"INTERSECTION_ID","LANES","DISTANCE","PRED_NON_PED_AADT","SPEED","WIDTH","PATTERN","SCORE","RANK","RANK_PERCENTILE"
1,1,3,0,1,0,0,5,8690,54.42
2,1,0,1,1,0,4,7,13868,78.23
3,3,0,5,2,5,10,25,18550,99.91
4,1,0,1,1,1,0,4,4966,36.77
5,1,0,1,1,2,0,5,8690,54.42
6,1,1,0,1,0,0,3,1352,17.01
7,1,0,2,1,0,0,4,4966,36.77
8,1,2,2,1,0,0,6,11521,68.36
9,1,0,1,1,2,0,5,8690,54.42
10,1,0,2,2,1,0,6,11521,68.36
11,1,1,0,1,1,0,4,4966,36.77
12,1,0,0,1,0,0,2,32,3.72
13,1,0,3,1,0,0,5,8690,54.42
14,1,0,1,1,2,0,5,8690,54.42
15,1,0,1,1,3,0,6,11521,68.36
16,1,0,0,1,0,0,2,32,3.72
17,1,0,0,1,0,0,2,32,3.72
18,1,0,0,1,0,0,2,32,3.72
19,1,0,0,1,0,0,2,32,3.72
20,1,0,1,1,2,0,5,8690,54.42
21,1,2,0,1,0,0,4,4966,36.77
22,1,1,1,1,0,0,4,4966,36.77
23,1,0,0,1,0,0,2,32,3.72
25,1,0,2,1,0,0,4,4966,36.77
26,1,1,0,1,0,0,3,1352,17.01
27,1,0,1,1,0,0,3,1352,17.01
28,1,3,3,4,4,0,15,17888,96.85
30,1,2,3,1,0,0,7,13868,78.23
31,1,0,0,1,1,0,3,1352,17.01
32,1,0,1,1,0,6,9,15950,87.44
33,1,0,5,1,0,0,7,13868,78.23
34,1,0,0,1,0,0,2,32,3.72
35,1,1,0,1,0,0,3,1352,17.01
36,1,3,0,1,1,0,6,11521,68.36
37,1,1,1,1,1,0,5,8690,54.42
38,1,1,0,1,0,0,3,1352,17.01
39,1,0,0,1,0,0,2,32,3.72
40,1,2,1,1,0,0,5,8690,54.42
41,1,0,3,1,4,0,9,15950,87.44
42,1,0,2,1,1,8,13,17456,94.66
43,1,1,0,1,1,0,4,4966,36.77
44,1,4,2,1,0,0,8,15186,83.84
45,1,0,0,1,0,0,2,32,3.72
46,1,1,1,1,0,0,4,4966,36.77
47,1,0,1,1,0,0,3,1352,17.01
48,1,1,1,1,2,0,6,11521,68.36
49,1,1,0,1,1,0,4,4966,36.77
50,1,2,0,1,2,0,6,11521,68.36
51,1,0,1,1,1,0,4,4966,36.77
52,1,1,1,1,0,4,8,15186,83.84
53,3,0,5,4,5,0,17,18193,98.23
54,1,1,1,1,1,0,5,8690,54.42
55,1,0,4,1,4,6,16,18081,97.67
56,1,2,1,1,0,0,5,8690,54.42
57,1,0,2,1,2,0,6,11521,68.36
58,1,1,1,1,0,0,4,4966,36.77
59,1,0,0,1,2,0,4,4966,36.77
60,3,0,5,2,5,6,21,18462,99.52
62,1,1,1,1,3,0,7,13868,78.23
63,1,0,1,1,0,6,9,15950,87.44
64,1,0,0,1,0,0,2,32,3.72
65,1,0,0,1,3,0,5,8690,54.42
66,1,1,0,1,0,0,3,1352,17.01
67,1,0,2,1,0,0,4,4966,36.77
68,1,0,0,1,0,0,2,32,3.72
69,1,0,2,1,4,0,8,15186,83.84
70,1,2,0,1,1,0,5,8690,54.42
71,1,0,0,1,0,0,2,32,3.72
72,1,1,0,1,2,0,5,8690,54.42
73,1,0,1,1,0,0,3,1352,17.01
74,1,4,0,1,0,0,6,11521,68.36
75,1,1,0,1,0,0,3,1352,17.01
76,1,4,0,1,1,0,7,13868,78.23
77,1,2,0,1,0,0,4,4966,36.77
78,1,2,0,1,0,0,4,4966,36.77
79,1,3,1,1,0,0,6,11521,68.36
80,1,2,1,1,4,0,9,15950,87.44
81,1,2,0,1,0,0,4,4966,36.77
82,1,2,0,1,0,0,4,4966,36.77
83,1,0,1,1,0,0,3,1352,17.01
84,1,0,1,1,3,0,6,11521,68.36
85,1,4,2,1,0,0,8,15186,83.84
86,1,1,0,1,0,0,3,1352,17.01
87,3,0,5,2,4,0,14,17699,95.82
88,1,0,0,1,0,0,2,32,3.72
89,1,2,1,1,0,0,5,8690,54.42
90,1,2,0,1,0,0,4,4966,36.77
91,3,4,5,4,5,0,21,18462,99.52
92,1,2,1,1,4,0,9,15950,87.44
93,3,1,4,1,4,0,13,17456,94.66
94,1,2,1,1,0,0,5,8690,54.42
95,1,0,1,1,0,0,3,1352,17.01
96,1,1,0,1,0,0,3,1352,17.01
97,1,0,1,1,0,0,3,1352,17.01
98,1,0,1,1,1,0,4,4966,36.77
99,1,0,1,1,0,0,3,1352,17.01
100,1,1,1,1,0,0,4,4966,36.77
101,1,1,3,1,0,0,6,11521,68.36
102,3,3,5,4,3,0,18,18287,98.68
103,1,4,0,1,0,0,6,11521,68.36
104,1,0,1,1,3,2,8,15186,83.84
105,1,1,0,1,0,0,3,1352,17.01
106,3,0,5,4,5,0,17,18193,98.23
107,1,0,0,0,0,0,1,1,0.08
108,1,0,1,1,0,0,3,1352,17.01
110,3,2,5,2,2,6,20,18419,99.31
111,1,1,1,1,2,0,6,11521,68.36
112,1,0,1,1,1,0,4,4966,36.77
113,1,0,1,1,3,0,6,11521,68.36
114,1,1,0,1,2,0,5,8690,54.42
115,1,0,0,1,0,0,2,32,3.72
116,4,0,5,2,5,0,16,18081,97.67
117,1,0,2,1,4,0,8,15186,83.84
118,1,2,1,1,2,0,7,13868,78.23
119,1,0,2,1,0,0,4,4966,36.77
120,1,3,0,1,0,0,5,8690,54.42
121,1,4,0,1,0,0,6,11521,68.36
122,1,0,0,1,0,0,2,32,3.72
123,1,1,1,1,4,0,8,15186,83.84
124,1,0,0,1,0,0,2,32,3.72
125,1,3,1,1,3,0,9,15950,87.44
126,1,0,0,1,1,0,3,1352,17.01
127,1,4,0,1,1,0,7,13868,78.23
128,3,0,5,4,3,0,15,17888,96.85
129,1,3,0,1,1,0,6,11521,68.36
130,1,3,4,2,4,0,14,17699,95.82
131,1,1,2,1,0,0,5,8690,54.42
132,1,2,1,1,3,0,8,15186,83.84
133,4,0,5,2,5,0,16,18081,97.67
134,1,3,1,1,3,0,9,15950,87.44
135,1,4,1,1,1,0,8,15186,83.84
136,1,2,0,1,4,0,8,15186,83.84
137,3,0,4,2,5,0,14,17699,95.82
138,1,0,0,1,1,0,3,1352,17.01
139,1,2,0,1,0,0,4,4966,36.77
140,1,3,0,1,0,0,5,8690,54.42
141,1,1,0,1,0,0,3,1352,17.01
142,1,0,4,1,0,6,12,17186,93.28
143,1,0,0,1,0,0,2,32,3.72
144,1,3,0,1,1,0,6,11521,68.36
145,1,1,2,1,0,0,5,8690,54.42
146,4,0,5,2,5,0,16,18081,97.67
147,1,2,0,1,0,0,4,4966,36.77
148,1,0,0,1,1,0,3,1352,17.01
149,1,0,1,1,0,0,3,1352,17.01
150,1,3,2,1,3,0,10,16522,90.12
151,1,2,1,1,0,0,5,8690,54.42
153,1,0,1,1,3,0,6,11521,68.36
154,1,1,0,1,0,0,3,1352,17.01
155,1,0,0,1,0,0,2,32,3.72
156,1,1,0,1,0,0,3,1352,17.01
157,1,1,1,1,0,0,4,4966,36.77
158,1,1,1,1,0,0,4,4966,36.77
159,1,1,0,1,1,0,4,4966,36.77
160,1,0,0,1,0,0,2,32,3.72
161,1,0,1,1,3,0,6,11521,68.36
162,1,1,1,1,0,0,4,4966,36.77
163,3,0,5,2,3,0,13,17456,94.66
164,1,4,1,1,2,0,9,15950,87.44
165,1,0,1,1,2,0,5,8690,54.42
167,1,2,0,1,0,0,4,4966,36.77
168,1,2,1,1,0,0,5,8690,54.42
169,1,0,3,1,4,0,9,15950,87.44
170,1,2,0,1,1,0,5,8690,54.42
171,3,1,4,2,4,0,14,17699,95.82
172,1,4,4,1,0,0,10,16522,90.12
173,1,2,2,1,0,0,6,11521,68.36
174,1,1,0,1,0,0,3,1352,17.01
175,1,0,0,1,1,0,3,1352,17.01
176,1,0,2,1,3,0,7,13868,78.23
177,3,0,5,2,2,6,18,18287,98.68
178,1,0,2,1,1,0,5,8690,54.42
179,1,0,1,1,3,0,6,11521,68.36
180,1,3,0,1,1,0,6,11521,68.36
183,1,0,0,0,1,0,2,32,3.72
184,1,0,0,1,0,0,2,32,3.72
185,1,0,1,1,0,0,3,1352,17.01
186,1,2,1,1,0,0,5,8690,54.42
187,1,0,2,1,2,0,6,11521,68.36
188,1,1,0,1,0,0,3,1352,17.01
189,1,0,0,1,0,0,2,32,3.72
190,4,0,5,2,5,10,26,18556,99.96
191,1,1,1,1,0,8,12,17186,93.28
193,1,1,2,1,3,0,8,15186,83.84
194,3,0,3,1,5,10,22,18498,99.73
196,1,2,0,1,0,0,4,4966,36.77
197,1,4,3,1,1,0,10,16522,90.12
198,1,0,0,1,0,0,2,32,3.72
199,1,1,1,1,0,0,4,4966,36.77
200,1,0,0,1,0,0,2,32,3.72
201,1,0,2,1,0,0,4,4966,36.77
202,1,3,0,1,0,0,5,8690,54.42
203,1,2,1,1,3,0,8,15186,83.84
204,1,0,2,1,0,0,4,4966,36.77
205,4,0,5,3,5,0,17,18193,98.23
206,1,1,0,1,1,0,4,4966,36.77
207,1,1,1,1,1,0,5,8690,54.42
208,1,2,0,1,3,0,7,13868,78.23
209,1,0,1,1,0,0,3,1352,17.01
210,1,4,0,1,0,0,6,11521,68.36
211,1,1,0,1,0,0,3,1352,17.01
212,1,0,2,1,0,0,4,4966,36.77
213,1,1,1,1,0,0,4,4966,36.77
214,1,0,2,1,0,0,4,4966,36.77
215,1,0,2,1,0,4,8,15186,83.84
216,1,0,2,1,0,0,4,4966,36.77
218,1,3,1,1,0,0,6,11521,68.36
219,1,4,1,1,0,0,7,13868,78.23
220,1,0,0,1,0,0,2,32,3.72
221,3,0,5,1,5,0,14,17699,95.82
222,1,0,2,1,0,0,4,4966,36.77
223,1,3,0,1,3,0,8,15186,83.84
224,1,1,0,1,0,0,3,1352,17.01
225,1,0,0,1,0,0,2,32,3.72
226,3,0,5,2,5,0,15,17888,96.85
227,3,0,5,1,5,6,20,18419,99.31
228,1,0,1,1,0,0,3,1352,17.01
229,1,2,1,1,3,0,8,15186,83.84
230,1,1,0,1,0,0,3,1352,17.01
231,1,1,1,1,0,0,4,4966,36.77
233,1,4,2,1,0,0,8,15186,83.84
234,1,3,0,1,0,0,5,8690,54.42
235,1,0,1,1,3,0,6,11521,68.36
236,1,0,1,1,3,0,6,11521,68.36
237,1,1,0,1,0,0,3,1352,17.01
239,1,2,0,1,0,0,4,4966,36.77
240,1,1,1,1,0,0,4,4966,36.77
241,1,2,1,1,0,0,5,8690,54.42
242,3,0,5,1,4,0,13,17456,94.66
243,1,0,0,1,0,0,2,32,3.72
244,3,5,3,4,5,0,20,18419,99.31
245,1,2,1,1,0,0,5,8690,54.42
246,1,0,2,1,0,0,4,4966,36.77
248,1,1,0,1,0,0,3,1352,17.01
249,1,2,2,1,1,0,7,13868,78.23
250,3,0,5,2,5,0,15,17888,96.85
251,1,3,1,1,0,0,6,11521,68.36
252,1,0,0,1,0,0,2,32,3.72
253,3,0,5,3,5,0,16,18081,97.67
254,1,2,0,1,0,0,4,4966,36.77
256,1,1,1,1,1,0,5,8690,54.42
257,1,1,0,1,0,0,3,1352,17.01
258,1,4,1,1,3,0,10,16522,90.12
259,1,0,4,1,0,0,6,11521,68.36
260,3,4,3,3,3,0,16,18081,97.67
261,1,0,1,1,0,0,3,1352,17.01
262,1,0,0,1,0,0,2,32,3.72
263,1,0,2,1,4,0,8,15186,83.84
264,1,1,2,1,1,0,6,11521,68.36
265,1,4,3,1,3,0,12,17186,93.28
266,1,0,0,1,0,0,2,32,3.72
267,1,1,0,1,0,0,3,1352,17.01
268,1,3,0,1,4,0,9,15950,87.44
269,1,1,0,1,0,0,3,1352,17.01
270,1,2,1,1,0,0,5,8690,54.42
271,1,2,0,1,0,0,4,4966,36.77
272,1,3,1,1,0,0,6,11521,68.36
273,1,1,1,1,0,0,4,4966,36.77
274,1,2,0,1,0,0,4,4966,36.77
275,1,0,0,1,4,0,6,11521,68.36
276,1,3,0,1,2,0,7,13868,78.23
277,3,0,5,2,5,0,15,17888,96.85
278,1,1,0,1,3,0,6,11521,68.36
279,1,0,1,1,0,0,3,1352,17.01
280,1,1,0,1,0,0,3,1352,17.01
281,3,0,5,1,2,0,11,16947,91.91
282,1,0,0,1,0,0,2,32,3.72
285,1,1,2,1,0,0,5,8690,54.42
286,1,0,2,1,3,0,7,13868,78.23
287,1,0,1,1,0,0,3,1352,17.01
288,1,0,3,1,3,0,8,15186,83.84
289,1,1,2,1,0,0,5,8690,54.42
291,1,2,0,1,0,0,4,4966,36.77
292,1,4,3,2,3,0,13,17456,94.66
293,1,0,1,1,0,6,9,15950,87.44
294,1,2,0,1,0,0,4,4966,36.77
295,1,1,0,1,0,0,3,1352,17.01
296,1,3,0,1,2,0,7,13868,78.23
297,1,0,1,1,0,4,7,13868,78.23
298,1,3,0,1,0,0,5,8690,54.42
299,1,0,0,1,0,0,2,32,3.72
300,1,0,0,1,0,0,2,32,3.72
301,1,1,0,1,2,0,5,8690,54.42
302,1,0,1,1,0,0,3,1352,17.01
303,1,0,1,1,0,0,3,1352,17.01
304,1,3,1,1,0,0,6,11521,68.36
305,3,3,4,2,4,0,16,18081,97.67
306,1,3,0,1,0,0,5,8690,54.42
307,1,2,1,1,0,0,5,8690,54.42
308,1,3,0,1,0,0,5,8690,54.42
309,1,2,0,1,0,0,4,4966,36.77
310,1,0,2,1,0,0,4,4966,36.77
311,1,1,0,1,0,0,3,1352,17.01
312,1,3,1,1,0,0,6,11521,68.36
313,1,0,2,1,0,0,4,4966,36.77
314,1,2,1,0,0,6,10,16522,90.12
315,1,0,1,1,0,0,3,1352,17.01
316,1,0,1,1,0,0,3,1352,17.01
317,1,0,2,1,0,0,4,4966,36.77
318,1,1,1,1,0,0,4,4966,36.77
319,1,1,0,1,1,0,4,4966,36.77
320,1,0,0,1,0,0,2,32,3.72
321,1,0,0,1,0,0,2,32,3.72
322,1,1,0,1,1,0,4,4966,36.77
323,1,1,1,1,1,0,5,8690,54.42
324,1,1,1,1,0,4,8,15186,83.84
325,1,2,0,1,0,0,4,4966,36.77
326,1,2,0,1,0,0,4,4966,36.77
327,1,2,0,1,0,0,4,4966,36.77
328,1,0,1,1,0,0,3,1352,17.01
329,1,3,0,1,1,0,6,11521,68.36
330,1,1,2,1,2,0,7,13868,78.23
331,1,0,0,1,1,0,3,1352,17.01
332,1,0,3,2,0,0,6,11521,68.36
333,1,1,0,1,0,0,3,1352,17.01
334,1,1,1,1,0,0,4,4966,36.77
335,1,0,0,1,0,0,2,32,3.72
336,1,0,1,1,4,0,7,13868,78.23
337,1,3,0,1,0,0,5,8690,54.42
338,1,0,2,1,1,4,9,15950,87.44
339,1,1,0,1,0,0,3,1352,17.01
340,1,1,0,1,0,0,3,1352,17.01
341,1,1,0,1,0,0,3,1352,17.01
342,1,4,0,1,0,0,6,11521,68.36
343,1,2,0,1,0,0,4,4966,36.77
344,1,4,0,1,1,0,7,13868,78.23
345,1,4,0,1,4,0,10,16522,90.12
346,1,4,0,1,0,0,6,11521,68.36
347,1,4,0,1,0,0,6,11521,68.36
348,1,4,0,1,1,0,7,13868,78.23
349,1,4,0,1,0,0,6,11521,68.36
350,1,3,0,1,0,0,5,8690,54.42
351,1,4,0,1,2,0,8,15186,83.84
352,1,0,2,1,1,0,5,8690,54.42
353,1,4,0,1,0,0,6,11521,68.36
354,1,4,0,1,0,0,6,11521,68.36
355,1,4,0,1,0,0,6,11521,68.36
356,1,2,0,1,0,0,4,4966,36.77
358,1,3,0,1,2,0,7,13868,78.23
359,1,2,1,1,0,6,11,16947,91.91
360,1,0,0,1,0,0,2,32,3.72
361,1,0,2,1,0,0,4,4966,36.77
362,1,0,0,1,1,0,3,1352,17.01
363,1,4,1,1,2,0,9,15950,87.44
364,1,4,0,1,2,0,8,15186,83.84
365,3,0,5,1,2,0,11,16947,91.91
366,1,1,1,1,0,0,4,4966,36.77
367,1,2,0,1,0,0,4,4966,36.77
368,1,3,0,1,0,0,5,8690,54.42
369,1,1,0,1,0,0,3,1352,17.01
370,1,1,2,1,2,0,7,13868,78.23
371,1,3,1,1,1,0,7,13868,78.23
372,1,2,1,1,0,0,5,8690,54.42
373,3,0,4,2,4,0,13,17456,94.66
374,1,1,1,1,1,0,5,8690,54.42
375,1,4,0,1,0,0,6,11521,68.36
376,1,4,0,1,0,0,6,11521,68.36
377,1,3,1,1,2,0,8,15186,83.84
378,1,1,1,1,0,0,4,4966,36.77
379,1,1,0,1,0,0,3,1352,17.01
380,1,2,0,1,0,0,4,4966,36.77
381,1,1,0,1,0,0,3,1352,17.01
382,1,0,0,1,1,0,3,1352,17.01
383,1,1,0,1,0,0,3,1352,17.01
384,1,1,0,1,1,0,4,4966,36.77
385,1,0,0,1,0,0,2,32,3.72
386,1,0,3,1,3,0,8,15186,83.84
387,1,0,0,1,0,0,2,32,3.72
388,1,0,0,1,3,0,5,8690,54.42
389,1,0,2,2,0,0,5,8690,54.42
390,1,0,0,1,0,0,2,32,3.72
391,1,0,0,1,0,0,2,32,3.72
392,1,0,0,1,1,0,3,1352,17.01
393,1,2,0,1,0,0,4,4966,36.77
394,1,0,0,1,1,0,3,1352,17.01
395,1,4,0,1,0,0,6,11521,68.36
396,1,0,1,1,1,0,4,4966,36.77
397,3,0,5,2,5,0,15,17888,96.85
398,1,1,1,1,0,0,4,4966,36.77
399,1,0,1,1,0,0,3,1352,17.01
400,1,1,1,1,1,0,5,8690,54.42
401,3,0,5,2,5,0,15,17888,96.85
402,1,1,1,1,0,0,4,4966,36.77
403,1,1,2,1,4,0,9,15950,87.44
404,1,1,2,1,1,0,6,11521,68.36
405,1,2,1,1,0,0,5,8690,54.42
406,1,2,0,1,0,0,4,4966,36.77
407,1,0,3,1,0,6,11,16947,91.91
408,1,3,0,1,0,0,5,8690,54.42
409,1,1,2,1,1,0,6,11521,68.36
410,1,1,3,1,0,0,6,11521,68.36
411,3,0,4,1,2,0,10,16522,90.12
412,1,0,3,3,2,0,9,15950,87.44
413,1,0,1,1,3,0,6,11521,68.36
414,1,2,1,1,0,0,5,8690,54.42
415,1,3,1,1,0,0,6,11521,68.36
416,1,1,1,1,0,0,4,4966,36.77
417,1,1,1,1,0,0,4,4966,36.77
418,1,0,1,1,0,0,3,1352,17.01
419,1,4,1,1,0,0,7,13868,78.23
420,1,1,0,1,0,0,3,1352,17.01
421,1,1,0,1,1,0,4,4966,36.77
422,1,1,0,1,1,0,4,4966,36.77
423,1,4,3,1,0,0,9,15950,87.44
424,1,0,1,1,0,0,3,1352,17.01
425,1,2,0,1,0,0,4,4966,36.77
427,1,0,1,1,0,0,3,1352,17.01
428,1,0,1,1,0,0,3,1352,17.01
429,1,0,0,1,0,0,2,32,3.72
430,1,0,2,1,0,0,4,4966,36.77
431,1,0,2,1,1,0,5,8690,54.42
432,1,0,1,1,0,0,3,1352,17.01
433,1,2,1,1,0,0,5,8690,54.42
434,1,1,0,1,0,0,3,1352,17.01
435,1,0,1,1,0,0,3,1352,17.01
436,1,0,1,1,0,0,3,1352,17.01
437,1,0,0,1,0,0,2,32,3.72
438,1,1,0,1,0,0,3,1352,17.01
439,1,4,0,1,0,0,6,11521,68.36
440,1,1,0,1,0,0,3,1352,17.01
441,1,3,0,1,1,0,6,11521,68.36
442,1,2,2,1,0,0,6,11521,68.36
443,3,0,5,2,4,0,14,17699,95.82
444,1,0,1,1,0,2,5,8690,54.42
445,1,2,0,1,0,0,4,4966,36.77
446,1,1,1,1,0,0,4,4966,36.77
447,1,0,1,1,0,0,3,1352,17.01
448,1,0,1,1,1,0,4,4966,36.77
449,1,1,3,3,1,0,9,15950,87.44
450,3,3,5,1,3,6,21,18462,99.52
451,1,1,2,1,0,0,5,8690,54.42
452,1,0,1,1,1,0,4,4966,36.77
453,1,0,1,1,0,0,3,1352,17.01
454,1,3,1,1,0,0,6,11521,68.36
455,1,0,0,1,0,0,2,32,3.72
456,3,0,4,1,2,6,16,18081,97.67
457,3,0,5,1,5,0,14,17699,95.82
458,1,3,1,1,0,0,6,11521,68.36
459,1,2,1,1,0,0,5,8690,54.42
460,1,1,1,1,0,0,4,4966,36.77
461,1,0,2,1,0,0,4,4966,36.77
462,1,0,2,1,2,0,6,11521,68.36
463,1,2,0,1,0,0,4,4966,36.77
464,1,0,1,1,0,0,3,1352,17.01
465,1,1,1,1,1,0,5,8690,54.42
466,1,0,1,1,0,0,3,1352,17.01
467,1,0,3,2,3,0,9,15950,87.44
468,1,0,5,2,0,0,8,15186,83.84
469,1,0,1,1,0,0,3,1352,17.01
470,1,0,0,1,0,0,2,32,3.72
471,1,2,0,1,0,0,4,4966,36.77
472,1,1,1,1,0,0,4,4966,36.77
473,4,4,3,2,0,0,13,17456,94.66
474,1,0,1,1,3,0,6,11521,68.36
475,1,0,2,1,1,0,5,8690,54.42
476,1,1,0,1,0,0,3,1352,17.01
477,1,1,0,1,0,0,3,1352,17.01
478,1,0,2,1,1,0,5,8690,54.42
479,1,4,0,1,2,0,8,15186,83.84
480,1,3,0,1,3,0,8,15186,83.84
481,1,3,2,1,3,0,10,16522,90.12
482,1,3,0,1,0,0,5,8690,54.42
483,1,3,0,1,3,0,8,15186,83.84
484,1,0,1,1,0,0,3,1352,17.01
485,1,1,0,1,0,0,3,1352,17.01
486,1,2,1,1,0,0,5,8690,54.42
487,1,2,2,1,4,0,10,16522,90.12
488,3,0,5,3,2,0,13,17456,94.66
489,1,5,3,1,0,0,10,16522,90.12
490,1,0,1,1,0,0,3,1352,17.01
491,1,0,0,1,3,6,11,16947,91.91
492,1,0,0,1,0,10,12,17186,93.28
493,1,0,1,1,0,0,3,1352,17.01
494,1,2,3,1,1,0,8,15186,83.84
495,1,4,0,1,0,0,6,11521,68.36
496,1,0,3,1,2,0,7,13868,78.23
497,1,1,2,1,0,0,5,8690,54.42
498,1,0,5,2,0,0,8,15186,83.84
499,1,1,1,1,0,0,4,4966,36.77
500,1,0,1,1,0,0,3,1352,17.01
501,1,1,0,1,0,0,3,1352,17.01
502,3,0,5,1,3,0,12,17186,93.28
503,1,0,1,1,0,0,3,1352,17.01
505,1,3,0,2,0,0,6,11521,68.36
506,1,1,2,1,2,0,7,13868,78.23
507,1,1,0,1,0,0,3,1352,17.01
508,1,0,2,1,0,0,4,4966,36.77
509,1,0,1,1,3,0,6,11521,68.36
510,1,0,3,1,0,0,5,8690,54.42
511,1,2,0,1,0,0,4,4966,36.77
512,1,3,1,1,1,0,7,13868,78.23
513,1,0,0,1,0,0,2,32,3.72
514,1,0,2,1,1,10,15,17888,96.85
515,1,4,2,2,0,0,9,15950,87.44
516,3,1,5,1,1,0,11,16947,91.91
517,1,0,4,2,1,0,8,15186,83.84
518,1,0,2,1,0,0,4,4966,36.77
519,1,0,1,1,0,0,3,1352,17.01
520,1,0,0,1,0,8,10,16522,90.12
521,1,1,0,1,0,0,3,1352,17.01
522,1,0,1,1,1,0,4,4966,36.77
523,1,0,1,1,0,0,3,1352,17.01
524,1,2,1,1,0,0,5,8690,54.42
525,1,2,0,1,3,0,7,13868,78.23
526,1,0,1,1,0,0,3,1352,17.01
527,1,1,0,1,0,0,3,1352,17.01
528,1,0,0,1,0,0,2,32,3.72
529,3,0,4,4,5,0,16,18081,97.67
530,1,2,0,1,0,0,4,4966,36.77
531,3,0,5,1,3,0,12,17186,93.28
532,1,0,0,1,0,0,2,32,3.72
533,1,4,0,1,0,0,6,11521,68.36
534,1,0,2,1,0,0,4,4966,36.77
535,1,5,0,1,0,0,7,13868,78.23
536,1,0,1,1,0,6,9,15950,87.44
537,1,1,1,1,2,0,6,11521,68.36
538,1,1,0,1,2,0,5,8690,54.42
539,1,0,1,1,1,0,4,4966,36.77
540,1,2,1,1,0,0,5,8690,54.42
541,1,1,1,1,0,0,4,4966,36.77
542,1,1,2,1,0,2,7,13868,78.23
543,1,1,2,1,0,0,5,8690,54.42
544,1,2,2,1,1,0,7,13868,78.23
545,1,0,0,1,0,0,2,32,3.72
546,1,0,3,1,1,6,12,17186,93.28
547,1,1,1,1,0,10,14,17699,95.82
548,1,1,1,1,0,0,4,4966,36.77
549,1,1,1,1,0,0,4,4966,36.77
550,1,0,2,1,1,0,5,8690,54.42
551,1,0,0,1,0,2,4,4966,36.77
552,1,2,0,1,1,0,5,8690,54.42
553,1,4,2,1,0,0,8,15186,83.84
554,1,1,0,1,0,0,3,1352,17.01
555,1,0,2,1,3,0,7,13868,78.23
556,1,0,2,1,2,0,6,11521,68.36
557,1,2,0,1,1,0,5,8690,54.42
558,1,2,1,1,0,0,5,8690,54.42
559,1,0,0,1,0,0,2,32,3.72
560,1,0,2,1,1,0,5,8690,54.42
561,1,0,1,1,0,6,9,15950,87.44
562,1,3,0,1,0,0,5,8690,54.42
563,1,0,0,1,0,0,2,32,3.72
564,1,0,0,1,0,0,2,32,3.72
565,1,0,1,1,2,2,7,13868,78.23
566,1,0,1,1,0,10,13,17456,94.66
567,1,5,2,1,0,0,9,15950,87.44
568,3,1,5,1,3,0,13,17456,94.66
569,1,0,1,1,0,0,3,1352,17.01
570,1,1,2,1,3,0,8,15186,83.84
571,1,0,1,1,0,0,3,1352,17.01
572,1,1,1,1,0,0,4,4966,36.77
573,3,0,5,2,3,6,19,18362,99.04
574,1,1,2,1,1,0,6,11521,68.36
575,1,3,0,1,0,0,5,8690,54.42
576,1,0,0,1,3,0,5,8690,54.42
577,1,0,0,1,2,0,4,4966,36.77
578,1,1,1,1,2,0,6,11521,68.36
579,1,1,1,1,0,0,4,4966,36.77
580,1,4,1,1,4,0,11,16947,91.91
581,1,0,1,1,2,0,5,8690,54.42
582,1,4,1,1,0,0,7,13868,78.23
583,1,0,2,1,2,0,6,11521,68.36
584,1,0,1,1,0,0,3,1352,17.01
585,1,0,1,1,0,0,3,1352,17.01
586,1,0,1,1,2,0,5,8690,54.42
587,1,1,1,1,0,6,10,16522,90.12
588,1,1,1,1,2,0,6,11521,68.36
589,1,2,0,1,2,0,6,11521,68.36
590,1,0,4,2,4,0,11,16947,91.91
591,1,1,1,1,0,0,4,4966,36.77
592,1,2,0,1,0,0,4,4966,36.77
593,1,2,0,1,0,0,4,4966,36.77
594,1,0,0,1,0,0,2,32,3.72
595,1,0,0,1,0,0,2,32,3.72
596,1,1,0,1,3,0,6,11521,68.36
597,1,2,0,1,0,0,4,4966,36.77
598,1,0,0,1,0,0,2,32,3.72
599,1,0,0,1,0,0,2,32,3.72
600,1,0,1,1,0,0,3,1352,17.01
601,1,1,1,1,2,0,6,11521,68.36
602,1,1,0,1,1,0,4,4966,36.77
603,1,2,1,1,0,0,5,8690,54.42
604,3,0,5,2,4,0,14,17699,95.82
605,1,0,2,1,4,0,8,15186,83.84
607,1,0,5,1,3,0,10,16522,90.12
608,1,0,1,1,0,0,3,1352,17.01
609,1,2,1,1,0,0,5,8690,54.42
610,1,3,0,1,0,0,5,8690,54.42
611,1,0,0,1,0,0,2,32,3.72
612,1,0,1,1,3,0,6,11521,68.36
613,1,2,0,1,0,0,4,4966,36.77
614,1,0,1,1,0,0,3,1352,17.01
615,3,0,5,1,5,6,20,18419,99.31
616,1,2,1,1,0,0,5,8690,54.42
617,1,1,1,1,3,0,7,13868,78.23
618,1,1,0,1,0,0,3,1352,17.01
619,1,0,2,1,0,0,4,4966,36.77
620,1,1,1,1,0,0,4,4966,36.77
621,1,1,1,1,3,0,7,13868,78.23
622,1,0,1,1,0,0,3,1352,17.01
623,3,0,5,1,3,6,18,18287,98.68
624,1,0,1,1,0,0,3,1352,17.01
625,1,1,0,1,0,0,3,1352,17.01
626,3,0,5,3,5,0,16,18081,97.67
627,1,2,1,1,3,0,8,15186,83.84
628,1,0,0,1,0,0,2,32,3.72
629,1,0,2,1,0,0,4,4966,36.77
630,1,0,1,1,0,0,3,1352,17.01
631,1,1,0,1,0,0,3,1352,17.01
632,1,0,3,1,0,0,5,8690,54.42
633,1,4,0,1,0,0,6,11521,68.36
634,1,4,0,1,0,0,6,11521,68.36
635,1,0,4,1,0,0,6,11521,68.36
636,1,0,1,1,0,2,5,8690,54.42
637,1,0,0,1,0,4,6,11521,68.36
638,1,3,0,1,0,0,5,8690,54.42
639,1,2,0,1,0,0,4,4966,36.77
640,1,4,0,1,0,0,6,11521,68.36
641,1,0,1,1,0,6,9,15950,87.44
642,1,0,0,1,0,0,2,32,3.72
643,1,2,0,1,0,0,4,4966,36.77
644,3,3,4,2,3,0,15,17888,96.85
645,1,4,2,2,2,0,11,16947,91.91
646,1,4,0,1,4,0,10,16522,90.12
647,1,0,1,1,4,0,7,13868,78.23
648,1,3,0,1,0,0,5,8690,54.42
649,1,1,0,1,0,0,3,1352,17.01
650,1,5,0,1,0,0,7,13868,78.23
651,1,0,2,1,2,0,6,11521,68.36
652,1,1,1,1,0,0,4,4966,36.77
653,1,0,3,1,1,0,6,11521,68.36
654,1,0,1,1,0,0,3,1352,17.01
655,1,0,2,1,3,0,7,13868,78.23
656,1,1,1,1,2,0,6,11521,68.36
657,1,0,1,1,0,0,3,1352,17.01
658,1,0,1,1,0,0,3,1352,17.01
659,1,0,1,1,2,0,5,8690,54.42
660,1,4,3,1,0,0,9,15950,87.44
661,1,0,0,1,0,0,2,32,3.72
662,1,0,0,1,3,0,5,8690,54.42
663,1,4,1,1,0,0,7,13868,78.23
664,1,2,0,0,0,0,3,1352,17.01
665,1,0,5,2,0,0,8,15186,83.84
666,1,0,0,1,0,0,2,32,3.72
667,1,0,2,1,0,6,10,16522,90.12
668,1,1,1,1,0,0,4,4966,36.77
669,1,1,1,1,1,0,5,8690,54.42
670,1,3,2,1,0,0,7,13868,78.23
671,1,0,1,1,0,0,3,1352,17.01
672,1,0,3,1,0,4,9,15950,87.44
673,1,0,1,1,0,0,3,1352,17.01
674,3,0,5,3,5,0,16,18081,97.67
675,1,1,2,1,0,0,5,8690,54.42
676,1,1,0,1,0,0,3,1352,17.01
677,1,0,0,1,0,0,2,32,3.72
678,1,3,1,1,0,0,6,11521,68.36
679,3,0,5,2,2,0,12,17186,93.28
680,1,4,1,1,3,0,10,16522,90.12
681,1,3,1,1,2,0,8,15186,83.84
682,1,0,2,1,0,0,4,4966,36.77
683,1,0,2,1,0,0,4,4966,36.77
684,1,3,0,1,0,0,5,8690,54.42
685,1,1,2,1,0,0,5,8690,54.42
686,1,0,1,1,0,0,3,1352,17.01
687,1,5,3,2,1,0,12,17186,93.28
688,1,1,0,1,0,0,3,1352,17.01
689,1,1,1,1,0,0,4,4966,36.77
690,1,0,1,1,3,0,6,11521,68.36
691,1,0,0,1,0,0,2,32,3.72
692,1,1,1,1,0,0,4,4966,36.77
693,3,0,5,1,3,0,12,17186,93.28
694,1,0,0,1,0,0,2,32,3.72
695,1,1,1,1,0,0,4,4966,36.77
696,1,0,1,1,0,0,3,1352,17.01
697,1,1,0,1,0,0,3,1352,17.01
698,1,0,2,1,1,0,5,8690,54.42
699,1,2,0,1,3,0,7,13868,78.23
700,1,2,0,1,0,0,4,4966,36.77
701,1,3,1,1,2,0,8,15186,83.84
702,1,1,0,1,2,0,5,8690,54.42
703,1,2,0,1,0,0,4,4966,36.77
704,1,4,0,1,2,0,8,15186,83.84
705,1,0,4,1,3,0,9,15950,87.44
706,1,0,2,1,0,0,4,4966,36.77
707,1,1,2,1,1,0,6,11521,68.36
708,1,1,0,1,0,0,3,1352,17.01
709,3,1,5,1,2,4,16,18081,97.67
710,1,0,1,1,0,6,9,15950,87.44
711,1,1,1,1,0,0,4,4966,36.77
712,1,0,1,1,0,0,3,1352,17.01
713,1,1,2,1,0,0,5,8690,54.42
714,1,1,3,1,0,0,6,11521,68.36
715,1,3,0,1,0,0,5,8690,54.42
716,1,0,0,1,0,0,2,32,3.72
717,1,5,3,1,0,0,10,16522,90.12
718,1,2,1,1,0,0,5,8690,54.42
719,1,2,0,1,0,0,4,4966,36.77
720,1,1,5,2,0,0,9,15950,87.44
721,1,4,1,1,0,0,7,13868,78.23
722,1,2,0,1,4,0,8,15186,83.84
723,1,1,0,1,0,0,3,1352,17.01
724,1,1,2,1,0,0,5,8690,54.42
725,1,0,1,1,0,6,9,15950,87.44
726,1,1,1,1,0,0,4,4966,36.77
727,1,1,0,1,0,0,3,1352,17.01
728,1,0,0,1,0,0,2,32,3.72
729,3,0,5,2,4,0,14,17699,95.82
731,1,0,1,1,2,0,5,8690,54.42
732,1,1,0,1,0,0,3,1352,17.01
733,1,2,0,1,0,0,4,4966,36.77
734,1,1,0,1,0,0,3,1352,17.01
735,1,0,1,1,0,0,3,1352,17.01
736,1,4,1,1,4,0,11,16947,91.91
737,1,3,0,1,0,0,5,8690,54.42
738,1,1,2,1,1,0,6,11521,68.36
739,1,3,1,1,0,4,10,16522,90.12
740,1,1,2,1,0,0,5,8690,54.42
741,1,1,1,1,0,0,4,4966,36.77
742,1,1,1,1,0,0,4,4966,36.77
743,1,0,1,1,0,8,11,16947,91.91
744,1,1,1,1,0,0,4,4966,36.77
745,1,2,0,1,0,0,4,4966,36.77
746,3,0,5,2,3,0,13,17456,94.66
747,1,0,0,1,0,0,2,32,3.72
748,1,0,1,1,0,2,5,8690,54.42
749,1,2,1,1,0,0,5,8690,54.42
750,1,2,1,1,0,0,5,8690,54.42
751,1,2,1,1,0,0,5,8690,54.42
752,1,3,1,1,0,0,6,11521,68.36
753,1,3,1,1,0,0,6,11521,68.36
754,1,4,2,1,0,0,8,15186,83.84
755,1,2,2,1,1,0,7,13868,78.23
756,1,0,1,1,0,0,3,1352,17.01
757,3,0,5,1,3,6,18,18287,98.68
758,1,0,1,1,0,0,3,1352,17.01
759,1,3,0,1,0,0,5,8690,54.42
760,1,2,0,1,0,0,4,4966,36.77
761,1,0,1,1,3,0,6,11521,68.36
762,1,2,0,1,0,0,4,4966,36.77
763,1,0,0,1,0,0,2,32,3.72
764,1,0,1,1,0,4,7,13868,78.23
765,1,0,1,1,1,6,10,16522,90.12
766,1,0,1,1,0,0,3,1352,17.01
767,1,4,2,2,0,0,9,15950,87.44
768,1,3,3,1,0,0,8,15186,83.84
769,1,0,2,1,0,0,4,4966,36.77
770,1,0,4,1,4,0,10,16522,90.12
771,1,1,1,1,0,0,4,4966,36.77
772,1,3,0,1,2,0,7,13868,78.23
773,1,2,1,1,1,0,6,11521,68.36
774,1,0,1,1,0,0,3,1352,17.01
775,1,0,1,1,0,0,3,1352,17.01
776,1,2,0,1,0,0,4,4966,36.77
777,1,0,2,1,0,0,4,4966,36.77
778,1,1,0,1,2,0,5,8690,54.42
779,1,0,2,1,0,0,4,4966,36.77
780,1,1,0,1,0,0,3,1352,17.01
781,1,1,0,1,0,0,3,1352,17.01
782,1,0,1,1,0,0,3,1352,17.01
783,1,4,0,1,0,0,6,11521,68.36
784,1,1,0,1,0,0,3,1352,17.01
785,1,3,0,1,0,0,5,8690,54.42
786,1,1,2,1,2,0,7,13868,78.23
787,1,0,1,1,0,0,3,1352,17.01
788,1,0,2,1,2,4,10,16522,90.12
789,1,0,4,1,0,0,6,11521,68.36
790,1,1,0,1,1,0,4,4966,36.77
791,1,0,1,1,0,0,3,1352,17.01
792,1,0,1,1,0,0,3,1352,17.01
793,1,1,1,1,3,0,7,13868,78.23
794,1,0,0,1,0,0,2,32,3.72
795,1,3,0,1,3,0,8,15186,83.84
796,1,0,0,1,0,8,10,16522,90.12
797,1,1,0,1,0,0,3,1352,17.01
798,1,3,0,1,1,0,6,11521,68.36
799,1,2,0,1,0,0,4,4966,36.77
800,1,0,1,1,1,0,4,4966,36.77
801,1,1,0,1,0,0,3,1352,17.01
802,1,1,1,1,0,0,4,4966,36.77
803,1,0,1,1,0,4,7,13868,78.23
804,1,2,0,1,1,0,5,8690,54.42
805,1,4,0,1,0,0,6,11521,68.36
806,1,1,0,1,0,0,3,1352,17.01
807,1,2,0,1,0,0,4,4966,36.77
808,1,0,1,1,1,0,4,4966,36.77
809,1,0,3,4,0,0,8,15186,83.84
810,1,2,1,1,3,0,8,15186,83.84
811,1,1,0,1,0,4,7,13868,78.23
812,1,1,0,1,0,0,3,1352,17.01
813,1,2,1,1,0,0,5,8690,54.42
814,1,2,0,1,0,0,4,4966,36.77
815,1,0,3,1,2,0,7,13868,78.23
816,1,0,1,1,0,0,3,1352,17.01
817,1,0,1,1,0,6,9,15950,87.44
818,1,0,3,2,4,0,10,16522,90.12
819,1,1,1,1,0,0,4,4966,36.77
820,1,0,0,1,0,0,2,32,3.72
821,1,1,1,1,0,0,4,4966,36.77
822,3,0,5,2,5,10,25,18550,99.91
823,1,1,0,1,0,0,3,1352,17.01
824,1,0,1,1,0,0,3,1352,17.01
825,1,0,1,1,2,0,5,8690,54.42
826,1,0,2,1,1,4,9,15950,87.44
828,1,0,3,2,1,0,7,13868,78.23
829,1,3,2,1,0,0,7,13868,78.23
830,1,0,1,1,0,4,7,13868,78.23
831,1,1,0,1,1,0,4,4966,36.77
832,1,4,0,1,0,0,6,11521,68.36
833,1,0,0,1,0,0,2,32,3.72
834,1,3,3,1,0,0,8,15186,83.84
835,1,1,0,1,0,0,3,1352,17.01
836,1,4,1,1,0,0,7,13868,78.23
837,1,0,2,1,0,0,4,4966,36.77
838,1,0,0,1,0,0,2,32,3.72
839,1,3,0,1,0,0,5,8690,54.42
840,1,2,1,1,0,0,5,8690,54.42
841,1,1,0,1,0,0,3,1352,17.01
842,1,2,0,1,0,0,4,4966,36.77
843,1,2,0,1,0,0,4,4966,36.77
844,1,1,0,1,0,0,3,1352,17.01
845,3,0,4,1,5,8,21,18462,99.52
846,3,0,5,2,5,0,15,17888,96.85
847,3,0,4,2,3,0,12,17186,93.28
848,1,0,0,1,3,0,5,8690,54.42
849,1,0,2,1,0,0,4,4966,36.77
850,1,5,0,1,0,0,7,13868,78.23
851,1,0,1,1,0,0,3,1352,17.01
852,1,1,1,1,0,0,4,4966,36.77
853,1,3,1,1,0,0,6,11521,68.36
854,1,5,3,2,2,0,13,17456,94.66
855,1,2,3,2,0,0,8,15186,83.84
856,3,0,5,4,5,0,17,18193,98.23
857,1,1,1,1,0,0,4,4966,36.77
858,1,2,0,1,2,0,6,11521,68.36
859,1,0,1,1,1,0,4,4966,36.77
860,1,2,0,1,0,0,4,4966,36.77
861,1,1,0,1,0,0,3,1352,17.01
862,1,0,2,1,0,0,4,4966,36.77
863,1,1,2,1,3,0,8,15186,83.84
864,1,1,1,1,0,0,4,4966,36.77
865,1,3,1,1,0,0,6,11521,68.36
866,3,0,5,2,1,0,11,16947,91.91
867,1,0,2,1,0,0,4,4966,36.77
868,1,3,0,1,1,0,6,11521,68.36
869,3,0,5,2,3,0,13,17456,94.66
870,1,1,0,1,0,0,3,1352,17.01
871,1,1,1,1,0,0,4,4966,36.77
872,3,0,5,4,5,0,17,18193,98.23
873,1,2,2,1,2,0,8,15186,83.84
874,1,0,1,1,2,0,5,8690,54.42
875,1,4,0,1,0,0,6,11521,68.36
876,3,0,5,2,1,0,11,16947,91.91
877,1,3,2,1,0,0,7,13868,78.23
878,1,0,1,1,0,0,3,1352,17.01
879,1,4,0,1,0,0,6,11521,68.36
880,1,1,3,1,0,0,6,11521,68.36
881,1,1,2,1,0,0,5,8690,54.42
882,1,2,0,1,3,0,7,13868,78.23
883,1,0,2,1,0,0,4,4966,36.77
884,1,2,0,2,0,0,5,8690,54.42
885,1,0,1,1,0,0,3,1352,17.01
886,1,2,2,1,3,0,9,15950,87.44
887,1,1,1,1,0,0,4,4966,36.77
888,1,0,1,1,0,0,3,1352,17.01
889,1,0,1,1,0,0,3,1352,17.01
890,1,0,2,1,0,0,4,4966,36.77
892,1,0,1,1,0,0,3,1352,17.01
893,1,0,0,1,0,0,2,32,3.72
894,1,4,1,1,0,0,7,13868,78.23
895,3,0,5,2,5,0,15,17888,96.85
896,1,3,0,1,3,0,8,15186,83.84
897,3,0,5,2,3,0,13,17456,94.66
898,1,4,0,1,0,0,6,11521,68.36
899,1,0,2,1,4,0,8,15186,83.84
900,1,0,1,1,0,0,3,1352,17.01
901,1,1,2,1,0,0,5,8690,54.42
902,1,0,0,1,0,0,2,32,3.72
903,1,3,1,1,0,0,6,11521,68.36
904,1,0,1,1,0,0,3,1352,17.01
905,1,0,2,1,0,0,4,4966,36.77
906,1,0,3,1,0,0,5,8690,54.42
907,1,2,0,1,0,0,4,4966,36.77
908,1,0,0,1,3,0,5,8690,54.42
909,3,4,5,4,5,0,21,18462,99.52
910,1,0,1,1,1,0,4,4966,36.77
911,1,0,4,1,1,0,7,13868,78.23
912,1,2,2,1,2,4,12,17186,93.28
913,1,2,1,1,0,0,5,8690,54.42
914,1,1,0,1,0,0,3,1352,17.01
915,1,0,1,1,0,0,3,1352,17.01
916,1,1,2,1,0,0,5,8690,54.42
917,1,2,0,1,0,0,4,4966,36.77
918,3,0,5,2,4,0,14,17699,95.82
919,1,0,0,1,0,6,8,15186,83.84
920,1,2,1,1,0,0,5,8690,54.42
921,1,3,0,1,0,0,5,8690,54.42
922,1,0,0,1,1,0,3,1352,17.01
923,1,0,0,1,0,0,2,32,3.72
924,1,0,0,1,0,0,2,32,3.72
925,1,4,0,1,0,0,6,11521,68.36
926,1,0,0,1,0,0,2,32,3.72
927,1,1,1,1,0,0,4,4966,36.77
928,1,1,0,1,2,0,5,8690,54.42
929,1,1,1,1,0,6,10,16522,90.12
930,1,2,1,1,0,0,5,8690,54.42
931,1,0,3,2,1,0,7,13868,78.23
932,1,3,2,1,3,0,10,16522,90.12
933,1,1,1,1,2,0,6,11521,68.36
934,1,1,0,1,0,0,3,1352,17.01
935,3,0,4,1,5,6,19,18362,99.04
936,1,0,0,1,0,0,2,32,3.72
937,3,0,5,2,3,0,13,17456,94.66
938,1,0,2,1,0,0,4,4966,36.77
939,1,1,2,1,0,0,5,8690,54.42
940,3,0,5,1,5,0,14,17699,95.82
941,1,0,1,1,1,4,8,15186,83.84
942,1,0,3,1,1,0,6,11521,68.36
943,1,1,0,1,0,2,5,8690,54.42
944,1,0,0,1,0,0,2,32,3.72
945,3,0,5,1,2,0,11,16947,91.91
946,1,1,1,1,1,0,5,8690,54.42
947,1,2,1,1,0,0,5,8690,54.42
948,1,0,4,1,3,0,9,15950,87.44
949,1,0,3,1,1,0,6,11521,68.36
950,1,4,0,1,3,0,9,15950,87.44
951,1,1,2,1,0,0,5,8690,54.42
952,1,0,5,1,4,0,11,16947,91.91
953,1,2,1,1,0,0,5,8690,54.42
954,1,1,1,1,0,0,4,4966,36.77
955,1,0,0,1,0,0,2,32,3.72
956,1,2,0,1,0,0,4,4966,36.77
957,1,4,0,1,0,0,6,11521,68.36
958,1,2,0,1,0,0,4,4966,36.77
959,1,1,1,1,1,6,11,16947,91.91
960,1,0,1,1,0,0,3,1352,17.01
961,1,1,1,1,0,0,4,4966,36.77
962,1,5,5,2,0,0,13,17456,94.66
963,1,2,1,1,3,0,8,15186,83.84
964,1,1,1,1,0,0,4,4966,36.77
965,1,0,1,1,0,0,3,1352,17.01
966,1,0,0,1,0,0,2,32,3.72
967,1,0,1,1,0,0,3,1352,17.01
968,1,4,0,1,0,0,6,11521,68.36
969,1,0,0,1,0,0,2,32,3.72
970,1,0,1,1,3,0,6,11521,68.36
971,1,0,2,1,3,0,7,13868,78.23
972,1,0,1,1,0,6,9,15950,87.44
973,1,0,5,2,0,0,8,15186,83.84
974,1,4,0,1,0,0,6,11521,68.36
975,1,0,1,1,0,0,3,1352,17.01
976,1,2,2,1,3,0,9,15950,87.44
977,1,0,0,1,0,0,2,32,3.72
978,1,2,1,1,0,0,5,8690,54.42
979,1,0,1,1,1,0,4,4966,36.77
980,1,2,1,1,0,0,5,8690,54.42
981,1,0,2,1,0,0,4,4966,36.77
982,1,1,2,1,1,0,6,11521,68.36
983,1,1,0,1,0,0,3,1352,17.01
984,1,2,1,1,0,0,5,8690,54.42
985,1,0,4,1,0,0,6,11521,68.36
986,1,0,1,1,3,0,6,11521,68.36
987,1,0,3,1,3,0,8,15186,83.84
988,1,0,4,1,0,0,6,11521,68.36
989,1,0,3,1,3,0,8,15186,83.84
990,1,0,1,1,2,0,5,8690,54.42
991,1,2,1,1,1,4,10,16522,90.12
992,1,3,0,1,0,0,5,8690,54.42
993,1,0,3,1,0,2,7,13868,78.23
994,1,5,1,1,0,0,8,15186,83.84
995,1,2,0,1,0,0,4,4966,36.77
996,1,2,2,1,0,0,6,11521,68.36
997,1,1,0,1,0,0,3,1352,17.01
998,1,0,1,1,0,0,3,1352,17.01
999,1,4,1,1,0,0,7,13868,78.23
1000,1,2,2,1,0,0,6,11521,68.36
1001,1,4,0,1,0,0,6,11521,68.36
1002,1,4,0,1,0,0,6,11521,68.36
1003,1,1,1,1,3,0,7,13868,78.23
1004,1,0,0,1,0,0,2,32,3.72
1005,1,0,2,1,1,0,5,8690,54.42
1006,1,3,0,1,0,0,5,8690,54.42
1007,1,2,1,1,0,6,11,16947,91.91
1008,1,1,1,1,1,0,5,8690,54.42
1009,1,0,3,2,0,0,6,11521,68.36
1010,1,0,1,1,0,0,3,1352,17.01
1011,1,1,0,2,0,0,4,4966,36.77
1012,1,1,1,1,0,0,4,4966,36.77
1013,1,0,1,1,0,10,13,17456,94.66
1014,3,0,5,1,5,6,20,18419,99.31
1015,1,4,0,1,0,0,6,11521,68.36
1016,1,4,1,1,0,0,7,13868,78.23
1017,1,2,0,1,0,0,4,4966,36.77
1018,1,0,4,1,0,0,6,11521,68.36
1020,1,1,0,1,0,0,3,1352,17.01
1021,1,0,1,1,0,4,7,13868,78.23
1022,1,1,0,1,1,0,4,4966,36.77
1023,1,1,1,1,2,0,6,11521,68.36
1024,4,0,5,1,5,4,19,18362,99.04
1025,1,1,0,1,0,0,3,1352,17.01
1026,1,2,1,1,0,0,5,8690,54.42
1027,1,1,0,1,0,0,3,1352,17.01
1028,1,0,0,1,3,0,5,8690,54.42
1029,1,1,1,1,0,0,4,4966,36.77
1030,1,0,1,1,1,0,4,4966,36.77
1031,1,2,3,2,3,0,11,16947,91.91
1032,1,0,1,1,0,0,3,1352,17.01
1033,1,1,0,1,0,0,3,1352,17.01
1034,1,3,0,1,0,0,5,8690,54.42
1035,1,1,0,1,0,4,7,13868,78.23
1036,1,2,0,1,0,0,4,4966,36.77
1037,1,0,1,1,1,0,4,4966,36.77
1038,1,4,0,0,0,0,5,8690,54.42
1039,1,1,0,1,1,0,4,4966,36.77
1040,1,0,2,1,1,0,5,8690,54.42
1041,1,1,0,1,1,0,4,4966,36.77
1042,3,0,3,1,2,10,19,18362,99.04
1043,3,0,5,1,3,6,18,18287,98.68
1044,1,4,3,1,0,0,9,15950,87.44
1045,1,0,3,1,0,0,5,8690,54.42
1046,1,5,1,1,0,0,8,15186,83.84
1047,1,4,0,1,0,0,6,11521,68.36
1048,1,2,1,1,1,0,6,11521,68.36
1049,1,0,1,1,0,0,3,1352,17.01
1050,1,0,2,1,3,0,7,13868,78.23
1051,3,2,5,2,5,6,23,18538,99.86
1052,1,5,1,1,1,0,9,15950,87.44
1053,1,0,3,1,0,0,5,8690,54.42
1054,3,1,4,1,1,0,10,16522,90.12
1055,1,4,0,1,0,0,6,11521,68.36
1056,1,1,0,1,0,0,3,1352,17.01
1057,1,1,3,1,1,0,7,13868,78.23
1058,1,1,1,1,0,0,4,4966,36.77
1059,1,0,0,1,0,0,2,32,3.72
1060,1,0,1,1,0,0,3,1352,17.01
1061,1,5,2,2,0,0,10,16522,90.12
1062,1,4,2,1,3,0,11,16947,91.91
1063,1,4,0,1,0,0,6,11521,68.36
1064,1,3,0,1,0,0,5,8690,54.42
1065,1,0,1,1,0,0,3,1352,17.01
1066,1,1,1,1,0,4,8,15186,83.84
1067,1,0,2,1,0,0,4,4966,36.77
1068,1,1,0,1,1,0,4,4966,36.77
1069,1,0,1,1,0,0,3,1352,17.01
1070,1,1,1,1,2,0,6,11521,68.36
1071,1,1,1,1,1,0,5,8690,54.42
1072,1,1,1,1,0,0,4,4966,36.77
1073,3,0,5,2,5,2,17,18193,98.23
1074,1,1,0,1,0,0,3,1352,17.01
1075,1,2,2,1,0,0,6,11521,68.36
1076,1,2,0,1,0,0,4,4966,36.77
1077,1,1,0,1,0,0,3,1352,17.01
1078,1,1,1,1,0,0,4,4966,36.77
1079,1,0,1,1,0,0,3,1352,17.01
1080,1,5,0,1,0,0,7,13868,78.23
1081,1,0,0,1,0,0,2,32,3.72
1082,1,0,3,2,0,0,6,11521,68.36
1083,1,0,2,1,0,0,4,4966,36.77
1084,1,0,3,1,2,10,17,18193,98.23
1085,1,0,4,1,0,0,6,11521,68.36
1086,1,2,1,1,0,0,5,8690,54.42
1087,1,0,0,1,0,0,2,32,3.72
1088,1,3,2,1,0,0,7,13868,78.23
1089,1,1,0,1,0,0,3,1352,17.01
1090,4,0,5,2,5,10,26,18556,99.96
1091,1,3,2,1,0,0,7,13868,78.23
1092,1,3,2,1,0,0,7,13868,78.23
1093,1,0,3,1,0,0,5,8690,54.42
1095,1,5,1,1,1,0,9,15950,87.44
1096,1,1,1,1,0,0,4,4966,36.77
1097,1,0,2,1,1,0,5,8690,54.42
1098,3,0,4,2,1,6,16,18081,97.67
1099,1,0,0,1,0,0,2,32,3.72
1100,1,4,0,1,0,0,6,11521,68.36
1101,1,0,1,1,0,0,3,1352,17.01
1103,1,1,0,1,0,0,3,1352,17.01
1104,1,1,1,1,0,0,4,4966,36.77
1105,1,3,0,1,4,0,9,15950,87.44
1106,3,0,5,1,5,0,14,17699,95.82
1107,1,0,2,1,0,0,4,4966,36.77
1108,1,1,0,1,0,0,3,1352,17.01
1109,1,0,2,1,0,0,4,4966,36.77
1110,1,1,0,1,0,0,3,1352,17.01
1111,1,1,1,1,2,0,6,11521,68.36
1112,1,3,0,1,0,0,5,8690,54.42
1113,1,2,1,1,0,0,5,8690,54.42
1114,1,0,4,2,0,0,7,13868,78.23
1115,1,1,1,1,0,0,4,4966,36.77
1116,1,3,1,1,0,0,6,11521,68.36
1117,3,0,5,2,3,0,13,17456,94.66
1119,1,1,2,1,0,0,5,8690,54.42
1120,3,0,5,2,5,0,15,17888,96.85
1121,1,0,2,1,1,0,5,8690,54.42
1122,1,1,0,1,0,0,3,1352,17.01
1123,1,0,2,1,1,0,5,8690,54.42
1124,1,0,2,1,1,0,5,8690,54.42
1125,1,2,0,1,0,0,4,4966,36.77
1126,1,3,0,1,0,0,5,8690,54.42
1127,1,1,2,1,0,0,5,8690,54.42
1128,1,3,1,1,2,0,8,15186,83.84
1129,1,2,0,1,0,0,4,4966,36.77
1130,1,4,0,0,0,0,5,8690,54.42
1131,1,1,0,1,0,0,3,1352,17.01
1132,1,0,1,1,0,0,3,1352,17.01
1133,1,2,0,1,0,0,4,4966,36.77
1134,1,0,5,1,1,0,8,15186,83.84
1135,1,4,0,1,1,0,7,13868,78.23
1136,1,3,2,1,0,0,7,13868,78.23
1137,1,1,1,1,0,0,4,4966,36.77
1138,1,0,1,1,0,0,3,1352,17.01
1139,1,1,1,1,0,0,4,4966,36.77
1140,1,2,1,1,0,0,5,8690,54.42
1141,1,0,0,1,0,0,2,32,3.72
1142,1,4,0,1,2,0,8,15186,83.84
1143,1,1,1,1,0,0,4,4966,36.77
1144,1,0,0,1,0,2,4,4966,36.77
1145,1,2,1,1,0,0,5,8690,54.42
1146,1,0,0,1,0,0,2,32,3.72
1147,1,2,2,1,0,0,6,11521,68.36
1148,3,0,4,2,5,0,14,17699,95.82
1149,1,1,0,1,0,0,3,1352,17.01
1150,1,2,0,1,0,0,4,4966,36.77
1151,1,1,1,1,0,0,4,4966,36.77
1152,1,0,2,1,3,0,7,13868,78.23
1153,1,0,0,1,0,6,8,15186,83.84
1154,1,0,2,1,1,0,5,8690,54.42
1155,1,0,1,1,0,0,3,1352,17.01
1156,1,2,0,1,3,0,7,13868,78.23
1157,1,0,2,1,0,0,4,4966,36.77
1158,1,1,0,1,0,0,3,1352,17.01
1159,1,3,0,1,0,0,5,8690,54.42
1160,1,2,2,1,1,0,7,13868,78.23
1161,1,2,1,1,0,0,5,8690,54.42
1162,1,1,2,1,0,4,9,15950,87.44
1163,1,0,2,1,0,0,4,4966,36.77
1164,1,0,1,1,0,0,3,1352,17.01
1165,1,5,2,1,0,0,9,15950,87.44
1166,1,1,0,1,0,0,3,1352,17.01
1167,1,2,0,1,0,0,4,4966,36.77
1168,4,0,5,2,5,0,16,18081,97.67
1169,1,0,1,1,0,2,5,8690,54.42
1170,1,2,2,1,0,0,6,11521,68.36
1171,1,1,1,1,0,0,4,4966,36.77
1172,1,1,0,1,0,0,3,1352,17.01
1173,3,3,4,3,4,0,17,18193,98.23
1174,1,4,0,1,1,0,7,13868,78.23
1175,1,4,0,1,0,0,6,11521,68.36
1176,1,2,1,1,0,0,5,8690,54.42
1177,1,0,2,1,1,0,5,8690,54.42
1178,1,3,1,1,0,0,6,11521,68.36
1179,1,0,1,1,0,0,3,1352,17.01
1180,1,4,0,1,0,0,6,11521,68.36
1181,1,1,0,1,0,0,3,1352,17.01
1182,1,3,1,1,2,0,8,15186,83.84
1183,1,1,2,1,0,0,5,8690,54.42
1184,1,1,1,1,3,0,7,13868,78.23
1185,1,0,1,1,0,0,3,1352,17.01
1186,1,0,0,1,0,0,2,32,3.72
1187,3,3,4,3,2,0,15,17888,96.85
1188,1,2,1,1,0,0,5,8690,54.42
1189,1,3,1,1,3,0,9,15950,87.44
1190,1,2,1,1,3,0,8,15186,83.84
1191,1,1,0,1,0,0,3,1352,17.01
1192,1,2,1,1,0,0,5,8690,54.42
1193,1,1,1,1,0,0,4,4966,36.77
1194,1,1,1,1,0,0,4,4966,36.77
1195,1,0,1,1,1,0,4,4966,36.77
1196,1,2,1,1,0,0,5,8690,54.42
1197,1,0,1,1,0,0,3,1352,17.01
1198,1,4,0,1,0,0,6,11521,68.36
1199,3,0,5,2,3,0,13,17456,94.66
1200,1,2,0,1,2,0,6,11521,68.36
1201,1,0,1,1,0,0,3,1352,17.01
1202,3,1,3,2,3,0,12,17186,93.28
1203,1,4,2,2,3,0,12,17186,93.28
1204,1,2,1,1,0,0,5,8690,54.42
1205,3,0,4,2,3,0,12,17186,93.28
1206,1,0,3,1,0,0,5,8690,54.42
1207,1,0,2,1,0,0,4,4966,36.77
1208,1,0,1,1,0,0,3,1352,17.01
1209,1,1,1,1,1,0,5,8690,54.42
1210,3,1,5,2,3,0,14,17699,95.82
1211,1,4,0,1,0,0,6,11521,68.36
1212,3,3,5,3,2,0,16,18081,97.67
1213,1,1,1,1,0,0,4,4966,36.77
1214,1,1,1,1,0,0,4,4966,36.77
1215,1,5,2,1,0,0,9,15950,87.44
1216,1,2,1,2,0,0,6,11521,68.36
1217,1,2,0,0,0,0,3,1352,17.01
1218,1,0,0,1,0,0,2,32,3.72
1219,1,3,0,1,1,0,6,11521,68.36
1220,1,0,0,1,0,0,2,32,3.72
1221,1,3,2,1,0,0,7,13868,78.23
1222,1,2,0,1,0,0,4,4966,36.77
1223,1,3,0,1,0,0,5,8690,54.42
1224,1,1,1,1,0,0,4,4966,36.77
1225,1,0,2,1,0,0,4,4966,36.77
1226,1,0,2,1,4,0,8,15186,83.84
1227,1,2,1,1,0,0,5,8690,54.42
1228,1,5,0,1,0,0,7,13868,78.23
1229,1,0,2,1,3,0,7,13868,78.23
1230,1,1,1,1,0,0,4,4966,36.77
1231,1,0,1,1,0,0,3,1352,17.01
1232,1,3,0,1,1,0,6,11521,68.36
1233,1,4,0,1,0,0,6,11521,68.36
1234,1,4,0,1,0,0,6,11521,68.36
1235,1,1,2,1,0,0,5,8690,54.42
1236,1,0,0,1,0,0,2,32,3.72
1237,1,1,1,1,0,0,4,4966,36.77
1238,1,2,1,1,0,0,5,8690,54.42
1239,1,0,0,1,2,0,4,4966,36.77
1240,1,0,0,1,0,4,6,11521,68.36
1241,1,4,2,1,0,0,8,15186,83.84
1242,1,3,1,1,0,0,6,11521,68.36
1243,1,0,1,1,2,0,5,8690,54.42
1244,1,0,2,1,0,0,4,4966,36.77
1245,1,0,0,1,0,0,2,32,3.72
1246,1,0,0,1,0,0,2,32,3.72
1247,1,1,5,2,3,0,12,17186,93.28
1248,1,0,1,1,3,4,10,16522,90.12
1249,1,2,1,1,0,0,5,8690,54.42
1250,1,3,1,1,1,0,7,13868,78.23
1251,1,4,3,1,3,0,12,17186,93.28
1252,3,0,5,3,5,0,16,18081,97.67
1253,1,1,2,1,1,0,6,11521,68.36
1254,1,0,0,1,0,0,2,32,3.72
1255,1,1,1,1,1,0,5,8690,54.42
1256,1,0,3,1,4,0,9,15950,87.44
1257,3,0,5,1,5,0,14,17699,95.82
1258,1,2,1,1,2,0,7,13868,78.23
1259,1,0,0,1,0,0,2,32,3.72
1260,3,0,4,1,2,0,10,16522,90.12
1261,1,0,1,1,0,0,3,1352,17.01
1262,1,2,1,1,0,0,5,8690,54.42
1263,1,4,1,1,1,0,8,15186,83.84
1264,1,0,1,1,0,0,3,1352,17.01
1265,1,3,0,1,2,0,7,13868,78.23
1266,1,2,0,1,0,0,4,4966,36.77
1267,1,0,2,1,2,0,6,11521,68.36
1268,1,2,0,1,3,0,7,13868,78.23
1269,3,0,5,1,0,0,9,15950,87.44
1270,1,4,0,1,0,0,6,11521,68.36
1271,1,0,1,1,0,0,3,1352,17.01
1272,1,0,1,1,0,0,3,1352,17.01
1273,1,0,0,1,0,0,2,32,3.72
1274,1,0,5,2,0,0,8,15186,83.84
1275,3,0,5,1,5,6,20,18419,99.31
1276,1,0,1,1,3,0,6,11521,68.36
1277,1,2,0,1,0,0,4,4966,36.77
1278,1,1,2,1,1,0,6,11521,68.36
1279,1,1,0,1,0,0,3,1352,17.01
1280,1,4,1,1,2,0,9,15950,87.44
1281,1,1,2,1,0,0,5,8690,54.42
1282,1,0,1,1,1,0,4,4966,36.77
1283,1,1,1,1,0,0,4,4966,36.77
1284,1,1,1,1,0,0,4,4966,36.77
1285,1,0,1,1,0,0,3,1352,17.01
1286,1,0,2,1,0,0,4,4966,36.77
1287,1,0,0,1,0,0,2,32,3.72
1288,1,0,2,1,0,6,10,16522,90.12
1289,1,1,1,1,3,0,7,13868,78.23
1291,1,0,3,2,0,0,6,11521,68.36
1292,3,0,5,2,1,0,11,16947,91.91
1293,1,0,1,1,0,0,3,1352,17.01
1294,1,3,3,3,1,0,11,16947,91.91
1295,1,1,0,1,0,0,3,1352,17.01
1296,1,1,0,1,0,0,3,1352,17.01
1298,3,0,4,1,5,0,13,17456,94.66
1299,1,2,1,1,1,0,6,11521,68.36
1300,1,4,0,1,0,0,6,11521,68.36
1301,1,3,1,1,0,0,6,11521,68.36
1302,1,4,0,1,0,0,6,11521,68.36
1303,1,4,0,1,0,0,6,11521,68.36
1304,1,0,4,1,0,0,6,11521,68.36
1305,1,0,1,1,0,0,3,1352,17.01
1306,3,0,5,2,5,0,15,17888,96.85
1307,1,2,4,2,0,4,13,17456,94.66
1308,1,0,2,1,1,0,5,8690,54.42
1309,1,4,2,2,3,0,12,17186,93.28
1310,1,3,0,1,0,0,5,8690,54.42
1311,1,0,0,1,0,0,2,32,3.72
1312,1,2,1,1,0,0,5,8690,54.42
1313,1,1,1,1,0,0,4,4966,36.77
1314,1,1,1,1,3,0,7,13868,78.23
1315,3,0,3,1,5,6,18,18287,98.68
1316,1,2,0,1,0,0,4,4966,36.77
1317,1,0,3,1,1,0,6,11521,68.36
1318,1,1,0,1,1,0,4,4966,36.77
1319,1,0,2,1,1,0,5,8690,54.42
1320,3,0,5,2,2,2,14,17699,95.82
1321,1,2,0,1,0,0,4,4966,36.77
1322,1,1,0,1,0,0,3,1352,17.01
1323,3,0,5,4,3,0,15,17888,96.85
1324,1,0,4,1,2,0,8,15186,83.84
1325,1,0,1,1,0,0,3,1352,17.01
1326,3,0,5,2,5,6,21,18462,99.52
1327,1,4,0,1,0,0,6,11521,68.36
1328,1,0,3,2,0,0,6,11521,68.36
1329,1,5,0,1,0,0,7,13868,78.23
1330,1,2,0,0,1,0,4,4966,36.77
1331,1,0,5,1,3,0,10,16522,90.12
1332,1,0,0,1,0,0,2,32,3.72
1333,1,1,0,1,0,0,3,1352,17.01
1334,1,0,0,1,0,0,2,32,3.72
1335,1,3,2,2,2,0,10,16522,90.12
1336,1,0,3,1,0,4,9,15950,87.44
1337,1,1,1,1,0,0,4,4966,36.77
1338,1,1,2,1,0,0,5,8690,54.42
1339,1,0,2,1,1,0,5,8690,54.42
1340,1,0,0,1,1,0,3,1352,17.01
1341,1,0,1,1,3,10,16,18081,97.67
1342,1,0,0,1,0,0,2,32,3.72
1343,1,4,0,1,0,0,6,11521,68.36
1344,1,1,0,1,0,0,3,1352,17.01
1345,1,0,0,1,1,0,3,1352,17.01
1346,1,5,1,1,0,0,8,15186,83.84
1347,1,3,0,1,0,0,5,8690,54.42
1348,3,0,4,2,5,8,22,18498,99.73
1349,1,0,2,1,1,0,5,8690,54.42
1350,3,0,5,2,3,2,15,17888,96.85
1351,1,0,5,1,4,0,11,16947,91.91
1352,1,1,1,1,0,0,4,4966,36.77
1353,1,0,2,1,0,0,4,4966,36.77
1354,1,1,1,1,0,0,4,4966,36.77
1355,1,1,0,1,0,0,3,1352,17.01
1356,1,0,2,1,0,0,4,4966,36.77
1357,1,3,0,1,0,0,5,8690,54.42
1358,1,1,1,1,2,0,6,11521,68.36
1359,1,1,1,1,3,0,7,13868,78.23
1360,1,1,2,1,3,0,8,15186,83.84
1361,1,1,1,1,2,0,6,11521,68.36
1362,1,1,1,1,0,0,4,4966,36.77
1363,1,3,0,1,0,0,5,8690,54.42
1364,3,0,5,3,3,0,14,17699,95.82
1365,1,1,1,1,0,0,4,4966,36.77
1366,1,0,3,1,1,0,6,11521,68.36
1367,1,1,0,1,3,0,6,11521,68.36
1368,1,1,0,1,0,0,3,1352,17.01
1369,1,0,1,1,0,0,3,1352,17.01
1370,1,0,3,1,1,0,6,11521,68.36
1371,1,3,1,1,0,0,6,11521,68.36
1372,1,3,0,1,0,0,5,8690,54.42
1373,1,1,0,1,2,0,5,8690,54.42
1374,1,0,4,2,4,0,11,16947,91.91
1375,1,1,0,1,1,0,4,4966,36.77
1376,1,1,2,1,0,0,5,8690,54.42
1377,1,0,0,1,1,0,3,1352,17.01
1378,1,1,1,1,1,0,5,8690,54.42
1379,1,0,1,1,0,0,3,1352,17.01
1380,1,4,0,1,0,0,6,11521,68.36
1381,1,0,2,1,2,0,6,11521,68.36
1382,1,0,3,1,0,0,5,8690,54.42
1383,1,5,3,1,0,0,10,16522,90.12
1384,1,3,3,1,0,0,8,15186,83.84
1385,3,0,5,4,5,0,17,18193,98.23
1386,1,3,1,1,0,0,6,11521,68.36
1387,1,2,0,1,0,0,4,4966,36.77
1388,1,3,0,1,0,0,5,8690,54.42
1389,1,4,0,1,0,0,6,11521,68.36
1390,1,2,0,1,0,0,4,4966,36.77
1391,1,0,1,1,1,0,4,4966,36.77
1392,1,0,0,1,0,0,2,32,3.72
1393,1,0,0,1,0,0,2,32,3.72
1394,1,1,0,1,0,0,3,1352,17.01
1395,1,0,3,1,0,0,5,8690,54.42
1396,1,0,0,1,0,0,2,32,3.72
1397,1,0,1,1,0,10,13,17456,94.66
1398,1,0,1,1,0,0,3,1352,17.01
1399,1,2,0,1,4,0,8,15186,83.84
1400,1,1,2,1,1,0,6,11521,68.36
1401,1,0,0,1,0,0,2,32,3.72
1402,1,1,1,1,0,0,4,4966,36.77
1403,1,0,1,1,1,0,4,4966,36.77
1404,1,2,1,1,2,0,7,13868,78.23
1405,1,4,2,1,0,0,8,15186,83.84
1406,1,4,0,1,0,0,6,11521,68.36
1407,1,1,1,1,2,0,6,11521,68.36
1408,1,0,0,1,1,0,3,1352,17.01
1409,1,0,0,1,0,0,2,32,3.72
1410,1,1,2,1,3,0,8,15186,83.84
1411,3,0,5,2,4,0,14,17699,95.82
1412,3,0,5,2,5,0,15,17888,96.85
1413,1,4,0,1,0,0,6,11521,68.36
1414,1,0,1,1,0,0,3,1352,17.01
1415,1,0,1,1,3,0,6,11521,68.36
1416,1,1,0,1,0,6,9,15950,87.44
1417,1,0,0,1,1,0,3,1352,17.01
1418,1,0,0,1,0,0,2,32,3.72
1419,1,0,3,2,2,4,12,17186,93.28
1420,1,0,4,2,1,0,8,15186,83.84
1421,1,0,1,1,1,0,4,4966,36.77
1422,1,1,1,1,0,0,4,4966,36.77
1423,1,2,2,2,0,0,7,13868,78.23
1424,1,4,1,1,0,0,7,13868,78.23
1425,1,0,0,1,2,0,4,4966,36.77
1426,1,1,0,1,0,0,3,1352,17.01
1427,1,3,1,1,0,0,6,11521,68.36
1428,1,1,1,1,2,0,6,11521,68.36
1429,1,1,1,1,0,0,4,4966,36.77
1430,1,4,4,2,4,0,15,17888,96.85
1431,1,3,1,1,0,0,6,11521,68.36
1432,1,0,1,1,0,0,3,1352,17.01
1433,1,2,0,1,0,0,4,4966,36.77
1434,3,2,5,2,3,0,15,17888,96.85
1435,1,0,0,1,0,0,2,32,3.72
1436,1,3,1,1,0,0,6,11521,68.36
1437,1,4,1,1,0,0,7,13868,78.23
1438,1,1,0,1,0,0,3,1352,17.01
1439,1,0,0,1,0,0,2,32,3.72
1440,1,3,0,1,0,0,5,8690,54.42
1441,1,0,2,1,3,0,7,13868,78.23
1443,1,0,2,1,1,0,5,8690,54.42
1444,1,1,1,1,0,0,4,4966,36.77
1445,1,0,5,2,0,0,8,15186,83.84
1446,1,4,4,2,0,0,11,16947,91.91
1447,1,1,2,1,1,0,6,11521,68.36
1448,1,4,0,1,0,0,6,11521,68.36
1449,1,0,0,1,0,0,2,32,3.72
1450,1,5,2,2,0,0,10,16522,90.12
1451,1,1,0,1,2,0,5,8690,54.42
1452,1,0,2,1,0,0,4,4966,36.77
1453,1,4,0,1,1,0,7,13868,78.23
1454,1,0,2,1,0,0,4,4966,36.77
1455,1,0,0,1,0,2,4,4966,36.77
1456,1,4,0,1,0,0,6,11521,68.36
1457,1,0,1,1,0,0,3,1352,17.01
1458,1,0,2,1,0,0,4,4966,36.77
1459,1,3,0,1,0,0,5,8690,54.42
1460,3,0,5,1,5,0,14,17699,95.82
1461,1,4,3,2,1,0,11,16947,91.91
1462,1,1,1,1,0,0,4,4966,36.77
1463,1,2,2,1,0,0,6,11521,68.36
1464,3,0,5,2,5,6,21,18462,99.52
1465,1,3,0,1,0,0,5,8690,54.42
1466,1,0,1,1,2,0,5,8690,54.42
1467,1,5,2,2,0,0,10,16522,90.12
1468,3,0,5,2,2,0,12,17186,93.28
1469,1,1,2,2,0,0,6,11521,68.36
1470,1,0,0,1,0,0,2,32,3.72
1471,1,1,0,1,0,0,3,1352,17.01
1472,1,4,0,1,0,0,6,11521,68.36
1473,1,0,0,1,1,0,3,1352,17.01
1474,1,0,1,1,0,0,3,1352,17.01
1475,1,4,2,1,0,0,8,15186,83.84
1476,1,0,1,1,0,0,3,1352,17.01
1477,1,1,1,1,2,0,6,11521,68.36
1478,1,2,2,1,0,6,12,17186,93.28
1479,1,1,1,1,0,0,4,4966,36.77
1480,1,0,1,1,0,0,3,1352,17.01
1481,1,0,3,2,1,0,7,13868,78.23
1482,1,2,2,1,1,0,7,13868,78.23
1483,1,1,1,1,0,0,4,4966,36.77
1484,1,5,0,1,0,0,7,13868,78.23
1485,1,3,0,1,3,0,8,15186,83.84
1486,3,3,5,2,3,0,16,18081,97.67
1487,1,0,3,2,0,0,6,11521,68.36
1488,1,0,0,1,0,0,2,32,3.72
1489,1,0,0,1,0,0,2,32,3.72
1490,1,1,1,1,1,0,5,8690,54.42
1491,1,1,3,1,0,0,6,11521,68.36
1492,1,5,1,1,0,0,8,15186,83.84
1493,1,0,2,1,1,0,5,8690,54.42
1494,1,0,0,1,3,0,5,8690,54.42
1495,1,0,1,1,0,0,3,1352,17.01
1496,1,0,0,1,0,0,2,32,3.72
1497,1,4,0,1,0,0,6,11521,68.36
1498,1,2,0,1,0,0,4,4966,36.77
1499,3,0,5,2,5,0,15,17888,96.85
1500,1,4,0,1,0,0,6,11521,68.36
1501,1,0,1,1,0,0,3,1352,17.01
1502,1,2,1,1,0,0,5,8690,54.42
1503,1,0,0,1,3,0,5,8690,54.42
1504,1,1,0,1,0,0,3,1352,17.01
1505,1,4,0,1,0,0,6,11521,68.36
1506,1,0,5,2,0,0,8,15186,83.84
1507,1,2,0,1,0,0,4,4966,36.77
1508,1,3,0,1,0,0,5,8690,54.42
1509,1,1,0,0,2,0,4,4966,36.77
1510,1,0,0,1,1,0,3,1352,17.01
1511,1,1,2,1,1,0,6,11521,68.36
1512,1,1,1,1,0,0,4,4966,36.77
1513,1,0,3,2,3,0,9,15950,87.44
1514,1,1,2,1,0,0,5,8690,54.42
1515,1,2,0,1,0,0,4,4966,36.77
1516,1,1,3,1,2,0,8,15186,83.84
1517,1,0,2,1,0,0,4,4966,36.77
1518,3,3,5,2,4,0,17,18193,98.23
1519,1,0,1,1,0,0,3,1352,17.01
1520,1,0,0,1,0,0,2,32,3.72
1521,1,0,5,1,0,0,7,13868,78.23
1522,1,0,1,1,3,0,6,11521,68.36
1523,3,0,5,2,3,0,13,17456,94.66
1524,1,0,4,2,0,0,7,13868,78.23
1525,1,1,1,1,0,6,10,16522,90.12
1526,1,2,1,1,0,0,5,8690,54.42
1527,1,1,0,1,2,0,5,8690,54.42
1528,1,4,0,1,0,0,6,11521,68.36
1529,1,1,0,1,0,0,3,1352,17.01
1530,1,1,1,1,0,0,4,4966,36.77
1531,1,3,1,1,2,4,12,17186,93.28
1532,1,0,1,1,0,0,3,1352,17.01
1533,1,0,0,1,0,0,2,32,3.72
1534,1,1,1,1,0,6,10,16522,90.12
1535,1,0,1,1,0,0,3,1352,17.01
1536,1,0,2,1,0,0,4,4966,36.77
1537,3,0,5,4,3,0,15,17888,96.85
1538,1,0,2,1,1,0,5,8690,54.42
1539,1,1,0,1,0,0,3,1352,17.01
1540,1,3,0,1,1,0,6,11521,68.36
1541,1,0,1,1,0,0,3,1352,17.01
1542,1,0,4,1,4,0,10,16522,90.12
1543,1,0,0,1,0,0,2,32,3.72
1544,1,2,1,1,2,0,7,13868,78.23
1545,1,2,0,1,0,0,4,4966,36.77
1546,1,0,1,1,0,0,3,1352,17.01
1547,1,1,0,1,0,0,3,1352,17.01
1548,1,4,0,1,0,0,6,11521,68.36
1549,1,2,1,1,0,0,5,8690,54.42
1550,1,2,0,1,1,0,5,8690,54.42
1551,1,5,1,1,0,0,8,15186,83.84
1552,1,2,1,1,0,0,5,8690,54.42
1553,1,1,0,1,0,2,5,8690,54.42
1554,1,0,1,1,4,0,7,13868,78.23
1555,1,0,1,1,0,0,3,1352,17.01
1556,1,0,3,1,2,0,7,13868,78.23
1557,1,2,1,1,0,0,5,8690,54.42
1558,1,0,1,1,2,0,5,8690,54.42
1559,1,2,0,1,3,0,7,13868,78.23
1560,1,2,0,1,1,0,5,8690,54.42
1561,1,4,0,1,0,0,6,11521,68.36
1562,1,1,3,1,3,0,9,15950,87.44
1563,1,0,0,1,0,0,2,32,3.72
1564,1,0,0,1,0,0,2,32,3.72
1565,1,0,0,1,3,2,7,13868,78.23
1566,3,1,5,2,4,0,15,17888,96.85
1567,1,0,2,1,1,0,5,8690,54.42
1568,1,4,4,3,1,0,13,17456,94.66
1569,1,1,3,1,0,0,6,11521,68.36
1570,1,0,2,1,1,4,9,15950,87.44
1572,1,0,0,1,4,0,6,11521,68.36
1573,3,1,5,2,3,0,14,17699,95.82
1574,1,3,1,1,1,0,7,13868,78.23
1575,1,2,1,1,0,0,5,8690,54.42
1576,1,1,1,1,0,0,4,4966,36.77
1577,1,0,3,2,0,0,6,11521,68.36
1578,1,1,0,1,0,0,3,1352,17.01
1579,1,1,0,1,0,0,3,1352,17.01
1580,1,2,1,1,0,0,5,8690,54.42
1581,1,0,0,1,0,0,2,32,3.72
1582,1,4,0,1,0,0,6,11521,68.36
1583,1,4,0,1,0,0,6,11521,68.36
1584,1,0,1,1,2,0,5,8690,54.42
1585,1,1,1,1,2,0,6,11521,68.36
1586,1,1,0,1,0,0,3,1352,17.01
1587,1,0,0,1,0,0,2,32,3.72
1588,1,0,3,1,3,6,14,17699,95.82
1589,1,3,1,1,0,0,6,11521,68.36
1590,1,4,0,1,3,0,9,15950,87.44
1591,1,3,0,1,1,0,6,11521,68.36
1592,1,1,0,1,0,0,3,1352,17.01
1593,1,3,0,1,0,0,5,8690,54.42
1594,1,1,1,1,0,0,4,4966,36.77
1595,1,0,0,1,0,0,2,32,3.72
1596,1,0,2,1,1,0,5,8690,54.42
1597,1,2,0,1,1,0,5,8690,54.42
1598,1,3,0,1,3,0,8,15186,83.84
1599,1,0,0,1,0,0,2,32,3.72
1600,1,3,0,1,1,0,6,11521,68.36
1601,1,0,0,1,0,0,2,32,3.72
1602,1,0,1,1,1,0,4,4966,36.77
1603,1,1,0,1,0,0,3,1352,17.01
1604,3,0,5,1,5,4,18,18287,98.68
1605,1,0,1,1,0,0,3,1352,17.01
1606,1,3,0,1,0,0,5,8690,54.42
1607,1,0,1,1,0,0,3,1352,17.01
1608,1,1,1,1,0,0,4,4966,36.77
1609,1,1,0,1,0,0,3,1352,17.01
1610,1,0,0,1,1,0,3,1352,17.01
1611,1,2,0,1,0,0,4,4966,36.77
1612,1,0,2,2,1,0,6,11521,68.36
1613,1,3,0,1,2,0,7,13868,78.23
1614,1,1,1,1,0,4,8,15186,83.84
1615,1,1,2,1,1,0,6,11521,68.36
1616,1,1,0,1,0,0,3,1352,17.01
1617,1,1,1,1,2,0,6,11521,68.36
1618,1,0,1,1,2,0,5,8690,54.42
1619,3,0,5,2,5,0,15,17888,96.85
1620,1,4,2,2,0,0,9,15950,87.44
1621,1,0,1,1,0,0,3,1352,17.01
1622,1,2,1,1,2,0,7,13868,78.23
1623,1,0,2,1,0,0,4,4966,36.77
1624,1,1,2,1,2,0,7,13868,78.23
1625,1,0,1,1,0,0,3,1352,17.01
1626,1,1,0,1,2,0,5,8690,54.42
1627,1,1,1,1,0,0,4,4966,36.77
1628,1,1,0,1,0,0,3,1352,17.01
1629,1,2,2,1,2,0,8,15186,83.84
1630,3,1,5,2,5,0,16,18081,97.67
1631,1,3,1,1,0,0,6,11521,68.36
1632,1,3,0,1,1,0,6,11521,68.36
1633,1,0,1,1,1,0,4,4966,36.77
1634,1,0,1,1,2,0,5,8690,54.42
1635,1,0,1,1,0,0,3,1352,17.01
1636,1,0,1,1,0,0,3,1352,17.01
1637,1,2,1,1,0,0,5,8690,54.42
1638,3,0,5,1,3,0,12,17186,93.28
1639,1,1,1,1,0,0,4,4966,36.77
1640,1,0,1,1,0,0,3,1352,17.01
1641,1,0,0,1,0,0,2,32,3.72
1642,1,2,0,0,0,0,3,1352,17.01
1643,1,1,0,1,0,0,3,1352,17.01
1644,3,0,4,1,3,4,15,17888,96.85
1645,1,0,2,1,2,0,6,11521,68.36
1646,3,0,3,1,4,6,17,18193,98.23
1647,1,3,2,1,0,0,7,13868,78.23
1648,1,1,3,2,3,0,10,16522,90.12
1649,1,3,2,1,2,0,9,15950,87.44
1650,1,2,3,1,1,0,8,15186,83.84
1651,1,2,1,1,0,0,5,8690,54.42
1652,1,4,1,1,2,0,9,15950,87.44
1653,1,3,0,1,1,0,6,11521,68.36
1654,1,0,5,2,0,0,8,15186,83.84
1655,1,0,1,1,0,0,3,1352,17.01
1656,1,0,2,1,0,0,4,4966,36.77
1657,1,0,5,2,0,0,8,15186,83.84
1658,1,0,3,1,1,0,6,11521,68.36
1659,1,1,1,1,0,0,4,4966,36.77
1660,1,0,0,1,0,0,2,32,3.72
1661,1,1,2,1,2,0,7,13868,78.23
1662,1,0,1,1,0,2,5,8690,54.42
1663,3,1,5,2,3,4,18,18287,98.68
1664,1,1,0,1,0,0,3,1352,17.01
1665,1,2,1,1,0,0,5,8690,54.42
1666,1,0,0,1,1,0,3,1352,17.01
1667,1,4,1,1,2,0,9,15950,87.44
1668,1,0,1,1,0,0,3,1352,17.01
1669,1,1,2,1,2,4,11,16947,91.91
1670,1,0,1,1,0,0,3,1352,17.01
1671,1,1,4,2,4,0,12,17186,93.28
1672,1,2,1,1,0,0,5,8690,54.42
1673,1,0,1,1,0,0,3,1352,17.01
1674,1,0,1,1,0,0,3,1352,17.01
1675,1,0,3,1,1,0,6,11521,68.36
1676,1,4,1,1,0,0,7,13868,78.23
1677,3,0,5,2,5,0,15,17888,96.85
1678,1,3,1,1,3,0,9,15950,87.44
1679,1,3,0,1,0,0,5,8690,54.42
1680,3,0,3,1,3,6,16,18081,97.67
1681,1,2,1,1,3,0,8,15186,83.84
1682,1,4,0,1,0,0,6,11521,68.36
1685,1,3,0,1,1,0,6,11521,68.36
1686,1,2,2,1,0,0,6,11521,68.36
1687,1,2,1,1,0,2,7,13868,78.23
1688,1,0,0,1,0,0,2,32,3.72
1689,1,0,0,1,0,0,2,32,3.72
1690,1,0,0,1,2,0,4,4966,36.77
1691,1,1,0,1,0,0,3,1352,17.01
1692,1,0,1,1,1,0,4,4966,36.77
1693,1,1,0,1,0,0,3,1352,17.01
1694,1,1,1,1,0,0,4,4966,36.77
1695,1,4,0,1,0,0,6,11521,68.36
1696,1,1,0,1,1,0,4,4966,36.77
1697,1,1,2,1,0,0,5,8690,54.42
1698,1,1,2,1,1,0,6,11521,68.36
1699,1,1,1,1,0,0,4,4966,36.77
1700,1,1,2,1,2,6,13,17456,94.66
1701,1,2,1,1,0,0,5,8690,54.42
1702,1,0,0,1,0,4,6,11521,68.36
1703,1,0,1,1,0,0,3,1352,17.01
1704,1,1,1,1,0,0,4,4966,36.77
1705,1,0,1,1,0,0,3,1352,17.01
1706,1,0,0,1,0,6,8,15186,83.84
1707,1,0,1,1,0,0,3,1352,17.01
1708,1,2,0,1,0,0,4,4966,36.77
1709,1,1,1,1,0,0,4,4966,36.77
1710,1,1,1,1,1,4,9,15950,87.44
1711,1,1,0,1,0,0,3,1352,17.01
1712,1,4,1,1,0,0,7,13868,78.23
1713,1,0,0,1,0,0,2,32,3.72
1714,1,0,1,1,0,0,3,1352,17.01
1715,1,0,0,1,0,0,2,32,3.72
1716,1,1,1,1,0,6,10,16522,90.12
1717,1,4,1,1,0,0,7,13868,78.23
1718,1,4,0,1,0,0,6,11521,68.36
1719,1,3,3,1,0,0,8,15186,83.84
1720,1,1,1,1,0,0,4,4966,36.77
1721,1,0,0,1,0,0,2,32,3.72
1722,1,0,2,1,0,4,8,15186,83.84
1723,1,0,4,2,0,6,13,17456,94.66
1724,1,1,0,1,0,0,3,1352,17.01
1725,1,0,1,1,0,0,3,1352,17.01
1726,1,0,1,1,0,0,3,1352,17.01
1727,1,0,1,1,0,0,3,1352,17.01
1728,3,1,5,2,5,0,16,18081,97.67
1729,1,0,0,1,1,0,3,1352,17.01
1730,1,0,1,2,0,0,4,4966,36.77
1731,1,0,2,1,0,0,4,4966,36.77
1732,1,0,2,1,0,0,4,4966,36.77
1733,3,0,3,2,2,0,10,16522,90.12
1734,1,3,0,2,0,0,6,11521,68.36
1735,1,2,0,1,0,0,4,4966,36.77
1736,1,0,3,1,1,0,6,11521,68.36
1737,1,4,0,1,0,0,6,11521,68.36
1739,1,3,0,1,2,0,7,13868,78.23
1740,1,0,1,1,0,0,3,1352,17.01
1741,1,1,1,1,0,0,4,4966,36.77
1742,1,1,1,1,0,0,4,4966,36.77
1743,1,1,1,1,0,0,4,4966,36.77
1744,1,1,0,1,0,0,3,1352,17.01
1745,1,4,0,1,0,0,6,11521,68.36
1746,1,2,0,1,0,0,4,4966,36.77
1747,1,1,1,1,0,0,4,4966,36.77
1748,1,0,2,1,0,0,4,4966,36.77
1749,1,4,2,1,0,0,8,15186,83.84
1750,1,2,1,1,0,0,5,8690,54.42
1751,1,1,2,1,3,0,8,15186,83.84
1752,1,1,2,1,1,0,6,11521,68.36
1753,1,0,0,1,0,0,2,32,3.72
1754,3,0,5,2,5,8,23,18538,99.86
1755,1,4,0,1,0,0,6,11521,68.36
1756,1,1,1,1,2,0,6,11521,68.36
1757,1,1,0,0,0,0,2,32,3.72
1758,1,0,1,1,0,6,9,15950,87.44
1759,1,0,3,1,1,0,6,11521,68.36
1760,1,0,3,2,2,0,8,15186,83.84
1761,1,3,1,1,0,0,6,11521,68.36
1762,1,0,2,1,1,0,5,8690,54.42
1763,1,0,4,2,4,0,11,16947,91.91
1764,1,2,1,1,2,0,7,13868,78.23
1765,1,1,1,1,0,0,4,4966,36.77
1766,1,1,0,1,0,0,3,1352,17.01
1767,1,3,0,1,0,0,5,8690,54.42
1768,1,0,1,1,0,0,3,1352,17.01
1769,1,0,2,1,0,0,4,4966,36.77
1770,1,2,4,2,0,0,9,15950,87.44
1771,1,0,0,1,0,0,2,32,3.72
1772,1,0,1,1,0,0,3,1352,17.01
1773,1,1,2,1,0,0,5,8690,54.42
1774,1,2,1,1,0,0,5,8690,54.42
1775,1,0,1,1,0,0,3,1352,17.01
1776,1,4,0,1,0,0,6,11521,68.36
1777,1,5,2,2,0,0,10,16522,90.12
1778,3,1,5,1,5,4,19,18362,99.04
1779,3,0,5,2,5,0,15,17888,96.85
1780,1,1,0,1,1,0,4,4966,36.77
1781,1,2,0,2,0,0,5,8690,54.42
1782,1,1,0,1,0,0,3,1352,17.01
1783,1,0,1,1,1,0,4,4966,36.77
1784,3,0,5,2,2,0,12,17186,93.28
1785,1,0,1,1,0,4,7,13868,78.23
1787,1,0,3,2,0,0,6,11521,68.36
1788,1,1,0,1,0,0,3,1352,17.01
1789,1,1,0,1,3,6,12,17186,93.28
1790,1,5,2,2,0,0,10,16522,90.12
1791,3,0,4,1,5,0,13,17456,94.66
1792,1,1,0,1,0,0,3,1352,17.01
1793,1,3,0,1,2,0,7,13868,78.23
1794,1,0,0,1,0,10,12,17186,93.28
1795,1,1,3,2,0,0,7,13868,78.23
1796,1,0,2,1,0,0,4,4966,36.77
1797,1,1,1,1,0,0,4,4966,36.77
1798,1,4,0,1,0,0,6,11521,68.36
1799,1,0,1,1,0,0,3,1352,17.01
1800,1,2,2,1,3,0,9,15950,87.44
1801,3,0,4,1,1,0,9,15950,87.44
1802,1,0,0,1,0,0,2,32,3.72
1803,1,4,2,2,0,0,9,15950,87.44
1804,1,2,1,1,0,0,5,8690,54.42
1805,1,0,1,1,0,0,3,1352,17.01
1806,1,0,0,1,0,0,2,32,3.72
1807,1,4,1,1,0,0,7,13868,78.23
1808,3,0,5,2,3,4,17,18193,98.23
1809,1,0,1,1,0,0,3,1352,17.01
1810,1,0,4,2,1,0,8,15186,83.84
1811,1,4,0,1,0,0,6,11521,68.36
1812,1,1,0,1,0,0,3,1352,17.01
1813,1,1,1,1,0,0,4,4966,36.77
1814,1,0,2,2,1,0,6,11521,68.36
1815,1,1,0,1,2,0,5,8690,54.42
1816,1,1,1,1,0,0,4,4966,36.77
1817,1,0,0,1,0,0,2,32,3.72
1818,1,0,4,1,0,0,6,11521,68.36
1819,1,1,0,1,0,0,3,1352,17.01
1820,1,0,0,1,0,6,8,15186,83.84
1821,1,4,0,1,0,0,6,11521,68.36
1822,1,1,0,1,3,0,6,11521,68.36
1823,3,0,5,2,3,2,15,17888,96.85
1824,1,0,1,1,0,0,3,1352,17.01
1825,1,0,1,1,0,0,3,1352,17.01
1826,1,2,1,1,3,0,8,15186,83.84
1827,3,0,5,1,5,4,18,18287,98.68
1828,1,4,1,1,0,0,7,13868,78.23
1829,1,0,2,1,0,0,4,4966,36.77
1830,1,1,1,1,2,0,6,11521,68.36
1831,1,0,3,1,1,0,6,11521,68.36
1832,1,0,1,1,0,0,3,1352,17.01
1833,1,2,2,1,0,0,6,11521,68.36
1834,1,1,0,1,0,0,3,1352,17.01
1835,1,0,3,2,1,0,7,13868,78.23
1836,1,5,0,1,2,0,9,15950,87.44
1837,3,0,3,1,2,0,9,15950,87.44
1838,1,0,1,1,3,0,6,11521,68.36
1839,1,0,1,1,0,4,7,13868,78.23
1840,1,4,4,2,0,0,11,16947,91.91
1841,1,0,1,1,0,0,3,1352,17.01
1842,1,0,1,1,1,0,4,4966,36.77
1843,1,0,1,1,0,0,3,1352,17.01
1844,1,0,2,1,0,2,6,11521,68.36
1845,1,3,0,1,0,0,5,8690,54.42
1846,1,0,1,1,0,0,3,1352,17.01
1847,1,1,2,1,0,0,5,8690,54.42
1848,3,0,4,2,5,0,14,17699,95.82
1849,1,1,0,1,0,0,3,1352,17.01
1850,1,0,4,2,0,0,7,13868,78.23
1851,1,0,2,1,1,4,9,15950,87.44
1852,1,0,2,1,0,0,4,4966,36.77
1853,1,0,3,2,1,0,7,13868,78.23
1854,1,1,2,1,0,0,5,8690,54.42
1855,1,2,1,1,0,4,9,15950,87.44
1856,1,4,0,1,0,0,6,11521,68.36
1857,1,2,0,1,0,0,4,4966,36.77
1858,1,0,1,1,1,0,4,4966,36.77
1859,1,0,1,1,0,0,3,1352,17.01
1860,1,0,1,1,0,0,3,1352,17.01
1861,1,2,2,1,0,0,6,11521,68.36
1862,1,3,0,1,0,0,5,8690,54.42
1863,1,2,0,1,0,0,4,4966,36.77
1864,3,4,5,4,5,0,21,18462,99.52
1865,1,1,0,1,1,0,4,4966,36.77
1866,1,1,1,1,0,0,4,4966,36.77
1867,1,4,2,1,0,0,8,15186,83.84
1868,1,3,3,1,2,0,10,16522,90.12
1869,1,1,0,1,0,0,3,1352,17.01
1870,1,3,1,1,0,0,6,11521,68.36
1871,1,1,3,1,1,0,7,13868,78.23
1872,1,0,0,1,0,0,2,32,3.72
1873,1,0,0,1,0,0,2,32,3.72
1874,1,4,0,1,0,0,6,11521,68.36
1875,1,2,0,1,0,0,4,4966,36.77
1876,1,2,1,1,3,0,8,15186,83.84
1877,1,1,1,1,1,0,5,8690,54.42
1878,3,0,5,2,5,0,15,17888,96.85
1879,1,1,1,1,0,0,4,4966,36.77
1880,1,3,1,1,0,0,6,11521,68.36
1881,1,1,1,1,0,0,4,4966,36.77
1882,1,0,1,1,0,0,3,1352,17.01
1883,1,2,0,1,1,0,5,8690,54.42
1884,1,3,0,1,0,0,5,8690,54.42
1885,1,0,1,1,1,0,4,4966,36.77
1886,1,4,0,1,0,0,6,11521,68.36
1887,3,0,5,2,5,0,15,17888,96.85
1888,1,3,1,1,0,0,6,11521,68.36
1889,3,0,5,2,3,0,13,17456,94.66
1890,1,0,1,1,1,0,4,4966,36.77
1891,1,0,2,1,2,0,6,11521,68.36
1892,1,1,0,1,0,0,3,1352,17.01
1893,1,0,1,1,3,0,6,11521,68.36
1894,1,1,0,1,0,0,3,1352,17.01
1895,1,4,0,1,0,0,6,11521,68.36
1896,1,4,0,1,1,0,7,13868,78.23
1897,1,0,1,1,0,0,3,1352,17.01
1898,1,4,0,1,0,0,6,11521,68.36
1899,1,0,1,1,0,0,3,1352,17.01
1900,1,3,0,1,0,0,5,8690,54.42
1901,1,1,0,1,0,0,3,1352,17.01
1902,1,2,0,1,0,0,4,4966,36.77
1903,1,0,4,1,0,6,12,17186,93.28
1904,1,0,1,1,0,0,3,1352,17.01
1905,1,0,1,1,3,0,6,11521,68.36
1906,1,1,1,1,0,0,4,4966,36.77
1907,1,1,0,1,0,0,3,1352,17.01
1908,3,0,5,2,5,6,21,18462,99.52
1909,1,0,0,1,0,2,4,4966,36.77
1910,1,2,0,1,0,0,4,4966,36.77
1911,1,1,0,1,0,0,3,1352,17.01
1912,1,0,1,1,0,0,3,1352,17.01
1913,1,0,0,1,3,0,5,8690,54.42
1914,1,0,0,1,1,0,3,1352,17.01
1915,1,0,1,1,2,0,5,8690,54.42
1916,1,1,1,1,0,0,4,4966,36.77
1917,1,0,0,1,0,0,2,32,3.72
1918,1,1,1,1,1,0,5,8690,54.42
1919,1,0,3,2,0,0,6,11521,68.36
1920,1,2,2,1,0,0,6,11521,68.36
1921,1,0,0,0,0,0,1,1,0.08
1922,1,3,2,1,0,0,7,13868,78.23
1923,1,2,1,1,0,0,5,8690,54.42
1924,1,1,0,1,0,0,3,1352,17.01
1925,1,2,1,1,0,0,5,8690,54.42
1926,1,2,1,1,0,0,5,8690,54.42
1927,1,1,1,1,0,0,4,4966,36.77
1928,1,0,3,1,1,0,6,11521,68.36
1929,1,0,1,1,0,0,3,1352,17.01
1930,1,1,0,1,3,0,6,11521,68.36
1931,1,2,2,2,0,0,7,13868,78.23
1932,1,1,0,1,2,0,5,8690,54.42
1933,1,0,2,1,3,0,7,13868,78.23
1934,3,0,5,3,3,0,14,17699,95.82
1935,1,1,2,1,0,6,11,16947,91.91
1936,1,2,2,1,3,0,9,15950,87.44
1937,1,1,1,1,0,0,4,4966,36.77
1938,1,1,2,1,0,0,5,8690,54.42
1939,1,2,0,1,0,0,4,4966,36.77
1940,1,1,1,1,0,0,4,4966,36.77
1941,1,1,0,1,1,2,6,11521,68.36
1942,1,1,0,1,0,0,3,1352,17.01
1943,1,1,1,1,2,0,6,11521,68.36
1944,1,1,0,1,3,0,6,11521,68.36
1945,1,1,0,1,1,0,4,4966,36.77
1946,1,2,1,1,0,0,5,8690,54.42
1948,1,1,0,1,0,0,3,1352,17.01
1949,1,1,0,1,0,0,3,1352,17.01
1950,1,1,0,1,0,0,3,1352,17.01
1951,1,4,0,1,0,0,6,11521,68.36
1952,1,4,0,1,0,0,6,11521,68.36
1953,1,2,1,1,0,0,5,8690,54.42
1954,1,0,2,1,4,6,14,17699,95.82
1955,1,0,3,1,0,0,5,8690,54.42
1956,1,0,2,1,0,0,4,4966,36.77
1957,1,2,0,1,0,0,4,4966,36.77
1958,1,0,2,1,1,0,5,8690,54.42
1959,1,0,2,1,1,0,5,8690,54.42
1960,1,2,1,1,2,0,7,13868,78.23
1961,1,0,1,1,0,0,3,1352,17.01
1962,1,1,1,1,0,6,10,16522,90.12
1963,3,0,4,1,1,8,17,18193,98.23
1965,1,0,2,1,1,0,5,8690,54.42
1966,1,1,1,1,0,4,8,15186,83.84
1967,1,1,1,1,0,0,4,4966,36.77
1968,1,4,2,2,0,0,9,15950,87.44
1969,1,5,1,1,0,0,8,15186,83.84
1970,1,3,1,1,2,0,8,15186,83.84
1971,1,3,1,1,1,0,7,13868,78.23
1972,1,3,0,1,0,0,5,8690,54.42
1973,3,0,4,1,2,6,16,18081,97.67
1974,1,0,3,2,0,0,6,11521,68.36
1975,3,0,5,1,5,8,22,18498,99.73
1976,1,3,0,1,0,0,5,8690,54.42
1977,1,0,1,1,1,0,4,4966,36.77
1978,1,0,2,2,0,0,5,8690,54.42
1979,1,2,0,1,0,0,4,4966,36.77
1980,1,0,2,1,3,0,7,13868,78.23
1982,1,2,1,1,2,0,7,13868,78.23
1983,1,2,0,1,0,0,4,4966,36.77
1984,1,2,0,1,0,0,4,4966,36.77
1985,1,1,2,1,0,0,5,8690,54.42
1986,1,4,0,1,0,0,6,11521,68.36
1987,1,0,2,1,1,6,11,16947,91.91
1988,1,1,1,1,1,0,5,8690,54.42
1989,1,0,2,1,1,0,5,8690,54.42
1990,1,1,0,1,0,0,3,1352,17.01
1991,1,2,0,1,0,0,4,4966,36.77
1992,1,0,0,1,0,0,2,32,3.72
1993,1,1,0,1,0,0,3,1352,17.01
1994,1,1,0,1,3,0,6,11521,68.36
1995,1,0,2,1,0,0,4,4966,36.77
1996,1,1,2,1,0,0,5,8690,54.42
1997,1,0,1,1,0,0,3,1352,17.01
1998,1,3,1,1,0,4,10,16522,90.12
1999,1,0,1,1,0,0,3,1352,17.01
2000,1,1,1,1,2,4,10,16522,90.12
2001,1,0,0,1,0,0,2,32,3.72
2002,1,0,1,1,0,0,3,1352,17.01
2003,1,0,2,1,3,0,7,13868,78.23
2004,3,0,5,1,5,0,14,17699,95.82
2005,1,1,1,1,1,0,5,8690,54.42
2006,3,0,4,1,3,4,15,17888,96.85
2007,1,0,3,1,2,0,7,13868,78.23
2008,1,0,0,1,0,0,2,32,3.72
2009,1,1,0,1,0,0,3,1352,17.01
2010,1,1,1,1,0,0,4,4966,36.77
2011,1,2,4,2,0,0,9,15950,87.44
2012,1,0,2,1,0,0,4,4966,36.77
2013,3,0,5,2,5,4,19,18362,99.04
2014,1,2,3,1,1,0,8,15186,83.84
2015,1,0,1,1,2,0,5,8690,54.42
2016,1,0,0,1,0,0,2,32,3.72
2017,1,3,0,1,2,0,7,13868,78.23
2018,1,0,2,1,0,0,4,4966,36.77
2019,1,0,0,1,0,0,2,32,3.72
2020,1,1,1,1,1,0,5,8690,54.42
2021,1,1,1,1,0,2,6,11521,68.36
2022,1,0,2,1,2,0,6,11521,68.36
2023,1,2,1,1,0,0,5,8690,54.42
2024,1,2,0,1,2,0,6,11521,68.36
2025,1,1,2,1,1,6,12,17186,93.28
2026,1,0,3,1,2,10,17,18193,98.23
2027,1,0,3,1,0,10,15,17888,96.85
2028,1,0,2,1,1,10,15,17888,96.85
2029,1,1,0,1,0,0,3,1352,17.01
2030,1,1,0,1,1,0,4,4966,36.77
2031,4,0,5,2,5,0,16,18081,97.67
2032,1,1,0,1,0,0,3,1352,17.01
2033,1,0,0,1,0,0,2,32,3.72
2034,1,1,1,1,0,0,4,4966,36.77
2035,1,1,1,1,0,0,4,4966,36.77
2036,1,0,2,1,3,0,7,13868,78.23
2037,1,2,0,1,0,0,4,4966,36.77
2038,1,0,1,1,3,0,6,11521,68.36
2039,1,0,2,1,1,0,5,8690,54.42
2040,1,0,2,1,0,2,6,11521,68.36
2041,1,2,0,1,3,0,7,13868,78.23
2042,1,1,2,1,4,0,9,15950,87.44
2043,1,3,1,1,0,0,6,11521,68.36
2044,1,3,0,1,0,0,5,8690,54.42
2045,1,1,0,1,0,0,3,1352,17.01
2046,1,4,0,1,0,0,6,11521,68.36
2047,1,3,1,1,2,0,8,15186,83.84
2048,1,1,2,1,0,0,5,8690,54.42
2049,1,0,1,1,3,0,6,11521,68.36
2050,1,3,0,1,0,0,5,8690,54.42
2051,1,0,1,1,0,0,3,1352,17.01
2052,1,0,0,1,0,0,2,32,3.72
2053,1,1,0,1,3,0,6,11521,68.36
2054,1,1,1,1,1,0,5,8690,54.42
2055,1,3,0,1,0,0,5,8690,54.42
2056,1,0,1,1,3,0,6,11521,68.36
2058,1,0,1,1,0,0,3,1352,17.01
2059,1,4,0,1,0,0,6,11521,68.36
2060,1,3,0,1,0,0,5,8690,54.42
2061,3,0,5,3,5,0,16,18081,97.67
2062,1,2,0,1,3,0,7,13868,78.23
2063,1,2,1,1,1,0,6,11521,68.36
2064,3,1,5,2,3,6,20,18419,99.31
2065,1,0,3,1,0,0,5,8690,54.42
2066,1,2,1,1,0,0,5,8690,54.42
2067,1,2,0,1,0,0,4,4966,36.77
2068,1,4,0,1,0,0,6,11521,68.36
2069,1,4,3,2,1,0,11,16947,91.91
2070,4,0,5,2,5,6,22,18498,99.73
2071,3,0,5,1,3,0,12,17186,93.28
2072,1,3,1,1,0,0,6,11521,68.36
2073,1,0,0,1,1,10,13,17456,94.66
2074,1,0,2,1,0,0,4,4966,36.77
2075,1,2,0,1,0,0,4,4966,36.77
2076,3,0,5,2,5,0,15,17888,96.85
2077,1,0,4,2,2,0,9,15950,87.44
2078,1,0,1,1,0,0,3,1352,17.01
2079,1,0,3,1,2,0,7,13868,78.23
2080,1,3,1,1,0,0,6,11521,68.36
2081,1,2,1,1,0,0,5,8690,54.42
2082,1,0,2,1,0,0,4,4966,36.77
2083,1,1,1,1,0,0,4,4966,36.77
2084,1,1,1,1,0,0,4,4966,36.77
2085,1,4,1,1,0,0,7,13868,78.23
2086,1,1,0,1,0,0,3,1352,17.01
2087,1,1,0,1,0,0,3,1352,17.01
2088,1,1,0,1,0,0,3,1352,17.01
2089,1,3,1,1,3,0,9,15950,87.44
2090,1,2,3,1,0,0,7,13868,78.23
2091,1,0,3,2,3,0,9,15950,87.44
2092,1,1,1,1,1,4,9,15950,87.44
2093,1,4,1,1,1,0,8,15186,83.84
2094,1,1,0,1,3,0,6,11521,68.36
2095,1,0,1,1,0,0,3,1352,17.01
2096,1,3,0,1,0,0,5,8690,54.42
2097,1,0,1,1,1,0,4,4966,36.77
2098,1,0,4,1,0,0,6,11521,68.36
2099,1,1,0,1,0,0,3,1352,17.01
2100,1,3,2,2,3,0,11,16947,91.91
2101,1,5,3,2,0,0,11,16947,91.91
2102,1,0,1,1,0,0,3,1352,17.01
2103,1,0,0,1,1,6,9,15950,87.44
2104,1,1,0,1,0,0,3,1352,17.01
2105,1,1,1,1,0,0,4,4966,36.77
2106,1,1,0,1,0,0,3,1352,17.01
2107,1,0,4,1,2,6,14,17699,95.82
2108,1,3,0,1,0,0,5,8690,54.42
2109,1,1,1,1,3,0,7,13868,78.23
2110,1,3,0,1,1,0,6,11521,68.36
2111,1,1,0,1,0,0,3,1352,17.01
2112,1,1,2,1,3,0,8,15186,83.84
2113,1,0,0,1,0,10,12,17186,93.28
2114,1,0,1,1,0,0,3,1352,17.01
2115,1,4,3,1,0,0,9,15950,87.44
2116,1,2,1,1,0,0,5,8690,54.42
2117,1,0,1,1,0,0,3,1352,17.01
2118,1,2,0,1,0,0,4,4966,36.77
2119,1,1,0,1,0,0,3,1352,17.01
2120,1,0,1,1,0,0,3,1352,17.01
2121,1,1,1,1,2,0,6,11521,68.36
2122,1,1,1,1,0,0,4,4966,36.77
2123,1,1,1,1,2,8,14,17699,95.82
2124,1,0,2,1,0,0,4,4966,36.77
2125,1,0,0,1,0,0,2,32,3.72
2126,1,3,0,1,1,0,6,11521,68.36
2127,1,3,0,1,0,0,5,8690,54.42
2128,1,1,2,1,3,0,8,15186,83.84
2129,1,0,0,1,0,0,2,32,3.72
2130,1,0,4,0,1,10,16,18081,97.67
2131,1,2,0,1,1,0,5,8690,54.42
2132,1,0,1,1,0,0,3,1352,17.01
2133,1,0,0,1,0,0,2,32,3.72
2134,1,1,0,1,3,6,12,17186,93.28
2135,1,1,1,1,0,0,4,4966,36.77
2136,1,2,0,1,0,0,4,4966,36.77
2137,3,0,5,2,5,0,15,17888,96.85
2138,1,4,0,1,0,0,6,11521,68.36
2139,1,0,0,1,0,0,2,32,3.72
2140,1,0,4,1,2,0,8,15186,83.84
2141,1,2,0,1,0,0,4,4966,36.77
2142,1,2,0,1,0,0,4,4966,36.77
2143,1,0,1,1,0,0,3,1352,17.01
2144,1,4,1,1,3,0,10,16522,90.12
2145,1,1,1,2,0,0,5,8690,54.42
2146,1,0,2,2,1,0,6,11521,68.36
2147,1,0,1,1,0,0,3,1352,17.01
2148,1,4,0,1,0,0,6,11521,68.36
2149,1,0,2,1,1,0,5,8690,54.42
2150,1,5,0,2,0,0,8,15186,83.84
2151,1,2,0,1,0,0,4,4966,36.77
2152,1,0,0,1,0,0,2,32,3.72
2153,1,1,0,1,0,0,3,1352,17.01
2154,1,2,0,1,1,0,5,8690,54.42
2155,1,0,1,1,1,0,4,4966,36.77
2156,4,0,5,2,5,0,16,18081,97.67
2157,1,0,3,1,0,0,5,8690,54.42
2158,1,1,0,1,0,0,3,1352,17.01
2159,1,4,1,1,0,0,7,13868,78.23
2160,1,0,0,1,0,0,2,32,3.72
2161,1,2,1,1,0,0,5,8690,54.42
2162,1,3,3,1,2,0,10,16522,90.12
2163,1,0,1,1,0,0,3,1352,17.01
2164,3,0,5,2,5,0,15,17888,96.85
2165,1,0,1,1,0,0,3,1352,17.01
2166,1,4,0,1,0,0,6,11521,68.36
2167,1,0,3,1,1,0,6,11521,68.36
2168,3,0,5,2,3,10,23,18538,99.86
2169,1,0,0,1,0,0,2,32,3.72
2170,3,0,5,1,4,0,13,17456,94.66
2171,1,2,2,1,0,0,6,11521,68.36
2172,1,4,0,1,0,0,6,11521,68.36
2173,1,1,1,1,0,0,4,4966,36.77
2174,1,2,1,1,1,0,6,11521,68.36
2175,3,0,5,2,3,4,17,18193,98.23
2176,1,4,0,1,0,0,6,11521,68.36
2177,1,3,0,1,0,0,5,8690,54.42
2178,1,4,3,1,3,0,12,17186,93.28
2179,4,0,3,1,4,6,18,18287,98.68
2180,1,1,2,1,0,0,5,8690,54.42
2181,1,2,3,2,3,6,17,18193,98.23
2182,1,0,5,2,0,0,8,15186,83.84
2183,1,3,1,1,1,0,7,13868,78.23
2184,1,0,0,1,0,6,8,15186,83.84
2185,1,0,1,1,0,0,3,1352,17.01
2186,1,1,0,1,0,0,3,1352,17.01
2187,1,2,0,1,0,0,4,4966,36.77
2188,1,1,0,1,0,0,3,1352,17.01
2189,1,1,1,1,0,0,4,4966,36.77
2190,1,2,0,1,2,0,6,11521,68.36
2191,1,1,1,1,0,0,4,4966,36.77
2192,1,1,1,1,0,0,4,4966,36.77
2193,1,4,0,1,0,0,6,11521,68.36
2194,1,0,4,1,1,0,7,13868,78.23
2195,1,1,0,1,0,0,3,1352,17.01
2196,1,0,2,1,1,0,5,8690,54.42
2197,1,1,0,1,2,0,5,8690,54.42
2198,1,0,1,1,0,6,9,15950,87.44
2199,1,1,2,1,0,0,5,8690,54.42
2200,1,0,2,1,1,0,5,8690,54.42
2201,1,0,3,1,4,0,9,15950,87.44
2202,1,0,0,1,0,2,4,4966,36.77
2203,1,0,1,1,2,0,5,8690,54.42
2204,1,0,0,1,0,10,12,17186,93.28
2205,1,3,2,1,0,0,7,13868,78.23
2206,1,0,5,2,0,0,8,15186,83.84
2207,1,0,3,2,4,0,10,16522,90.12
2208,1,1,1,1,2,0,6,11521,68.36
2209,1,3,1,1,1,0,7,13868,78.23
2210,1,1,1,1,0,0,4,4966,36.77
2211,1,0,2,1,0,6,10,16522,90.12
2212,1,1,1,1,0,0,4,4966,36.77
2213,1,1,0,1,0,0,3,1352,17.01
2214,1,1,1,1,0,0,4,4966,36.77
2215,1,0,3,1,0,0,5,8690,54.42
2217,1,0,1,1,0,0,3,1352,17.01
2218,1,2,0,1,0,0,4,4966,36.77
2219,1,3,1,1,2,0,8,15186,83.84
2220,1,0,1,1,0,0,3,1352,17.01
2221,1,0,1,1,0,6,9,15950,87.44
2222,1,0,0,1,1,0,3,1352,17.01
2223,1,1,0,1,0,0,3,1352,17.01
2224,1,2,0,1,0,0,4,4966,36.77
2225,1,1,1,1,2,0,6,11521,68.36
2226,1,0,0,1,0,0,2,32,3.72
2227,1,0,2,1,0,0,4,4966,36.77
2228,1,4,1,1,1,0,8,15186,83.84
2229,1,0,0,1,1,0,3,1352,17.01
2230,1,1,1,1,2,0,6,11521,68.36
2231,3,0,5,2,3,4,17,18193,98.23
2232,1,0,3,1,0,0,5,8690,54.42
2233,1,3,0,1,2,0,7,13868,78.23
2234,1,3,0,1,0,0,5,8690,54.42
2235,1,0,0,1,0,0,2,32,3.72
2236,1,2,0,1,0,0,4,4966,36.77
2237,1,0,0,1,0,0,2,32,3.72
2238,1,1,1,1,0,0,4,4966,36.77
2239,1,3,0,1,0,0,5,8690,54.42
2240,1,3,1,1,3,0,9,15950,87.44
2241,1,0,1,1,0,0,3,1352,17.01
2242,3,0,5,2,2,0,12,17186,93.28
2243,1,0,1,1,1,0,4,4966,36.77
2244,1,3,0,1,0,0,5,8690,54.42
2245,1,1,2,1,0,0,5,8690,54.42
2246,1,0,3,1,1,6,12,17186,93.28
2247,1,2,1,1,0,0,5,8690,54.42
2248,1,0,3,1,0,6,11,16947,91.91
2249,1,1,0,1,0,0,3,1352,17.01
2250,1,3,2,1,0,0,7,13868,78.23
2251,1,0,0,1,0,0,2,32,3.72
2253,1,2,1,1,0,0,5,8690,54.42
2254,1,0,1,1,0,0,3,1352,17.01
2255,1,0,5,1,0,0,7,13868,78.23
2256,3,0,4,1,2,0,10,16522,90.12
2257,1,3,0,1,0,0,5,8690,54.42
2258,1,4,1,1,0,0,7,13868,78.23
2259,1,1,1,1,0,0,4,4966,36.77
2260,1,2,0,1,0,0,4,4966,36.77
2261,1,0,2,1,0,0,4,4966,36.77
2262,1,0,1,1,2,0,5,8690,54.42
2263,1,0,1,1,0,0,3,1352,17.01
2264,1,3,1,1,1,0,7,13868,78.23
2265,1,0,2,1,1,0,5,8690,54.42
2266,1,0,1,1,0,0,3,1352,17.01
2267,1,3,0,1,0,0,5,8690,54.42
2268,1,0,3,1,0,0,5,8690,54.42
2269,1,2,0,1,0,0,4,4966,36.77
2270,1,0,2,1,0,0,4,4966,36.77
2271,1,2,1,1,0,0,5,8690,54.42
2273,1,4,3,1,0,0,9,15950,87.44
2274,1,2,0,1,0,0,4,4966,36.77
2275,1,0,0,1,0,0,2,32,3.72
2276,1,0,2,1,2,0,6,11521,68.36
2277,3,0,5,2,3,6,19,18362,99.04
2278,1,1,0,1,0,0,3,1352,17.01
2279,1,1,0,1,0,0,3,1352,17.01
2280,1,0,2,1,0,0,4,4966,36.77
2281,1,0,1,1,0,0,3,1352,17.01
2282,3,0,5,1,5,0,14,17699,95.82
2283,1,0,1,1,0,0,3,1352,17.01
2284,1,1,0,1,0,0,3,1352,17.01
2285,1,1,2,1,0,0,5,8690,54.42
2286,1,4,0,1,0,0,6,11521,68.36
2287,1,0,1,1,0,0,3,1352,17.01
2288,1,0,0,1,0,0,2,32,3.72
2289,1,1,1,1,0,0,4,4966,36.77
2290,1,2,0,1,0,0,4,4966,36.77
2291,1,0,1,1,3,4,10,16522,90.12
2292,1,3,0,1,0,0,5,8690,54.42
2294,3,0,5,2,5,0,15,17888,96.85
2295,1,2,0,1,1,0,5,8690,54.42
2296,1,2,0,1,0,0,4,4966,36.77
2297,1,0,3,2,3,6,15,17888,96.85
2298,1,0,1,1,0,0,3,1352,17.01
2299,1,3,0,1,3,0,8,15186,83.84
2300,1,0,0,1,0,0,2,32,3.72
2301,1,3,0,1,0,0,5,8690,54.42
2302,1,1,0,1,2,0,5,8690,54.42
2303,1,1,0,1,0,0,3,1352,17.01
2304,1,1,3,1,0,0,6,11521,68.36
2305,1,0,4,1,0,0,6,11521,68.36
2306,1,1,3,1,0,0,6,11521,68.36
2307,1,1,0,1,0,0,3,1352,17.01
2308,1,0,5,1,2,0,9,15950,87.44
2309,1,0,3,2,1,0,7,13868,78.23
2310,1,1,0,1,0,0,3,1352,17.01
2311,1,4,1,1,2,0,9,15950,87.44
2312,1,4,0,1,0,0,6,11521,68.36
2313,1,0,0,1,0,0,2,32,3.72
2314,1,1,0,1,0,6,9,15950,87.44
2315,1,1,0,0,0,0,2,32,3.72
2316,1,0,0,1,1,0,3,1352,17.01
2317,1,2,1,1,1,0,6,11521,68.36
2318,1,2,1,1,0,0,5,8690,54.42
2319,1,1,0,1,0,0,3,1352,17.01
2320,1,1,2,1,0,0,5,8690,54.42
2321,1,3,0,1,0,0,5,8690,54.42
2322,1,0,3,1,1,0,6,11521,68.36
2323,1,2,1,1,0,0,5,8690,54.42
2324,1,2,1,1,0,0,5,8690,54.42
2325,1,4,2,1,0,0,8,15186,83.84
2326,1,1,0,0,0,0,2,32,3.72
2327,3,0,4,3,5,0,15,17888,96.85
2328,1,0,2,1,2,0,6,11521,68.36
2329,1,0,1,1,0,0,3,1352,17.01
2330,3,0,5,4,3,2,17,18193,98.23
2331,1,1,0,1,0,0,3,1352,17.01
2332,1,3,1,1,0,0,6,11521,68.36
2333,1,4,0,1,1,0,7,13868,78.23
2334,1,0,3,1,3,0,8,15186,83.84
2335,1,0,1,1,0,2,5,8690,54.42
2336,1,1,0,1,0,6,9,15950,87.44
2337,1,0,2,1,3,0,7,13868,78.23
2338,1,2,1,1,0,0,5,8690,54.42
2339,1,4,4,3,2,0,14,17699,95.82
2340,1,2,0,1,0,0,4,4966,36.77
2341,1,4,1,1,0,0,7,13868,78.23
2342,1,2,2,1,0,0,6,11521,68.36
2343,1,1,1,1,0,0,4,4966,36.77
2344,1,1,1,1,0,0,4,4966,36.77
2345,1,1,0,1,1,0,4,4966,36.77
2346,1,0,4,2,0,0,7,13868,78.23
2347,1,4,0,1,0,0,6,11521,68.36
2348,1,4,1,1,0,0,7,13868,78.23
2349,1,0,2,1,4,0,8,15186,83.84
2350,1,3,0,1,1,0,6,11521,68.36
2351,1,0,0,1,3,0,5,8690,54.42
2352,1,0,1,1,1,0,4,4966,36.77
2353,1,1,1,1,0,0,4,4966,36.77
2354,1,0,0,1,0,0,2,32,3.72
2355,3,0,4,1,3,10,21,18462,99.52
2356,1,2,1,1,0,0,5,8690,54.42
2357,1,1,0,1,0,0,3,1352,17.01
2358,1,2,0,1,0,0,4,4966,36.77
2359,1,1,4,2,1,0,9,15950,87.44
2360,1,3,1,1,0,0,6,11521,68.36
2361,3,1,3,2,0,0,9,15950,87.44
2362,1,0,4,2,0,0,7,13868,78.23
2363,1,0,0,1,0,0,2,32,3.72
2364,1,2,1,1,1,0,6,11521,68.36
2365,1,0,1,1,0,0,3,1352,17.01
2366,1,4,1,1,0,0,7,13868,78.23
2367,1,1,1,1,0,0,4,4966,36.77
2368,1,1,0,1,0,0,3,1352,17.01
2369,1,3,0,1,0,0,5,8690,54.42
2370,1,2,0,1,2,0,6,11521,68.36
2371,1,1,0,1,0,0,3,1352,17.01
2372,1,0,1,1,2,0,5,8690,54.42
2373,1,0,0,1,1,0,3,1352,17.01
2374,4,0,5,2,5,10,26,18556,99.96
2375,1,4,0,0,0,0,5,8690,54.42
2376,1,2,0,1,0,0,4,4966,36.77
2377,1,3,0,1,2,0,7,13868,78.23
2378,1,1,0,1,0,0,3,1352,17.01
2379,1,1,1,1,3,6,13,17456,94.66
2380,1,1,2,1,1,0,6,11521,68.36
2381,1,0,2,1,0,0,4,4966,36.77
2382,3,0,5,2,4,0,14,17699,95.82
2383,3,1,5,2,2,0,13,17456,94.66
2384,1,0,2,1,3,4,11,16947,91.91
2385,1,2,2,1,0,0,6,11521,68.36
2386,1,2,1,1,0,0,5,8690,54.42
2387,1,4,0,1,0,0,6,11521,68.36
2388,1,0,4,2,3,4,14,17699,95.82
2389,1,1,0,1,0,0,3,1352,17.01
2390,1,0,0,1,0,0,2,32,3.72
2391,3,4,5,4,4,0,20,18419,99.31
2392,1,1,0,1,0,0,3,1352,17.01
2393,1,0,1,1,0,0,3,1352,17.01
2394,1,1,4,2,0,0,8,15186,83.84
2395,1,0,2,1,3,0,7,13868,78.23
2396,1,1,0,1,2,0,5,8690,54.42
2397,1,1,2,1,0,0,5,8690,54.42
2398,1,1,2,2,0,0,6,11521,68.36
2399,1,1,1,1,0,0,4,4966,36.77
2400,3,0,5,1,3,6,18,18287,98.68
2401,1,0,0,1,2,0,4,4966,36.77
2402,1,1,0,1,0,0,3,1352,17.01
2403,3,0,5,2,5,6,21,18462,99.52
2404,1,0,3,1,0,0,5,8690,54.42
2405,1,3,2,1,0,0,7,13868,78.23
2406,1,0,5,1,3,0,10,16522,90.12
2407,1,0,1,1,0,0,3,1352,17.01
2408,1,1,1,1,0,0,4,4966,36.77
2409,1,0,3,1,3,0,8,15186,83.84
2410,1,0,2,1,1,0,5,8690,54.42
2411,1,0,0,1,1,0,3,1352,17.01
2412,1,0,2,2,0,0,5,8690,54.42
2414,1,0,1,1,0,0,3,1352,17.01
2415,1,2,2,1,0,0,6,11521,68.36
2416,1,0,0,1,4,6,12,17186,93.28
2417,1,4,0,1,0,0,6,11521,68.36
2418,1,0,2,1,3,2,9,15950,87.44
2419,1,2,0,1,1,0,5,8690,54.42
2420,3,0,5,2,2,8,20,18419,99.31
2421,1,2,1,1,0,0,5,8690,54.42
2422,1,0,0,1,0,0,2,32,3.72
2423,1,0,2,1,2,6,12,17186,93.28
2424,1,0,0,1,0,0,2,32,3.72
2425,1,2,2,1,0,0,6,11521,68.36
2426,1,3,1,1,0,0,6,11521,68.36
2427,1,0,2,1,0,0,4,4966,36.77
2428,1,2,1,1,0,0,5,8690,54.42
2429,1,0,0,1,0,0,2,32,3.72
2430,1,3,0,1,0,0,5,8690,54.42
2431,1,4,0,1,2,0,8,15186,83.84
2432,1,3,1,1,0,0,6,11521,68.36
2433,1,0,1,1,1,0,4,4966,36.77
2434,1,0,2,1,3,0,7,13868,78.23
2435,1,4,0,1,2,0,8,15186,83.84
2436,1,2,2,1,3,0,9,15950,87.44
2437,1,0,3,1,2,0,7,13868,78.23
2438,1,1,2,1,3,0,8,15186,83.84
2439,1,0,5,1,0,0,7,13868,78.23
2440,1,0,2,1,0,0,4,4966,36.77
2441,1,1,0,1,0,0,3,1352,17.01
2442,1,0,0,1,1,0,3,1352,17.01
2443,1,1,0,1,0,0,3,1352,17.01
2444,1,0,0,1,0,0,2,32,3.72
2445,1,1,0,1,1,0,4,4966,36.77
2446,1,3,0,1,0,0,5,8690,54.42
2447,1,0,0,1,0,0,2,32,3.72
2448,1,1,0,1,0,0,3,1352,17.01
2449,1,0,0,1,0,0,2,32,3.72
2450,3,2,3,2,3,0,13,17456,94.66
2451,1,0,4,1,0,6,12,17186,93.28
2452,1,0,2,1,2,0,6,11521,68.36
2453,1,1,1,1,0,0,4,4966,36.77
2454,1,2,1,1,3,0,8,15186,83.84
2455,1,0,1,1,0,4,7,13868,78.23
2456,1,4,0,1,0,0,6,11521,68.36
2457,1,2,2,1,2,0,8,15186,83.84
2458,1,3,4,2,0,0,10,16522,90.12
2459,1,1,1,1,0,0,4,4966,36.77
2460,1,1,0,1,0,0,3,1352,17.01
2462,1,1,1,1,0,0,4,4966,36.77
2463,1,1,1,1,1,0,5,8690,54.42
2464,1,0,1,1,0,6,9,15950,87.44
2465,1,1,0,1,0,0,3,1352,17.01
2466,1,0,0,1,0,0,2,32,3.72
2467,1,0,1,1,0,0,3,1352,17.01
2469,1,3,1,1,0,0,6,11521,68.36
2470,1,0,0,1,0,0,2,32,3.72
2471,1,1,1,1,1,0,5,8690,54.42
2472,1,3,0,1,0,0,5,8690,54.42
2473,1,0,5,2,0,0,8,15186,83.84
2474,1,0,5,2,0,0,8,15186,83.84
2475,1,0,2,1,4,0,8,15186,83.84
2476,1,0,2,1,0,2,6,11521,68.36
2477,1,0,2,1,0,0,4,4966,36.77
2478,1,2,0,1,0,0,4,4966,36.77
2479,1,3,1,1,0,0,6,11521,68.36
2480,3,1,5,2,4,0,15,17888,96.85
2481,1,0,1,1,3,0,6,11521,68.36
2482,1,1,1,1,0,0,4,4966,36.77
2483,1,0,1,1,0,0,3,1352,17.01
2484,1,0,0,1,0,0,2,32,3.72
2485,1,2,0,1,0,0,4,4966,36.77
2486,1,0,1,1,0,0,3,1352,17.01
2487,1,2,1,1,3,0,8,15186,83.84
2489,3,0,5,2,4,0,14,17699,95.82
2490,1,1,0,1,0,0,3,1352,17.01
2491,1,2,1,1,3,0,8,15186,83.84
2492,1,0,0,1,0,0,2,32,3.72
2493,3,0,5,2,3,0,13,17456,94.66
2494,1,1,0,1,1,0,4,4966,36.77
2495,1,1,1,1,1,0,5,8690,54.42
2496,1,1,2,1,3,0,8,15186,83.84
2497,1,0,1,1,0,0,3,1352,17.01
2498,1,1,1,1,1,0,5,8690,54.42
2499,1,0,0,1,0,0,2,32,3.72
2500,1,0,0,1,0,0,2,32,3.72
2501,1,1,0,1,0,0,3,1352,17.01
2502,1,0,0,1,0,0,2,32,3.72
2503,1,1,2,2,1,0,7,13868,78.23
2504,1,0,3,1,1,0,6,11521,68.36
2505,1,0,1,1,0,4,7,13868,78.23
2506,1,3,0,1,0,0,5,8690,54.42
2507,1,4,0,1,3,0,9,15950,87.44
2508,1,3,0,1,0,0,5,8690,54.42
2509,1,0,0,1,0,0,2,32,3.72
2510,1,1,0,1,3,0,6,11521,68.36
2511,3,0,5,2,5,0,15,17888,96.85
2512,1,0,4,1,3,0,9,15950,87.44
2513,1,5,3,1,0,0,10,16522,90.12
2514,1,0,2,1,1,0,5,8690,54.42
2515,1,1,0,1,0,0,3,1352,17.01
2516,1,2,1,1,0,0,5,8690,54.42
2517,1,1,1,1,0,0,4,4966,36.77
2518,1,0,1,1,0,4,7,13868,78.23
2519,1,1,1,1,0,0,4,4966,36.77
2520,3,0,5,2,5,0,15,17888,96.85
2521,1,3,1,1,0,0,6,11521,68.36
2522,1,0,2,1,1,0,5,8690,54.42
2523,1,0,2,1,1,0,5,8690,54.42
2524,1,2,0,1,0,0,4,4966,36.77
2525,1,4,2,2,0,0,9,15950,87.44
2526,1,1,2,1,3,0,8,15186,83.84
2527,1,1,0,1,0,0,3,1352,17.01
2528,1,4,0,1,0,0,6,11521,68.36
2529,1,2,1,1,0,0,5,8690,54.42
2530,1,3,0,1,0,0,5,8690,54.42
2531,1,1,0,1,0,0,3,1352,17.01
2532,1,1,5,1,0,0,8,15186,83.84
2533,3,0,4,1,3,10,21,18462,99.52
2534,1,0,0,1,1,0,3,1352,17.01
2535,1,1,1,1,0,0,4,4966,36.77
2536,1,2,1,1,0,0,5,8690,54.42
2537,1,0,0,1,0,0,2,32,3.72
2538,1,0,3,1,0,0,5,8690,54.42
2539,1,1,1,1,0,0,4,4966,36.77
2540,1,0,0,1,0,0,2,32,3.72
2541,1,2,0,1,0,0,4,4966,36.77
2542,1,1,1,1,0,0,4,4966,36.77
2543,1,1,0,1,0,0,3,1352,17.01
2544,1,2,2,1,4,0,10,16522,90.12
2545,1,2,0,1,0,0,4,4966,36.77
2546,1,2,1,1,0,0,5,8690,54.42
2547,1,0,4,1,3,0,9,15950,87.44
2548,1,0,0,1,0,0,2,32,3.72
2549,3,0,5,2,5,0,15,17888,96.85
2550,1,2,1,1,0,0,5,8690,54.42
2551,1,1,3,1,0,0,6,11521,68.36
2552,3,0,5,2,5,0,15,17888,96.85
2553,1,1,1,1,0,4,8,15186,83.84
2554,1,3,0,1,0,0,5,8690,54.42
2555,1,4,0,1,0,0,6,11521,68.36
2556,1,3,0,1,0,0,5,8690,54.42
2557,1,2,0,1,0,0,4,4966,36.77
2559,1,0,1,1,0,0,3,1352,17.01
2560,1,0,1,1,0,0,3,1352,17.01
2561,1,2,0,1,3,0,7,13868,78.23
2562,1,2,1,1,0,0,5,8690,54.42
2563,1,4,4,1,1,0,11,16947,91.91
2564,1,1,3,1,0,0,6,11521,68.36
2565,1,1,0,1,0,0,3,1352,17.01
2566,1,2,2,2,0,0,7,13868,78.23
2567,1,0,2,1,2,4,10,16522,90.12
2568,1,0,1,1,0,0,3,1352,17.01
2569,1,1,1,1,3,0,7,13868,78.23
2570,1,3,2,1,0,0,7,13868,78.23
2571,1,3,2,1,0,0,7,13868,78.23
2572,1,1,3,1,0,0,6,11521,68.36
2573,3,0,5,1,3,4,16,18081,97.67
2574,1,2,2,1,0,0,6,11521,68.36
2575,1,0,1,1,0,0,3,1352,17.01
2576,1,0,0,1,3,0,5,8690,54.42
2578,1,0,1,1,0,0,3,1352,17.01
2579,1,0,1,1,0,0,3,1352,17.01
2580,1,0,3,1,0,0,5,8690,54.42
2581,1,3,1,1,0,0,6,11521,68.36
2582,1,3,2,2,0,0,8,15186,83.84
2583,1,0,0,1,1,0,3,1352,17.01
2584,1,1,2,1,0,0,5,8690,54.42
2585,3,0,5,1,3,4,16,18081,97.67
2586,1,0,1,1,0,0,3,1352,17.01
2587,1,5,0,1,0,0,7,13868,78.23
2588,3,0,5,1,3,6,18,18287,98.68
2589,1,3,1,1,0,0,6,11521,68.36
2590,1,1,2,2,1,0,7,13868,78.23
2591,1,3,0,1,0,0,5,8690,54.42
2592,3,0,5,2,5,0,15,17888,96.85
2593,1,0,3,1,0,0,5,8690,54.42
2594,1,1,1,1,0,4,8,15186,83.84
2595,1,0,1,1,0,0,3,1352,17.01
2596,1,4,0,1,0,0,6,11521,68.36
2597,1,0,0,1,0,0,2,32,3.72
2598,1,5,2,1,0,0,9,15950,87.44
2599,1,4,0,1,0,0,6,11521,68.36
2600,3,0,5,2,5,0,15,17888,96.85
2601,1,0,1,1,2,0,5,8690,54.42
2602,1,0,1,1,0,6,9,15950,87.44
2603,1,2,3,1,0,0,7,13868,78.23
2604,3,0,5,1,5,6,20,18419,99.31
2605,1,0,0,1,0,0,2,32,3.72
2606,1,5,0,1,0,0,7,13868,78.23
2607,1,0,2,1,3,0,7,13868,78.23
2608,1,4,0,1,0,0,6,11521,68.36
2609,1,0,1,1,0,0,3,1352,17.01
2610,1,3,1,1,0,0,6,11521,68.36
2611,1,4,0,1,0,0,6,11521,68.36
2612,1,1,2,1,0,0,5,8690,54.42
2613,1,1,0,1,0,0,3,1352,17.01
2614,1,3,0,1,0,0,5,8690,54.42
2615,1,4,0,1,0,0,6,11521,68.36
2616,1,3,0,1,3,0,8,15186,83.84
2617,1,1,2,1,1,0,6,11521,68.36
2618,1,4,0,2,4,0,11,16947,91.91
2619,1,0,1,1,2,0,5,8690,54.42
2620,1,3,0,1,0,0,5,8690,54.42
2621,1,1,0,1,1,0,4,4966,36.77
2622,1,1,1,1,1,0,5,8690,54.42
2623,1,1,1,1,0,0,4,4966,36.77
2624,3,0,5,2,3,0,13,17456,94.66
2625,1,0,0,1,0,0,2,32,3.72
2626,1,0,2,1,0,0,4,4966,36.77
2627,1,4,2,1,0,0,8,15186,83.84
2628,1,0,1,1,0,0,3,1352,17.01
2629,1,0,1,1,0,0,3,1352,17.01
2630,1,2,1,1,0,0,5,8690,54.42
2631,1,0,1,1,0,0,3,1352,17.01
2632,1,4,1,1,0,0,7,13868,78.23
2633,1,0,3,2,1,0,7,13868,78.23
2634,1,0,3,1,3,4,12,17186,93.28
2635,1,2,0,1,0,0,4,4966,36.77
2636,1,0,1,1,0,0,3,1352,17.01
2637,1,0,1,1,0,0,3,1352,17.01
2638,3,0,5,2,3,0,13,17456,94.66
2639,1,2,0,1,0,0,4,4966,36.77
2640,1,5,0,1,0,0,7,13868,78.23
2641,1,1,1,1,0,0,4,4966,36.77
2642,1,0,2,1,0,6,10,16522,90.12
2643,1,0,0,1,3,4,9,15950,87.44
2644,1,1,1,1,0,0,4,4966,36.77
2645,1,1,1,1,0,0,4,4966,36.77
2646,1,0,2,1,0,4,8,15186,83.84
2647,1,2,1,1,3,0,8,15186,83.84
2648,1,2,1,1,0,0,5,8690,54.42
2649,1,3,0,1,3,0,8,15186,83.84
2650,1,1,0,1,0,0,3,1352,17.01
2651,1,0,1,1,0,0,3,1352,17.01
2652,3,0,5,1,5,0,14,17699,95.82
2653,1,0,0,1,0,0,2,32,3.72
2654,4,0,5,2,5,6,22,18498,99.73
2655,1,0,3,1,1,0,6,11521,68.36
2656,1,0,1,1,0,0,3,1352,17.01
2657,1,0,0,1,0,0,2,32,3.72
2658,1,0,4,2,0,0,7,13868,78.23
2659,1,2,0,1,0,0,4,4966,36.77
2660,1,0,1,1,0,0,3,1352,17.01
2661,1,0,0,1,0,0,2,32,3.72
2662,1,0,1,1,0,0,3,1352,17.01
2663,1,0,1,1,1,0,4,4966,36.77
2664,1,3,2,1,1,0,8,15186,83.84
2665,1,0,1,1,0,0,3,1352,17.01
2666,1,1,1,1,0,0,4,4966,36.77
2667,1,2,0,1,0,0,4,4966,36.77
2668,1,1,1,1,0,0,4,4966,36.77
2669,1,3,0,1,0,0,5,8690,54.42
2670,1,4,0,1,0,0,6,11521,68.36
2671,1,0,0,1,0,0,2,32,3.72
2672,1,3,2,1,0,0,7,13868,78.23
2673,1,4,1,1,0,0,7,13868,78.23
2674,1,2,1,1,1,0,6,11521,68.36
2675,1,2,1,1,3,0,8,15186,83.84
2676,1,0,2,1,1,2,7,13868,78.23
2677,1,0,4,1,4,0,10,16522,90.12
2678,1,0,2,1,0,0,4,4966,36.77
2679,1,1,0,1,1,0,4,4966,36.77
2680,1,4,0,1,0,0,6,11521,68.36
2681,1,0,2,1,3,0,7,13868,78.23
2683,1,0,4,1,0,0,6,11521,68.36
2684,1,1,2,2,0,0,6,11521,68.36
2685,1,2,0,1,0,0,4,4966,36.77
2686,1,1,0,1,0,0,3,1352,17.01
2687,1,0,0,1,1,0,3,1352,17.01
2688,1,4,2,2,2,0,11,16947,91.91
2689,1,2,0,1,2,0,6,11521,68.36
2691,1,3,3,1,0,0,8,15186,83.84
2692,1,3,2,1,1,0,8,15186,83.84
2693,1,1,0,1,0,0,3,1352,17.01
2694,1,2,1,1,0,0,5,8690,54.42
2695,1,1,3,1,4,0,10,16522,90.12
2696,3,0,4,2,5,0,14,17699,95.82
2697,1,3,1,1,3,0,9,15950,87.44
2698,1,0,4,1,1,10,17,18193,98.23
2699,1,0,4,1,0,0,6,11521,68.36
2700,1,1,0,1,3,0,6,11521,68.36
2701,3,0,5,2,5,6,21,18462,99.52
2702,1,0,1,1,2,6,11,16947,91.91
2703,1,4,0,1,0,0,6,11521,68.36
2704,1,4,0,1,0,0,6,11521,68.36
2705,1,0,2,1,0,0,4,4966,36.77
2706,1,1,0,1,0,0,3,1352,17.01
2707,1,1,0,1,0,0,3,1352,17.01
2708,1,1,1,1,0,0,4,4966,36.77
2709,1,0,2,1,4,10,18,18287,98.68
2710,1,1,1,1,2,0,6,11521,68.36
2711,1,1,1,1,1,0,5,8690,54.42
2712,1,0,2,1,0,0,4,4966,36.77
2713,3,0,5,2,5,0,15,17888,96.85
2714,1,1,1,1,3,0,7,13868,78.23
2715,1,0,0,1,0,6,8,15186,83.84
2716,1,3,0,1,0,0,5,8690,54.42
2717,1,0,0,1,0,0,2,32,3.72
2718,1,0,1,1,0,0,3,1352,17.01
2719,1,3,0,1,1,0,6,11521,68.36
2720,1,2,0,1,0,0,4,4966,36.77
2721,1,1,1,1,3,0,7,13868,78.23
2722,1,1,4,3,0,0,9,15950,87.44
2723,1,0,2,1,3,0,7,13868,78.23
2724,1,0,1,1,1,0,4,4966,36.77
2725,4,1,5,2,5,0,17,18193,98.23
2726,1,1,3,1,0,2,8,15186,83.84
2727,1,1,0,1,0,0,3,1352,17.01
2728,1,1,0,1,0,0,3,1352,17.01
2729,1,0,3,1,2,0,7,13868,78.23
2730,1,0,1,1,0,0,3,1352,17.01
2731,1,0,3,1,1,0,6,11521,68.36
2732,1,0,4,1,1,0,7,13868,78.23
2733,1,0,0,1,0,0,2,32,3.72
2734,1,0,1,1,1,0,4,4966,36.77
2735,1,0,3,1,1,2,8,15186,83.84
2736,1,4,1,1,0,0,7,13868,78.23
2737,1,0,3,2,1,0,7,13868,78.23
2738,1,1,0,1,0,0,3,1352,17.01
2739,1,0,0,1,0,0,2,32,3.72
2740,1,0,4,1,1,0,7,13868,78.23
2741,1,0,0,1,0,0,2,32,3.72
2742,1,2,1,1,0,0,5,8690,54.42
2743,3,0,5,2,3,6,19,18362,99.04
2744,1,1,0,1,1,10,14,17699,95.82
2745,1,0,3,1,0,0,5,8690,54.42
2746,1,0,0,1,1,0,3,1352,17.01
2747,1,0,2,1,1,0,5,8690,54.42
2748,1,0,0,1,0,10,12,17186,93.28
2749,1,0,2,1,0,0,4,4966,36.77
2750,1,1,1,1,1,0,5,8690,54.42
2751,1,1,1,1,0,0,4,4966,36.77
2752,1,3,0,1,0,0,5,8690,54.42
2753,1,2,2,1,0,0,6,11521,68.36
2754,1,1,1,1,2,0,6,11521,68.36
2755,1,2,1,1,0,0,5,8690,54.42
2756,1,1,0,1,0,0,3,1352,17.01
2757,1,0,1,2,0,0,4,4966,36.77
2758,3,0,5,2,3,0,13,17456,94.66
2759,3,0,5,2,5,0,15,17888,96.85
2760,1,3,0,1,0,0,5,8690,54.42
2761,1,0,1,1,2,0,5,8690,54.42
2762,1,0,2,1,1,0,5,8690,54.42
2763,1,2,0,1,0,0,4,4966,36.77
2764,1,3,1,1,0,0,6,11521,68.36
2765,1,2,1,1,0,0,5,8690,54.42
2766,1,2,0,1,0,0,4,4966,36.77
2767,1,1,2,1,0,0,5,8690,54.42
2768,1,1,0,1,1,4,8,15186,83.84
2769,1,4,0,1,1,0,7,13868,78.23
2770,1,2,0,1,0,0,4,4966,36.77
2771,1,0,3,1,0,0,5,8690,54.42
2772,1,2,0,1,2,0,6,11521,68.36
2773,1,0,1,1,0,4,7,13868,78.23
2774,1,2,0,1,0,0,4,4966,36.77
2775,1,0,2,2,0,0,5,8690,54.42
2776,1,4,2,1,0,0,8,15186,83.84
2777,1,1,0,1,0,0,3,1352,17.01
2778,1,1,3,1,1,0,7,13868,78.23
2779,1,1,2,1,0,0,5,8690,54.42
2780,1,2,0,1,0,0,4,4966,36.77
2781,1,3,1,1,0,0,6,11521,68.36
2782,1,0,3,2,1,0,7,13868,78.23
2783,1,0,1,1,2,0,5,8690,54.42
2784,1,2,1,1,0,0,5,8690,54.42
2785,1,0,1,1,1,4,8,15186,83.84
2786,1,1,0,1,0,0,3,1352,17.01
2787,1,4,0,1,2,0,8,15186,83.84
2788,1,0,0,1,0,6,8,15186,83.84
2789,1,3,0,1,0,0,5,8690,54.42
2790,1,1,1,1,0,0,4,4966,36.77
2791,1,1,0,1,0,0,3,1352,17.01
2792,1,0,1,1,2,0,5,8690,54.42
2794,1,4,0,1,0,0,6,11521,68.36
2795,1,4,1,1,2,0,9,15950,87.44
2796,1,0,2,1,0,0,4,4966,36.77
2797,1,0,3,1,1,0,6,11521,68.36
2798,1,0,1,1,2,0,5,8690,54.42
2799,1,5,2,2,2,0,12,17186,93.28
2801,1,0,3,2,1,2,9,15950,87.44
2802,1,0,2,1,1,0,5,8690,54.42
2803,1,3,0,1,0,0,5,8690,54.42
2804,1,2,0,1,0,0,4,4966,36.77
2805,1,1,1,1,0,0,4,4966,36.77
2806,1,0,1,1,2,2,7,13868,78.23
2807,1,3,0,1,0,0,5,8690,54.42
2808,1,0,0,1,0,0,2,32,3.72
2809,1,1,1,1,0,0,4,4966,36.77
2810,1,2,0,1,0,0,4,4966,36.77
2811,1,0,1,1,2,0,5,8690,54.42
2812,3,1,3,2,3,0,12,17186,93.28
2813,1,2,1,1,0,0,5,8690,54.42
2814,3,5,5,3,5,0,21,18462,99.52
2815,1,1,4,1,1,0,8,15186,83.84
2816,1,1,2,1,0,0,5,8690,54.42
2817,1,1,1,1,0,0,4,4966,36.77
2818,1,4,1,1,0,0,7,13868,78.23
2819,1,4,0,1,3,0,9,15950,87.44
2820,1,0,0,1,0,0,2,32,3.72
2821,1,0,2,1,0,0,4,4966,36.77
2822,1,0,2,1,0,0,4,4966,36.77
2823,1,1,1,1,3,0,7,13868,78.23
2824,1,0,1,1,0,0,3,1352,17.01
2825,1,0,0,1,0,0,2,32,3.72
2826,1,0,0,1,0,0,2,32,3.72
2827,1,1,2,1,0,0,5,8690,54.42
2828,1,3,0,1,0,0,5,8690,54.42
2829,3,0,5,2,2,0,12,17186,93.28
2831,1,1,2,1,0,0,5,8690,54.42
2832,1,4,1,1,0,0,7,13868,78.23
2833,1,1,1,1,0,0,4,4966,36.77
2834,1,0,2,1,3,0,7,13868,78.23
2835,1,3,0,1,0,0,5,8690,54.42
2836,1,1,0,1,0,0,3,1352,17.01
2837,1,0,2,1,1,4,9,15950,87.44
2838,3,0,5,1,2,0,11,16947,91.91
2839,1,0,2,1,0,0,4,4966,36.77
2840,3,0,5,1,4,0,13,17456,94.66
2841,1,1,0,1,0,10,13,17456,94.66
2842,1,2,0,1,3,0,7,13868,78.23
2843,1,1,1,1,0,0,4,4966,36.77
2844,1,4,0,1,0,0,6,11521,68.36
2845,1,1,0,1,0,0,3,1352,17.01
2846,1,0,0,1,1,6,9,15950,87.44
2847,1,1,2,1,0,0,5,8690,54.42
2848,1,4,0,1,3,0,9,15950,87.44
2849,1,5,0,1,0,0,7,13868,78.23
2850,1,3,2,1,2,0,9,15950,87.44
2851,1,0,2,1,0,0,4,4966,36.77
2852,1,1,2,1,0,0,5,8690,54.42
2853,1,3,0,1,0,0,5,8690,54.42
2854,1,3,0,1,0,0,5,8690,54.42
2855,1,1,2,1,2,0,7,13868,78.23
2856,1,1,0,1,0,0,3,1352,17.01
2857,4,0,5,2,5,6,22,18498,99.73
2858,1,0,2,1,0,0,4,4966,36.77
2859,1,2,1,1,0,0,5,8690,54.42
2860,1,0,1,1,0,6,9,15950,87.44
2861,1,0,5,1,0,4,11,16947,91.91
2862,1,1,0,1,1,0,4,4966,36.77
2864,1,0,1,1,1,0,4,4966,36.77
2865,1,1,1,1,0,0,4,4966,36.77
2866,1,0,1,1,0,0,3,1352,17.01
2867,3,0,3,1,5,6,18,18287,98.68
2868,3,1,4,1,4,2,15,17888,96.85
2869,1,2,0,1,0,0,4,4966,36.77
2870,1,0,3,2,0,6,12,17186,93.28
2871,1,2,1,1,0,0,5,8690,54.42
2872,1,0,1,1,0,0,3,1352,17.01
2873,1,0,1,1,0,0,3,1352,17.01
2874,1,2,1,1,0,0,5,8690,54.42
2875,1,4,0,1,3,0,9,15950,87.44
2876,1,3,0,1,0,0,5,8690,54.42
2877,1,5,0,1,0,0,7,13868,78.23
2878,1,1,2,1,0,0,5,8690,54.42
2879,1,1,1,1,0,0,4,4966,36.77
2880,1,1,0,1,0,0,3,1352,17.01
2881,1,2,0,1,0,0,4,4966,36.77
2882,1,0,0,1,0,0,2,32,3.72
2883,1,2,0,1,0,0,4,4966,36.77
2884,3,0,5,2,3,0,13,17456,94.66
2885,1,1,0,1,1,0,4,4966,36.77
2886,1,4,2,1,1,0,9,15950,87.44
2887,1,0,1,1,0,0,3,1352,17.01
2888,1,4,0,1,1,0,7,13868,78.23
2889,1,3,0,1,1,0,6,11521,68.36
2890,1,3,2,1,0,0,7,13868,78.23
2891,1,0,3,1,1,0,6,11521,68.36
2892,1,4,0,1,0,0,6,11521,68.36
2893,1,1,1,1,1,6,11,16947,91.91
2894,1,0,1,1,0,0,3,1352,17.01
2895,1,3,1,1,0,0,6,11521,68.36
2896,1,2,0,1,3,0,7,13868,78.23
2897,1,0,4,1,0,4,10,16522,90.12
2898,1,1,0,1,0,0,3,1352,17.01
2899,1,1,1,1,1,0,5,8690,54.42
2900,1,0,1,1,0,6,9,15950,87.44
2901,1,0,3,1,0,0,5,8690,54.42
2902,3,1,5,1,4,0,14,17699,95.82
2903,1,0,2,1,2,6,12,17186,93.28
2904,1,0,0,1,0,6,8,15186,83.84
2905,1,4,0,1,4,0,10,16522,90.12
2906,3,0,5,1,5,0,14,17699,95.82
2907,1,1,1,1,0,0,4,4966,36.77
2908,1,0,1,1,0,4,7,13868,78.23
2909,1,0,5,2,1,0,9,15950,87.44
2910,1,1,0,1,2,0,5,8690,54.42
2911,4,0,5,1,5,0,15,17888,96.85
2912,1,0,1,1,0,0,3,1352,17.01
2913,1,1,1,1,0,0,4,4966,36.77
2914,1,1,0,1,0,0,3,1352,17.01
2915,1,4,1,1,3,0,10,16522,90.12
2916,1,4,0,1,1,0,7,13868,78.23
2917,3,0,5,1,5,6,20,18419,99.31
2918,1,0,2,1,0,0,4,4966,36.77
2919,1,0,1,1,3,2,8,15186,83.84
2920,1,2,0,1,0,0,4,4966,36.77
2921,1,1,0,1,0,0,3,1352,17.01
2922,1,4,0,1,0,0,6,11521,68.36
2923,1,0,1,1,2,0,5,8690,54.42
2924,1,1,2,1,1,0,6,11521,68.36
2925,1,2,1,1,0,0,5,8690,54.42
2926,3,0,5,2,5,0,15,17888,96.85
2927,1,4,0,1,0,0,6,11521,68.36
2928,1,1,0,1,0,0,3,1352,17.01
2929,1,0,2,1,1,0,5,8690,54.42
2930,1,0,1,1,3,0,6,11521,68.36
2931,1,2,1,1,0,0,5,8690,54.42
2932,1,4,1,1,0,0,7,13868,78.23
2933,1,0,3,1,3,0,8,15186,83.84
2934,1,0,2,1,0,0,4,4966,36.77
2935,1,2,1,1,4,0,9,15950,87.44
2936,1,0,1,1,0,0,3,1352,17.01
2937,1,3,1,1,0,6,12,17186,93.28
2938,1,0,0,1,3,0,5,8690,54.42
2939,1,2,0,1,3,0,7,13868,78.23
2940,1,1,2,1,0,6,11,16947,91.91
2941,1,1,1,1,1,0,5,8690,54.42
2942,1,0,0,1,0,0,2,32,3.72
2943,1,1,0,1,0,0,3,1352,17.01
2944,1,4,2,1,0,0,8,15186,83.84
2945,1,1,1,1,0,0,4,4966,36.77
2946,3,0,5,2,5,0,15,17888,96.85
2947,1,1,0,1,0,0,3,1352,17.01
2948,1,1,0,1,0,0,3,1352,17.01
2949,1,4,0,1,0,0,6,11521,68.36
2950,1,4,0,1,0,0,6,11521,68.36
2951,1,3,0,1,0,0,5,8690,54.42
2952,1,0,0,1,0,0,2,32,3.72
2953,1,4,2,1,0,0,8,15186,83.84
2954,1,0,1,1,0,0,3,1352,17.01
2955,1,1,2,1,0,0,5,8690,54.42
2956,1,2,0,1,0,0,4,4966,36.77
2958,1,0,2,1,0,0,4,4966,36.77
2959,1,3,1,1,0,0,6,11521,68.36
2960,1,2,3,1,0,0,7,13868,78.23
2961,1,4,0,1,0,0,6,11521,68.36
2962,1,4,0,1,0,0,6,11521,68.36
2964,1,2,0,1,1,0,5,8690,54.42
2965,1,1,0,1,2,0,5,8690,54.42
2966,1,2,0,1,3,0,7,13868,78.23
2967,1,0,0,1,1,0,3,1352,17.01
2968,1,0,3,2,0,0,6,11521,68.36
2969,1,0,1,1,3,0,6,11521,68.36
2970,1,0,2,1,0,2,6,11521,68.36
2971,1,0,3,2,3,0,9,15950,87.44
2972,1,5,0,1,0,0,7,13868,78.23
2973,1,3,0,1,1,0,6,11521,68.36
2974,1,3,0,1,1,0,6,11521,68.36
2976,3,1,5,1,5,6,21,18462,99.52
2977,1,2,0,1,0,0,4,4966,36.77
2978,1,0,3,1,1,4,10,16522,90.12
2979,1,2,1,1,0,0,5,8690,54.42
2980,1,2,0,1,0,0,4,4966,36.77
2981,1,1,1,1,0,0,4,4966,36.77
2982,1,0,2,1,3,6,13,17456,94.66
2983,1,1,2,1,0,0,5,8690,54.42
2984,1,1,0,1,0,0,3,1352,17.01
2985,1,4,0,1,0,0,6,11521,68.36
2986,1,1,0,1,0,0,3,1352,17.01
2987,1,1,3,1,1,0,7,13868,78.23
2988,1,0,2,1,0,0,4,4966,36.77
2989,1,0,3,2,1,0,7,13868,78.23
2990,1,4,0,1,0,0,6,11521,68.36
2991,1,2,0,1,1,0,5,8690,54.42
2992,1,0,1,1,0,6,9,15950,87.44
2993,1,0,1,1,0,0,3,1352,17.01
2994,1,0,3,2,0,0,6,11521,68.36
2995,1,1,2,1,4,0,9,15950,87.44
2996,1,3,0,1,0,0,5,8690,54.42
2997,1,1,0,1,0,0,3,1352,17.01
2998,1,0,2,1,1,0,5,8690,54.42
2999,1,1,1,1,1,0,5,8690,54.42
3000,1,0,1,1,0,0,3,1352,17.01
3001,1,2,0,0,0,0,3,1352,17.01
3002,1,0,4,1,0,0,6,11521,68.36
3003,1,0,1,1,0,0,3,1352,17.01
3004,1,0,1,1,1,0,4,4966,36.77
3005,3,0,5,2,5,8,23,18538,99.86
3006,1,0,2,1,0,0,4,4966,36.77
3007,1,4,0,1,3,0,9,15950,87.44
3008,1,1,1,1,0,0,4,4966,36.77
3009,1,1,2,1,1,0,6,11521,68.36
3010,1,5,2,2,2,0,12,17186,93.28
3011,1,0,2,1,1,0,5,8690,54.42
3012,1,2,3,1,4,0,11,16947,91.91
3013,1,0,3,1,3,10,18,18287,98.68
3015,4,0,5,2,5,10,26,18556,99.96
3016,1,5,0,1,0,0,7,13868,78.23
3017,1,3,0,1,0,0,5,8690,54.42
3018,3,0,5,1,5,10,24,18547,99.89
3019,1,1,0,1,0,2,5,8690,54.42
3020,1,0,1,1,0,0,3,1352,17.01
3021,1,2,1,2,0,0,6,11521,68.36
3022,1,4,1,1,3,0,10,16522,90.12
3023,1,4,1,1,1,0,8,15186,83.84
3025,1,0,0,1,0,0,2,32,3.72
3026,3,0,4,1,3,6,17,18193,98.23
3027,3,0,5,2,3,0,13,17456,94.66
3028,1,3,0,1,2,0,7,13868,78.23
3029,1,1,1,1,0,0,4,4966,36.77
3030,1,1,0,1,1,0,4,4966,36.77
3031,1,0,0,1,2,0,4,4966,36.77
3032,1,0,1,1,0,0,3,1352,17.01
3033,1,0,1,1,0,0,3,1352,17.01
3034,1,1,1,1,0,0,4,4966,36.77
3035,1,1,1,1,0,0,4,4966,36.77
3036,1,0,1,1,1,0,4,4966,36.77
3037,1,4,2,1,0,0,8,15186,83.84
3038,1,5,2,1,2,0,11,16947,91.91
3039,1,0,1,1,0,0,3,1352,17.01
3040,1,0,1,1,0,0,3,1352,17.01
3041,1,2,2,1,0,0,6,11521,68.36
3042,1,4,0,1,0,0,6,11521,68.36
3043,1,1,0,1,0,0,3,1352,17.01
3044,1,5,0,1,0,0,7,13868,78.23
3045,1,0,2,1,0,0,4,4966,36.77
3046,1,0,4,1,0,0,6,11521,68.36
3047,1,1,0,1,0,0,3,1352,17.01
3048,1,0,1,1,0,0,3,1352,17.01
3049,1,4,2,1,4,0,12,17186,93.28
3050,1,0,1,1,0,0,3,1352,17.01
3051,1,0,0,1,2,0,4,4966,36.77
3052,1,0,0,1,0,0,2,32,3.72
3053,1,1,0,1,0,0,3,1352,17.01
3054,1,3,0,1,3,0,8,15186,83.84
3055,1,1,1,1,0,0,4,4966,36.77
3056,1,2,1,1,0,0,5,8690,54.42
3057,1,4,0,1,0,0,6,11521,68.36
3058,1,4,1,1,0,0,7,13868,78.23
3059,1,1,0,1,3,0,6,11521,68.36
3060,1,3,1,1,0,0,6,11521,68.36
3061,1,2,1,1,1,0,6,11521,68.36
3062,3,1,2,1,4,0,11,16947,91.91
3063,1,0,0,1,0,0,2,32,3.72
3064,1,0,1,1,0,0,3,1352,17.01
3065,3,0,5,2,5,0,15,17888,96.85
3067,1,1,2,1,2,0,7,13868,78.23
3068,1,0,1,1,0,0,3,1352,17.01
3069,1,3,2,1,0,0,7,13868,78.23
3070,1,0,5,2,1,0,9,15950,87.44
3071,1,0,0,1,2,0,4,4966,36.77
3072,1,3,1,1,0,0,6,11521,68.36
3073,1,3,0,1,0,0,5,8690,54.42
3074,1,1,1,1,0,0,4,4966,36.77
3075,1,0,0,1,2,0,4,4966,36.77
3076,1,1,0,1,0,0,3,1352,17.01
3077,1,1,2,1,0,0,5,8690,54.42
3078,1,0,0,0,0,0,1,1,0.08
3079,1,4,0,1,0,0,6,11521,68.36
3080,1,1,1,1,0,0,4,4966,36.77
3081,1,1,1,1,0,0,4,4966,36.77
3082,1,0,1,1,0,0,3,1352,17.01
3083,1,0,1,1,0,0,3,1352,17.01
3084,3,1,5,2,2,8,21,18462,99.52
3085,1,3,0,1,0,0,5,8690,54.42
3087,1,0,2,1,0,0,4,4966,36.77
3088,1,0,1,1,0,0,3,1352,17.01
3089,1,3,0,1,0,0,5,8690,54.42
3090,1,3,0,1,0,0,5,8690,54.42
3092,1,3,1,1,0,6,12,17186,93.28
3093,1,0,0,1,0,0,2,32,3.72
3095,1,0,2,1,1,4,9,15950,87.44
3096,1,2,0,1,0,0,4,4966,36.77
3097,1,0,1,1,0,0,3,1352,17.01
3098,1,0,0,1,0,0,2,32,3.72
3099,1,1,1,1,0,0,4,4966,36.77
3100,1,1,2,1,1,0,6,11521,68.36
3101,1,3,2,1,1,0,8,15186,83.84
3102,1,1,2,1,0,10,15,17888,96.85
3103,1,3,0,1,0,0,5,8690,54.42
3104,1,0,1,1,1,6,10,16522,90.12
3105,1,4,0,1,0,0,6,11521,68.36
3106,1,2,0,1,0,0,4,4966,36.77
3107,1,1,0,1,0,0,3,1352,17.01
3108,1,0,1,1,0,0,3,1352,17.01
3109,1,0,4,1,4,0,10,16522,90.12
3110,1,3,1,1,0,0,6,11521,68.36
3111,1,1,1,1,0,0,4,4966,36.77
3112,1,0,1,1,0,0,3,1352,17.01
3113,1,2,0,1,0,0,4,4966,36.77
3114,1,1,1,1,0,0,4,4966,36.77
3115,1,1,0,1,0,0,3,1352,17.01
3116,1,0,0,1,0,0,2,32,3.72
3117,4,0,5,2,5,6,22,18498,99.73
3118,1,0,1,1,0,0,3,1352,17.01
3119,1,1,1,1,2,0,6,11521,68.36
3120,1,1,0,1,0,0,3,1352,17.01
3121,1,0,4,1,1,0,7,13868,78.23
3122,1,1,0,1,0,0,3,1352,17.01
3123,1,0,5,1,1,4,12,17186,93.28
3124,1,3,1,1,0,0,6,11521,68.36
3125,1,0,0,1,3,0,5,8690,54.42
3126,1,4,2,2,2,0,11,16947,91.91
3127,1,0,1,1,2,0,5,8690,54.42
3128,1,1,3,2,1,6,14,17699,95.82
3129,4,0,5,2,5,0,16,18081,97.67
3130,1,0,3,1,2,0,7,13868,78.23
3131,1,1,0,1,0,0,3,1352,17.01
3132,1,0,0,1,0,0,2,32,3.72
3133,1,2,1,1,0,0,5,8690,54.42
3134,1,0,2,1,0,0,4,4966,36.77
3135,1,1,3,1,1,0,7,13868,78.23
3136,1,3,2,1,0,0,7,13868,78.23
3137,1,4,1,1,0,0,7,13868,78.23
3138,1,4,1,1,2,0,9,15950,87.44
3139,1,2,1,1,0,0,5,8690,54.42
3140,1,0,1,1,0,0,3,1352,17.01
3141,1,3,0,1,0,0,5,8690,54.42
3142,1,1,0,1,0,0,3,1352,17.01
3143,1,4,1,1,0,0,7,13868,78.23
3144,1,2,0,1,0,0,4,4966,36.77
3145,1,3,0,1,0,0,5,8690,54.42
3146,1,1,1,1,0,0,4,4966,36.77
3147,1,1,1,1,0,0,4,4966,36.77
3148,3,0,5,2,4,0,14,17699,95.82
3149,1,3,1,1,1,0,7,13868,78.23
3150,1,4,0,1,1,0,7,13868,78.23
3151,1,0,1,1,3,0,6,11521,68.36
3152,1,2,0,1,0,0,4,4966,36.77
3153,1,1,0,1,0,0,3,1352,17.01
3154,1,3,1,1,0,0,6,11521,68.36
3155,1,2,1,1,0,0,5,8690,54.42
3156,1,0,1,1,1,0,4,4966,36.77
3157,1,2,0,1,0,0,4,4966,36.77
3158,1,2,1,1,1,0,6,11521,68.36
3159,1,0,1,1,0,6,9,15950,87.44
3160,1,0,1,1,0,0,3,1352,17.01
3161,1,0,0,1,0,0,2,32,3.72
3162,1,1,2,2,0,0,6,11521,68.36
3163,1,1,1,1,1,0,5,8690,54.42
3164,1,0,4,1,2,0,8,15186,83.84
3165,1,0,3,1,0,0,5,8690,54.42
3166,1,1,1,1,0,0,4,4966,36.77
3167,1,0,1,1,0,0,3,1352,17.01
3168,1,2,1,1,0,0,5,8690,54.42
3169,1,4,0,1,1,0,7,13868,78.23
3170,3,0,4,1,3,0,11,16947,91.91
3171,1,0,1,1,0,0,3,1352,17.01
3172,1,1,1,1,0,0,4,4966,36.77
3173,1,0,2,1,0,0,4,4966,36.77
3174,1,0,2,1,1,0,5,8690,54.42
3175,1,0,4,1,1,0,7,13868,78.23
3176,1,1,0,1,0,0,3,1352,17.01
3177,1,4,0,1,0,0,6,11521,68.36
3178,1,1,2,1,0,0,5,8690,54.42
3179,3,3,5,2,5,0,18,18287,98.68
3181,1,1,0,1,0,0,3,1352,17.01
3182,1,0,0,1,0,0,2,32,3.72
3183,3,0,4,1,3,0,11,16947,91.91
3184,1,0,0,1,0,6,8,15186,83.84
3185,1,3,0,1,0,0,5,8690,54.42
3186,1,0,2,1,2,0,6,11521,68.36
3187,1,2,1,1,0,0,5,8690,54.42
3188,1,3,0,1,0,0,5,8690,54.42
3189,1,0,3,1,0,0,5,8690,54.42
3190,1,0,2,1,0,0,4,4966,36.77
3191,3,0,5,2,3,6,19,18362,99.04
3192,3,4,4,2,3,0,16,18081,97.67
3193,1,4,1,1,0,0,7,13868,78.23
3194,1,0,1,1,0,0,3,1352,17.01
3195,1,1,4,1,0,0,7,13868,78.23
3196,1,0,3,1,2,0,7,13868,78.23
3197,3,1,5,2,4,2,17,18193,98.23
3198,1,3,0,1,0,0,5,8690,54.42
3199,1,3,0,1,0,0,5,8690,54.42
3200,3,0,4,1,5,0,13,17456,94.66
3201,1,2,0,1,0,0,4,4966,36.77
3202,3,1,3,2,3,0,12,17186,93.28
3203,1,1,0,1,0,2,5,8690,54.42
3204,1,0,1,1,0,0,3,1352,17.01
3205,3,0,5,2,3,0,13,17456,94.66
3206,1,2,2,1,0,0,6,11521,68.36
3207,1,3,1,1,0,0,6,11521,68.36
3208,1,2,0,1,0,0,4,4966,36.77
3209,1,0,2,1,2,0,6,11521,68.36
3210,1,0,3,1,4,0,9,15950,87.44
3211,1,3,1,1,2,0,8,15186,83.84
3212,3,4,5,3,4,0,19,18362,99.04
3213,1,0,0,1,0,0,2,32,3.72
3214,1,1,0,1,0,0,3,1352,17.01
3215,3,0,5,1,5,8,22,18498,99.73
3216,1,0,2,1,0,2,6,11521,68.36
3217,1,4,2,2,0,0,9,15950,87.44
3218,1,1,0,1,0,0,3,1352,17.01
3219,1,4,1,1,0,0,7,13868,78.23
3220,1,3,0,1,0,0,5,8690,54.42
3221,1,0,2,1,2,0,6,11521,68.36
3222,1,1,1,1,0,6,10,16522,90.12
3223,1,0,2,1,0,0,4,4966,36.77
3224,1,4,1,1,0,0,7,13868,78.23
3225,1,3,1,1,2,0,8,15186,83.84
3226,1,0,1,1,0,0,3,1352,17.01
3228,1,3,0,1,0,0,5,8690,54.42
3229,1,0,1,1,3,0,6,11521,68.36
3230,1,4,0,1,0,0,6,11521,68.36
3231,1,0,2,1,2,0,6,11521,68.36
3232,3,0,5,2,5,4,19,18362,99.04
3233,1,1,1,1,4,0,8,15186,83.84
3234,1,1,3,1,0,0,6,11521,68.36
3235,1,2,0,1,0,0,4,4966,36.77
3236,1,0,4,2,0,0,7,13868,78.23
3237,1,3,0,1,0,0,5,8690,54.42
3238,1,0,2,1,0,0,4,4966,36.77
3239,3,1,5,2,3,0,14,17699,95.82
3240,1,0,1,1,3,0,6,11521,68.36
3241,1,3,0,1,1,0,6,11521,68.36
3242,1,1,0,1,0,0,3,1352,17.01
3243,1,4,0,1,2,0,8,15186,83.84
3244,1,0,2,1,0,0,4,4966,36.77
3245,1,2,2,2,0,0,7,13868,78.23
3246,1,4,0,1,0,0,6,11521,68.36
3247,1,0,2,1,1,0,5,8690,54.42
3248,1,1,3,1,1,6,13,17456,94.66
3249,1,0,5,2,0,0,8,15186,83.84
3250,1,1,1,1,0,2,6,11521,68.36
3251,1,1,0,1,0,6,9,15950,87.44
3252,1,0,4,2,3,0,10,16522,90.12
3253,4,0,5,2,5,10,26,18556,99.96
3254,1,1,1,1,0,0,4,4966,36.77
3255,1,4,0,1,0,0,6,11521,68.36
3256,1,0,1,1,0,2,5,8690,54.42
3257,1,0,2,1,0,0,4,4966,36.77
3258,1,0,1,1,0,0,3,1352,17.01
3259,1,2,0,1,0,0,4,4966,36.77
3260,1,3,0,1,0,0,5,8690,54.42
3261,1,0,2,1,0,0,4,4966,36.77
3262,1,0,3,1,1,0,6,11521,68.36
3263,1,0,2,1,0,0,4,4966,36.77
3264,1,4,2,1,0,0,8,15186,83.84
3265,1,0,2,1,3,0,7,13868,78.23
3266,1,0,1,1,0,0,3,1352,17.01
3267,1,3,2,1,0,0,7,13868,78.23
3268,1,0,2,1,0,0,4,4966,36.77
3269,1,4,0,1,0,0,6,11521,68.36
3270,1,3,1,1,0,0,6,11521,68.36
3271,1,0,5,1,0,0,7,13868,78.23
3272,3,0,5,1,3,0,12,17186,93.28
3273,1,2,0,1,0,0,4,4966,36.77
3274,1,4,0,1,0,0,6,11521,68.36
3275,1,0,1,1,0,0,3,1352,17.01
3276,1,1,0,1,0,6,9,15950,87.44
3277,1,0,2,1,1,0,5,8690,54.42
3278,1,0,1,1,0,0,3,1352,17.01
3279,1,2,2,2,0,0,7,13868,78.23
3280,1,2,1,1,2,0,7,13868,78.23
3281,1,0,2,1,1,0,5,8690,54.42
3282,1,5,1,1,0,0,8,15186,83.84
3283,1,3,3,1,2,0,10,16522,90.12
3284,1,0,3,2,3,0,9,15950,87.44
3285,1,0,1,1,0,2,5,8690,54.42
3286,1,1,0,1,0,0,3,1352,17.01
3287,1,0,1,1,0,0,3,1352,17.01
3288,1,0,2,1,0,0,4,4966,36.77
3289,1,1,1,1,0,0,4,4966,36.77
3290,1,0,0,1,1,0,3,1352,17.01
3291,1,0,2,1,2,0,6,11521,68.36
3293,1,0,3,1,4,0,9,15950,87.44
3294,1,3,0,1,0,0,5,8690,54.42
3295,3,0,5,2,5,0,15,17888,96.85
3296,1,1,1,1,0,0,4,4966,36.77
3297,1,2,5,1,0,0,9,15950,87.44
3298,1,0,0,1,0,0,2,32,3.72
3299,1,2,0,1,0,0,4,4966,36.77
3300,1,3,1,1,0,0,6,11521,68.36
3301,1,1,1,1,0,0,4,4966,36.77
3302,1,3,0,1,0,0,5,8690,54.42
3303,1,4,0,1,2,0,8,15186,83.84
3304,1,0,0,1,0,0,2,32,3.72
3305,3,0,4,1,3,6,17,18193,98.23
3306,1,0,1,1,0,0,3,1352,17.01
3307,1,2,1,1,0,0,5,8690,54.42
3308,1,0,2,1,4,0,8,15186,83.84
3309,1,4,0,1,0,0,6,11521,68.36
3310,3,0,5,1,5,4,18,18287,98.68
3311,1,0,0,1,0,0,2,32,3.72
3312,1,1,1,1,0,0,4,4966,36.77
3313,1,0,0,1,3,0,5,8690,54.42
3314,1,1,1,1,0,6,10,16522,90.12
3315,1,0,0,1,0,0,2,32,3.72
3316,1,1,0,1,0,0,3,1352,17.01
3317,1,0,2,1,0,0,4,4966,36.77
3318,1,1,1,1,0,0,4,4966,36.77
3319,1,0,2,1,0,0,4,4966,36.77
3320,1,1,2,1,2,0,7,13868,78.23
3321,1,3,2,1,0,0,7,13868,78.23
3322,3,0,5,1,3,0,12,17186,93.28
3323,1,1,2,1,0,0,5,8690,54.42
3324,1,1,1,1,0,0,4,4966,36.77
3325,1,0,1,1,1,4,8,15186,83.84
3326,1,1,0,1,0,0,3,1352,17.01
3327,1,1,1,1,0,0,4,4966,36.77
3328,1,4,0,1,2,0,8,15186,83.84
3329,1,0,1,1,0,0,3,1352,17.01
3330,1,1,1,1,0,0,4,4966,36.77
3331,1,0,0,1,3,0,5,8690,54.42
3332,3,0,4,2,5,0,14,17699,95.82
3333,1,0,1,1,2,10,15,17888,96.85
3334,1,3,2,1,2,0,9,15950,87.44
3335,1,0,1,1,0,6,9,15950,87.44
3336,1,1,1,1,0,0,4,4966,36.77
3337,1,1,0,1,0,0,3,1352,17.01
3338,1,3,0,1,0,0,5,8690,54.42
3339,1,3,1,1,1,6,13,17456,94.66
3340,3,0,5,2,4,0,14,17699,95.82
3341,1,1,0,1,0,0,3,1352,17.01
3342,1,0,0,1,0,0,2,32,3.72
3343,1,0,2,2,0,0,5,8690,54.42
3344,1,3,1,1,0,0,6,11521,68.36
3345,1,1,2,1,0,0,5,8690,54.42
3346,1,1,1,1,0,0,4,4966,36.77
3347,1,0,1,1,0,0,3,1352,17.01
3348,3,0,5,3,5,0,16,18081,97.67
3349,1,0,3,1,2,0,7,13868,78.23
3350,1,0,2,1,0,0,4,4966,36.77
3351,1,1,1,1,0,0,4,4966,36.77
3352,3,0,3,2,5,6,19,18362,99.04
3353,1,3,0,1,0,0,5,8690,54.42
3354,1,0,2,1,4,0,8,15186,83.84
3355,1,0,1,1,0,0,3,1352,17.01
3356,1,2,1,1,0,6,11,16947,91.91
3357,1,4,1,1,0,0,7,13868,78.23
3358,1,1,0,1,0,0,3,1352,17.01
3359,3,0,5,3,5,0,16,18081,97.67
3360,1,1,1,1,0,0,4,4966,36.77
3361,1,0,2,1,3,0,7,13868,78.23
3362,1,0,1,1,2,0,5,8690,54.42
3363,1,0,0,1,1,0,3,1352,17.01
3364,1,1,1,1,0,0,4,4966,36.77
3365,1,4,2,1,0,0,8,15186,83.84
3366,1,0,1,1,0,0,3,1352,17.01
3367,1,1,0,1,0,0,3,1352,17.01
3368,1,3,1,1,0,0,6,11521,68.36
3369,1,0,3,1,0,6,11,16947,91.91
3370,1,0,1,1,0,0,3,1352,17.01
3371,1,3,0,1,1,0,6,11521,68.36
3372,1,4,0,1,0,0,6,11521,68.36
3373,1,2,0,1,0,0,4,4966,36.77
3374,1,4,1,2,0,0,8,15186,83.84
3375,1,2,0,1,1,0,5,8690,54.42
3376,1,4,1,2,0,0,8,15186,83.84
3377,1,2,0,1,0,0,4,4966,36.77
3378,1,1,1,1,0,0,4,4966,36.77
3379,1,2,0,1,0,0,4,4966,36.77
3380,1,0,3,1,1,0,6,11521,68.36
3381,3,0,5,3,3,0,14,17699,95.82
3382,1,0,1,1,2,0,5,8690,54.42
3383,1,4,0,1,0,0,6,11521,68.36
3384,1,0,3,1,1,4,10,16522,90.12
3385,1,0,0,1,0,0,2,32,3.72
3386,1,1,0,1,0,0,3,1352,17.01
3387,1,4,0,1,0,0,6,11521,68.36
3388,1,0,2,1,0,0,4,4966,36.77
3389,1,3,0,1,0,0,5,8690,54.42
3390,3,0,5,2,4,0,14,17699,95.82
3391,1,1,1,1,0,0,4,4966,36.77
3392,1,4,0,1,0,0,6,11521,68.36
3393,1,3,0,1,0,0,5,8690,54.42
3394,1,0,2,1,0,0,4,4966,36.77
3395,1,1,3,1,0,0,6,11521,68.36
3396,1,0,2,1,0,0,4,4966,36.77
3397,1,1,0,1,3,0,6,11521,68.36
3398,1,0,2,1,0,0,4,4966,36.77
3399,1,4,3,2,3,0,13,17456,94.66
3400,1,2,0,1,0,0,4,4966,36.77
3401,1,4,0,1,3,0,9,15950,87.44
3402,1,4,0,1,0,0,6,11521,68.36
3403,1,0,1,1,0,0,3,1352,17.01
3404,1,0,2,1,0,0,4,4966,36.77
3405,1,2,0,1,0,0,4,4966,36.77
3406,1,2,3,1,0,0,7,13868,78.23
3407,1,1,1,1,0,6,10,16522,90.12
3408,1,0,4,2,3,8,18,18287,98.68
3409,1,2,1,1,0,0,5,8690,54.42
3410,1,0,1,1,0,0,3,1352,17.01
3411,1,1,0,1,0,4,7,13868,78.23
3412,1,3,0,1,0,0,5,8690,54.42
3413,1,0,0,1,0,0,2,32,3.72
3414,1,1,0,1,0,0,3,1352,17.01
3415,1,1,1,1,3,0,7,13868,78.23
3416,1,3,1,1,2,0,8,15186,83.84
3417,1,0,1,1,0,0,3,1352,17.01
3418,1,0,3,2,0,0,6,11521,68.36
3419,1,0,4,1,0,0,6,11521,68.36
3420,1,2,0,1,0,0,4,4966,36.77
3421,1,4,0,1,0,0,6,11521,68.36
3422,1,0,1,1,0,0,3,1352,17.01
3423,1,2,1,1,2,0,7,13868,78.23
3424,1,2,0,1,0,0,4,4966,36.77
3425,1,0,2,1,0,0,4,4966,36.77
3426,1,0,1,1,0,6,9,15950,87.44
3427,1,4,0,1,0,0,6,11521,68.36
3428,1,2,1,1,3,0,8,15186,83.84
3429,1,0,1,1,1,0,4,4966,36.77
3430,1,2,0,1,0,0,4,4966,36.77
3431,1,0,2,1,0,8,12,17186,93.28
3432,3,0,5,2,5,0,15,17888,96.85
3433,1,1,0,1,2,0,5,8690,54.42
3434,1,0,1,1,1,10,14,17699,95.82
3435,1,0,2,1,3,0,7,13868,78.23
3436,1,0,1,1,0,0,3,1352,17.01
3437,1,4,0,1,0,0,6,11521,68.36
3438,1,1,1,1,0,6,10,16522,90.12
3439,1,2,0,1,0,0,4,4966,36.77
3440,1,2,4,2,2,0,11,16947,91.91
3441,1,1,0,1,0,0,3,1352,17.01
3442,1,0,0,1,0,0,2,32,3.72
3443,1,0,0,1,0,0,2,32,3.72
3444,1,2,0,1,0,0,4,4966,36.77
3445,1,0,0,1,0,0,2,32,3.72
3446,1,0,1,1,0,0,3,1352,17.01
3447,1,1,1,1,0,4,8,15186,83.84
3448,1,4,1,1,2,0,9,15950,87.44
3449,1,0,4,1,0,0,6,11521,68.36
3450,1,0,0,1,3,4,9,15950,87.44
3451,1,3,0,1,0,0,5,8690,54.42
3452,1,0,1,1,3,0,6,11521,68.36
3453,1,3,1,1,0,0,6,11521,68.36
3454,3,0,3,1,5,6,18,18287,98.68
3455,1,3,1,1,0,6,12,17186,93.28
3456,1,3,4,1,0,0,9,15950,87.44
3457,1,0,2,1,0,6,10,16522,90.12
3458,1,1,0,1,0,0,3,1352,17.01
3459,1,4,0,1,1,0,7,13868,78.23
3460,1,4,0,1,0,0,6,11521,68.36
3461,1,1,4,2,0,0,8,15186,83.84
3462,1,2,2,1,0,0,6,11521,68.36
3463,1,0,2,1,0,0,4,4966,36.77
3464,1,0,2,1,1,0,5,8690,54.42
3465,1,0,1,1,0,6,9,15950,87.44
3466,1,1,0,1,0,0,3,1352,17.01
3467,1,0,3,2,1,0,7,13868,78.23
3468,1,2,0,1,3,0,7,13868,78.23
3469,4,0,4,2,5,0,15,17888,96.85
3470,1,0,1,1,0,0,3,1352,17.01
3471,1,0,1,1,0,6,9,15950,87.44
3472,1,2,1,1,0,0,5,8690,54.42
3473,1,4,0,1,0,0,6,11521,68.36
3475,3,0,5,2,3,0,13,17456,94.66
3476,1,2,0,1,1,0,5,8690,54.42
3477,1,0,0,1,0,0,2,32,3.72
3478,1,0,0,1,0,0,2,32,3.72
3479,1,2,1,1,0,0,5,8690,54.42
3480,1,1,0,1,0,0,3,1352,17.01
3481,1,0,2,1,0,0,4,4966,36.77
3482,1,1,3,1,2,0,8,15186,83.84
3483,1,0,2,1,3,0,7,13868,78.23
3484,1,5,0,1,2,0,9,15950,87.44
3485,1,1,0,1,0,0,3,1352,17.01
3486,1,2,0,1,0,0,4,4966,36.77
3487,1,0,2,1,1,0,5,8690,54.42
3489,1,1,1,1,0,0,4,4966,36.77
3490,1,2,3,1,3,0,10,16522,90.12
3491,1,0,0,1,0,0,2,32,3.72
3492,1,1,1,1,0,6,10,16522,90.12
3493,1,2,1,1,0,0,5,8690,54.42
3494,1,2,0,1,2,0,6,11521,68.36
3495,1,2,1,1,0,6,11,16947,91.91
3496,1,0,3,1,1,0,6,11521,68.36
3497,4,0,5,2,5,10,26,18556,99.96
3498,1,0,1,1,0,0,3,1352,17.01
3499,1,0,1,1,0,0,3,1352,17.01
3500,1,4,2,2,1,0,10,16522,90.12
3501,1,0,0,1,0,0,2,32,3.72
3502,1,2,0,1,1,0,5,8690,54.42
3503,1,3,1,1,4,0,10,16522,90.12
3504,1,0,2,1,3,0,7,13868,78.23
3505,1,3,0,1,0,0,5,8690,54.42
3506,1,0,1,1,0,0,3,1352,17.01
3507,1,0,1,1,0,0,3,1352,17.01
3508,1,1,0,1,0,0,3,1352,17.01
3509,1,1,0,1,0,4,7,13868,78.23
3510,1,2,2,1,1,0,7,13868,78.23
3511,3,0,5,2,5,0,15,17888,96.85
3512,1,3,0,1,0,0,5,8690,54.42
3513,1,2,0,1,0,0,4,4966,36.77
3514,3,4,5,4,4,0,20,18419,99.31
3515,1,0,2,1,0,6,10,16522,90.12
3516,1,0,1,1,0,6,9,15950,87.44
3517,1,0,2,1,0,0,4,4966,36.77
3518,1,1,2,1,0,0,5,8690,54.42
3519,1,2,1,1,0,0,5,8690,54.42
3520,1,1,0,1,2,0,5,8690,54.42
3521,1,0,3,1,1,0,6,11521,68.36
3522,1,2,1,1,0,0,5,8690,54.42
3524,1,1,0,1,0,0,3,1352,17.01
3525,1,3,1,1,0,0,6,11521,68.36
3526,1,0,2,1,1,0,5,8690,54.42
3527,1,0,1,1,0,0,3,1352,17.01
3528,1,1,1,1,2,0,6,11521,68.36
3529,1,0,1,1,1,0,4,4966,36.77
3530,1,2,2,1,0,0,6,11521,68.36
3531,1,0,2,1,0,0,4,4966,36.77
3532,3,0,5,2,5,0,15,17888,96.85
3533,1,1,1,1,0,0,4,4966,36.77
3534,1,0,3,2,0,0,6,11521,68.36
3535,1,4,0,1,0,0,6,11521,68.36
3536,1,0,2,1,0,0,4,4966,36.77
3537,1,1,1,1,0,0,4,4966,36.77
3538,1,0,2,1,2,0,6,11521,68.36
3539,1,0,3,1,4,0,9,15950,87.44
3540,1,0,1,1,0,0,3,1352,17.01
3541,1,0,1,1,0,0,3,1352,17.01
3542,1,0,4,1,0,0,6,11521,68.36
3543,1,3,1,1,0,0,6,11521,68.36
3544,1,0,1,1,0,0,3,1352,17.01
3545,3,0,3,1,1,10,18,18287,98.68
3546,1,0,2,1,1,6,11,16947,91.91
3547,1,0,3,1,0,0,5,8690,54.42
3548,1,0,1,1,0,0,3,1352,17.01
3549,3,0,4,2,2,2,13,17456,94.66
3550,1,0,2,1,0,0,4,4966,36.77
3551,1,3,0,1,0,0,5,8690,54.42
3552,1,0,2,1,0,0,4,4966,36.77
3553,1,1,0,1,0,0,3,1352,17.01
3554,1,0,0,1,3,0,5,8690,54.42
3555,1,1,0,1,0,0,3,1352,17.01
3556,1,1,0,1,0,0,3,1352,17.01
3557,1,0,2,1,2,6,12,17186,93.28
3558,1,3,1,1,0,0,6,11521,68.36
3559,1,4,1,1,0,0,7,13868,78.23
3560,1,1,2,1,0,0,5,8690,54.42
3561,1,0,0,1,0,0,2,32,3.72
3562,1,0,0,1,0,0,2,32,3.72
3563,1,4,4,2,0,0,11,16947,91.91
3564,1,2,2,1,1,0,7,13868,78.23
3565,1,0,0,1,0,0,2,32,3.72
3566,1,2,3,1,0,0,7,13868,78.23
3567,1,3,2,1,0,0,7,13868,78.23
3568,1,4,1,1,2,0,9,15950,87.44
3569,1,1,2,1,0,6,11,16947,91.91
3570,1,0,2,1,3,0,7,13868,78.23
3571,1,3,2,2,4,0,12,17186,93.28
3572,1,0,0,1,0,0,2,32,3.72
3573,1,1,2,1,1,0,6,11521,68.36
3574,1,1,1,1,0,0,4,4966,36.77
3575,3,4,5,2,4,0,18,18287,98.68
3576,1,0,2,1,0,0,4,4966,36.77
3577,1,1,0,1,0,0,3,1352,17.01
3578,1,0,2,1,0,2,6,11521,68.36
3579,1,1,0,1,0,0,3,1352,17.01
3580,1,3,3,1,1,6,15,17888,96.85
3581,1,0,1,1,0,0,3,1352,17.01
3582,1,4,0,1,0,0,6,11521,68.36
3583,1,0,0,1,0,0,2,32,3.72
3584,1,1,2,1,2,0,7,13868,78.23
3585,1,0,3,1,3,2,10,16522,90.12
3586,1,3,0,1,0,0,5,8690,54.42
3587,1,1,0,1,0,0,3,1352,17.01
3588,1,0,4,1,0,0,6,11521,68.36
3589,1,0,1,1,2,0,5,8690,54.42
3590,1,5,2,1,1,0,10,16522,90.12
3591,1,1,0,1,0,0,3,1352,17.01
3592,3,0,5,2,2,0,12,17186,93.28
3593,1,2,1,1,0,0,5,8690,54.42
3595,1,1,0,1,0,4,7,13868,78.23
3596,1,0,2,1,2,0,6,11521,68.36
3597,1,2,1,1,0,0,5,8690,54.42
3598,1,0,3,2,1,0,7,13868,78.23
3599,1,0,1,1,0,0,3,1352,17.01
3600,1,5,3,2,0,0,11,16947,91.91
3601,1,0,1,1,0,0,3,1352,17.01
3602,3,0,5,1,3,6,18,18287,98.68
3603,1,1,0,1,0,0,3,1352,17.01
3604,1,0,2,1,3,0,7,13868,78.23
3605,1,4,1,1,0,0,7,13868,78.23
3606,1,1,1,1,0,0,4,4966,36.77
3607,1,3,1,1,0,0,6,11521,68.36
3608,1,2,0,1,0,0,4,4966,36.77
3609,1,0,1,1,0,6,9,15950,87.44
3610,1,0,1,1,0,0,3,1352,17.01
3611,1,2,2,1,0,0,6,11521,68.36
3612,1,4,1,1,0,0,7,13868,78.23
3613,1,0,4,2,0,0,7,13868,78.23
3614,1,3,0,1,0,0,5,8690,54.42
3615,1,5,0,1,0,0,7,13868,78.23
3616,1,1,2,1,3,0,8,15186,83.84
3617,1,3,2,1,1,0,8,15186,83.84
3618,1,0,1,1,0,0,3,1352,17.01
3619,1,0,2,1,0,0,4,4966,36.77
3620,3,0,4,2,4,0,13,17456,94.66
3621,1,0,1,1,0,0,3,1352,17.01
3622,1,0,2,1,0,4,8,15186,83.84
3623,1,4,0,1,0,0,6,11521,68.36
3624,1,2,0,1,0,0,4,4966,36.77
3625,1,1,1,1,0,0,4,4966,36.77
3626,1,4,1,1,0,0,7,13868,78.23
3627,1,0,3,2,1,0,7,13868,78.23
3628,1,4,0,1,0,0,6,11521,68.36
3629,1,2,1,1,0,0,5,8690,54.42
3630,1,2,2,1,0,0,6,11521,68.36
3631,1,0,0,1,2,0,4,4966,36.77
3632,3,0,5,2,3,6,19,18362,99.04
3633,1,0,0,1,2,0,4,4966,36.77
3634,1,0,3,1,2,0,7,13868,78.23
3635,1,0,0,1,3,0,5,8690,54.42
3636,1,1,3,2,3,0,10,16522,90.12
3637,1,1,1,1,3,0,7,13868,78.23
3638,1,3,0,1,0,0,5,8690,54.42
3639,1,2,0,1,0,0,4,4966,36.77
3640,1,1,2,1,3,0,8,15186,83.84
3641,1,4,2,2,0,0,9,15950,87.44
3642,1,0,2,1,0,8,12,17186,93.28
3643,1,0,1,1,0,0,3,1352,17.01
3644,1,1,0,1,1,0,4,4966,36.77
3645,1,1,2,1,0,0,5,8690,54.42
3646,1,1,1,1,0,6,10,16522,90.12
3647,1,1,2,1,0,0,5,8690,54.42
3648,1,0,0,1,0,0,2,32,3.72
3649,1,1,1,1,0,0,4,4966,36.77
3650,1,3,1,1,0,0,6,11521,68.36
3651,1,0,0,1,3,0,5,8690,54.42
3652,1,0,2,1,1,4,9,15950,87.44
3653,1,1,1,1,0,0,4,4966,36.77
3654,1,2,0,1,0,0,4,4966,36.77
3655,1,1,3,1,1,0,7,13868,78.23
3656,3,0,5,2,2,0,12,17186,93.28
3657,1,1,0,1,1,0,4,4966,36.77
3658,1,5,2,1,0,0,9,15950,87.44
3659,1,2,0,1,0,0,4,4966,36.77
3660,1,0,2,1,0,0,4,4966,36.77
3661,3,0,5,2,2,0,12,17186,93.28
3662,1,1,0,1,0,0,3,1352,17.01
3663,1,4,1,1,0,0,7,13868,78.23
3664,1,1,0,1,2,0,5,8690,54.42
3665,1,0,1,1,2,0,5,8690,54.42
3666,1,0,3,1,0,0,5,8690,54.42
3667,1,2,1,1,0,0,5,8690,54.42
3668,1,1,1,1,0,4,8,15186,83.84
3669,1,4,0,1,2,0,8,15186,83.84
3670,1,0,0,1,2,0,4,4966,36.77
3672,1,1,1,1,0,0,4,4966,36.77
3673,1,1,2,1,0,0,5,8690,54.42
3674,1,1,0,1,0,0,3,1352,17.01
3675,3,0,5,1,3,6,18,18287,98.68
3676,1,0,2,1,0,0,4,4966,36.77
3677,1,0,3,1,0,0,5,8690,54.42
3678,1,1,0,1,0,0,3,1352,17.01
3679,1,0,1,1,0,0,3,1352,17.01
3680,1,1,0,1,0,0,3,1352,17.01
3681,1,0,2,1,1,0,5,8690,54.42
3682,4,0,5,2,5,6,22,18498,99.73
3683,1,2,0,1,0,0,4,4966,36.77
3685,1,4,1,1,0,0,7,13868,78.23
3686,1,0,1,1,0,0,3,1352,17.01
3687,1,1,0,1,0,0,3,1352,17.01
3688,1,0,2,1,1,0,5,8690,54.42
3689,1,4,0,1,0,0,6,11521,68.36
3690,1,2,0,1,3,0,7,13868,78.23
3691,1,1,1,1,0,0,4,4966,36.77
3692,1,2,3,1,1,4,12,17186,93.28
3693,1,0,1,1,0,0,3,1352,17.01
3694,4,0,5,2,5,6,22,18498,99.73
3695,1,0,1,1,1,0,4,4966,36.77
3696,1,3,1,1,0,0,6,11521,68.36
3697,1,0,1,1,0,0,3,1352,17.01
3698,1,1,3,1,0,0,6,11521,68.36
3699,1,2,0,1,0,0,4,4966,36.77
3700,1,0,3,1,1,0,6,11521,68.36
3701,1,1,4,2,2,0,10,16522,90.12
3702,1,0,1,1,0,0,3,1352,17.01
3704,1,1,1,1,0,0,4,4966,36.77
3705,1,2,0,1,1,0,5,8690,54.42
3706,1,2,0,1,1,0,5,8690,54.42
3707,1,0,3,1,1,0,6,11521,68.36
3708,1,1,0,1,0,0,3,1352,17.01
3709,1,0,1,1,0,0,3,1352,17.01
3710,1,1,2,1,2,0,7,13868,78.23
3711,3,0,5,2,5,6,21,18462,99.52
3712,1,3,4,2,0,0,10,16522,90.12
3713,1,1,3,1,1,6,13,17456,94.66
3714,1,0,1,1,0,0,3,1352,17.01
3715,1,3,0,1,0,0,5,8690,54.42
3716,1,0,1,1,0,0,3,1352,17.01
3717,1,0,2,1,1,0,5,8690,54.42
3718,1,3,1,1,0,0,6,11521,68.36
3719,1,0,1,1,0,0,3,1352,17.01
3720,1,1,0,0,0,0,2,32,3.72
3721,1,0,2,1,3,0,7,13868,78.23
3722,1,4,0,1,1,0,7,13868,78.23
3723,1,4,1,1,0,0,7,13868,78.23
3724,1,2,1,1,0,0,5,8690,54.42
3725,1,1,0,1,3,0,6,11521,68.36
3726,1,3,0,1,2,0,7,13868,78.23
3727,1,5,2,1,0,0,9,15950,87.44
3728,1,4,0,1,0,0,6,11521,68.36
3729,1,4,2,1,0,0,8,15186,83.84
3730,1,1,0,1,1,0,4,4966,36.77
3731,1,4,0,1,0,0,6,11521,68.36
3732,1,1,1,1,0,0,4,4966,36.77
3733,1,2,1,1,0,0,5,8690,54.42
3734,1,3,1,1,1,0,7,13868,78.23
3735,1,1,2,1,0,0,5,8690,54.42
3736,1,2,1,1,0,0,5,8690,54.42
3737,1,1,2,1,0,0,5,8690,54.42
3738,1,1,1,1,0,0,4,4966,36.77
3739,1,0,1,1,0,0,3,1352,17.01
3740,1,1,2,1,3,0,8,15186,83.84
3741,1,1,3,2,1,0,8,15186,83.84
3742,1,1,1,1,0,0,4,4966,36.77
3743,1,3,2,1,0,0,7,13868,78.23
3744,1,2,0,1,0,0,4,4966,36.77
3745,1,2,0,1,0,0,4,4966,36.77
3746,1,1,1,1,0,0,4,4966,36.77
3747,3,0,5,2,5,0,15,17888,96.85
3748,1,4,0,1,0,0,6,11521,68.36
3749,1,0,1,1,0,4,7,13868,78.23
3750,1,3,1,1,0,0,6,11521,68.36
3751,3,0,4,1,3,10,21,18462,99.52
3752,1,0,1,1,0,0,3,1352,17.01
3753,1,0,1,1,0,10,13,17456,94.66
3754,1,3,4,2,0,0,10,16522,90.12
3755,1,1,1,1,0,0,4,4966,36.77
3756,1,2,0,1,0,0,4,4966,36.77
3757,1,0,0,1,0,0,2,32,3.72
3758,1,4,0,1,0,0,6,11521,68.36
3759,1,0,1,1,0,0,3,1352,17.01
3760,1,3,1,1,1,0,7,13868,78.23
3761,1,1,1,1,0,6,10,16522,90.12
3762,1,0,3,1,0,0,5,8690,54.42
3763,1,1,0,1,0,0,3,1352,17.01
3764,1,0,3,1,4,0,9,15950,87.44
3765,1,1,1,1,3,0,7,13868,78.23
3766,1,4,0,1,0,0,6,11521,68.36
3767,1,3,4,2,0,0,10,16522,90.12
3769,1,2,1,1,0,0,5,8690,54.42
3770,1,0,1,1,1,0,4,4966,36.77
3771,1,1,1,1,0,0,4,4966,36.77
3772,1,1,0,1,0,0,3,1352,17.01
3773,1,0,2,1,1,0,5,8690,54.42
3774,1,1,1,1,0,0,4,4966,36.77
3775,1,0,0,1,0,0,2,32,3.72
3776,1,4,2,1,0,0,8,15186,83.84
3777,3,0,4,2,3,0,12,17186,93.28
3778,1,1,1,1,1,0,5,8690,54.42
3779,1,4,0,1,1,0,7,13868,78.23
3780,1,0,0,1,4,0,6,11521,68.36
3781,3,0,5,2,5,0,15,17888,96.85
3782,1,0,5,3,0,0,9,15950,87.44
3783,1,1,0,1,0,0,3,1352,17.01
3784,3,0,4,4,5,0,16,18081,97.67
3785,1,3,1,1,0,0,6,11521,68.36
3786,3,0,5,2,3,6,19,18362,99.04
3787,1,1,3,1,0,0,6,11521,68.36
3788,1,4,1,1,0,0,7,13868,78.23
3789,1,0,0,1,1,0,3,1352,17.01
3790,1,0,1,1,0,6,9,15950,87.44
3791,1,1,1,1,0,0,4,4966,36.77
3792,1,1,0,1,0,0,3,1352,17.01
3793,1,0,0,1,0,0,2,32,3.72
3794,1,3,0,1,3,0,8,15186,83.84
3795,1,4,1,1,0,0,7,13868,78.23
3796,3,0,5,1,5,6,20,18419,99.31
3797,1,0,3,2,3,0,9,15950,87.44
3798,1,4,0,1,0,0,6,11521,68.36
3799,1,1,0,1,0,0,3,1352,17.01
3800,1,1,0,1,4,0,7,13868,78.23
3801,1,2,0,1,0,0,4,4966,36.77
3802,1,1,1,1,0,0,4,4966,36.77
3803,1,0,2,1,2,0,6,11521,68.36
3804,1,0,2,2,1,0,6,11521,68.36
3806,1,3,0,1,0,0,5,8690,54.42
3807,3,0,5,2,5,4,19,18362,99.04
3808,1,4,0,1,0,0,6,11521,68.36
3810,1,0,1,1,1,0,4,4966,36.77
3811,1,3,2,1,1,0,8,15186,83.84
3812,1,2,0,1,0,0,4,4966,36.77
3813,1,0,1,1,0,0,3,1352,17.01
3814,3,1,4,1,3,0,12,17186,93.28
3815,1,1,0,1,0,0,3,1352,17.01
3816,1,3,2,1,0,0,7,13868,78.23
3817,3,0,5,2,3,0,13,17456,94.66
3818,1,2,1,1,0,0,5,8690,54.42
3819,1,0,2,1,1,0,5,8690,54.42
3820,1,0,0,1,0,0,2,32,3.72
3821,1,1,0,1,0,0,3,1352,17.01
3822,1,0,1,1,0,4,7,13868,78.23
3823,3,0,5,4,3,0,15,17888,96.85
3824,1,2,1,1,0,0,5,8690,54.42
3825,1,2,3,1,4,0,11,16947,91.91
3826,1,1,1,1,2,0,6,11521,68.36
3827,1,3,0,0,0,0,4,4966,36.77
3828,1,1,1,1,1,0,5,8690,54.42
3829,3,1,5,2,3,2,16,18081,97.67
3830,1,1,1,1,1,0,5,8690,54.42
3831,1,1,0,1,0,0,3,1352,17.01
3832,1,4,0,1,0,0,6,11521,68.36
3833,1,0,5,2,0,0,8,15186,83.84
3834,1,0,0,1,0,0,2,32,3.72
3835,1,0,1,1,1,0,4,4966,36.77
3836,1,2,1,1,0,0,5,8690,54.42
3837,1,1,1,1,0,0,4,4966,36.77
3838,1,1,1,1,0,0,4,4966,36.77
3839,3,0,4,1,4,0,12,17186,93.28
3840,1,1,0,1,3,0,6,11521,68.36
3841,1,0,1,1,3,0,6,11521,68.36
3842,1,1,1,1,0,0,4,4966,36.77
3843,1,2,1,1,0,0,5,8690,54.42
3844,1,1,1,1,0,0,4,4966,36.77
3845,1,1,0,1,2,0,5,8690,54.42
3846,1,1,2,1,1,0,6,11521,68.36
3847,1,2,0,1,0,0,4,4966,36.77
3848,1,1,1,1,0,0,4,4966,36.77
3849,1,2,0,1,3,0,7,13868,78.23
3850,1,0,1,1,0,0,3,1352,17.01
3851,1,3,1,1,0,0,6,11521,68.36
3852,1,4,0,1,0,0,6,11521,68.36
3853,1,0,2,1,2,0,6,11521,68.36
3854,1,3,0,1,3,0,8,15186,83.84
3855,1,2,3,1,0,0,7,13868,78.23
3856,1,0,1,1,0,0,3,1352,17.01
3857,3,0,4,2,5,0,14,17699,95.82
3858,1,0,1,1,3,0,6,11521,68.36
3859,1,0,3,1,4,0,9,15950,87.44
3860,1,0,2,1,0,0,4,4966,36.77
3861,1,0,2,1,0,6,10,16522,90.12
3862,1,0,2,1,0,0,4,4966,36.77
3863,1,0,1,1,0,0,3,1352,17.01
3864,1,2,0,1,0,0,4,4966,36.77
3865,1,4,0,1,0,0,6,11521,68.36
3866,1,1,2,1,0,0,5,8690,54.42
3867,1,3,1,1,1,0,7,13868,78.23
3868,1,3,1,1,2,0,8,15186,83.84
3869,1,2,0,1,0,0,4,4966,36.77
3870,3,0,4,3,3,0,13,17456,94.66
3871,1,1,1,1,0,0,4,4966,36.77
3872,1,3,1,1,0,0,6,11521,68.36
3873,1,1,2,1,0,0,5,8690,54.42
3874,1,1,0,1,0,0,3,1352,17.01
3875,1,4,0,1,0,0,6,11521,68.36
3876,1,4,2,2,0,0,9,15950,87.44
3877,1,1,0,1,0,6,9,15950,87.44
3878,1,0,1,1,0,0,3,1352,17.01
3879,1,2,3,1,3,0,10,16522,90.12
3880,1,0,0,1,0,6,8,15186,83.84
3881,1,0,1,1,0,0,3,1352,17.01
3882,1,0,1,1,3,0,6,11521,68.36
3883,1,2,0,1,0,0,4,4966,36.77
3884,1,0,2,1,0,4,8,15186,83.84
3885,1,0,3,1,1,0,6,11521,68.36
3886,1,2,2,2,0,0,7,13868,78.23
3887,1,1,2,1,0,0,5,8690,54.42
3888,1,0,2,1,2,0,6,11521,68.36
3889,1,0,3,1,1,0,6,11521,68.36
3890,1,4,0,1,0,0,6,11521,68.36
3891,1,2,3,2,0,0,8,15186,83.84
3892,1,0,2,1,4,6,14,17699,95.82
3893,1,5,0,1,0,0,7,13868,78.23
3894,1,2,0,1,0,0,4,4966,36.77
3895,1,1,1,1,1,0,5,8690,54.42
3896,1,0,1,1,1,0,4,4966,36.77
3897,1,2,1,1,1,0,6,11521,68.36
3898,1,0,2,1,0,6,10,16522,90.12
3899,1,2,1,1,0,0,5,8690,54.42
3900,1,1,1,1,0,0,4,4966,36.77
3901,1,1,0,1,0,0,3,1352,17.01
3902,1,0,0,1,0,0,2,32,3.72
3903,1,5,2,2,0,0,10,16522,90.12
3904,1,5,0,1,0,0,7,13868,78.23
3905,1,2,0,1,0,0,4,4966,36.77
3906,1,0,1,1,0,0,3,1352,17.01
3907,1,1,0,1,0,0,3,1352,17.01
3908,1,1,1,1,0,0,4,4966,36.77
3909,1,0,0,1,0,0,2,32,3.72
3910,1,0,1,1,0,0,3,1352,17.01
3911,1,3,2,2,0,0,8,15186,83.84
3912,1,0,0,1,3,0,5,8690,54.42
3913,1,4,0,1,0,0,6,11521,68.36
3914,1,0,4,1,4,0,10,16522,90.12
3915,1,3,0,1,0,0,5,8690,54.42
3916,1,1,1,1,0,0,4,4966,36.77
3917,1,0,0,1,0,0,2,32,3.72
3918,3,0,5,1,2,0,11,16947,91.91
3919,1,0,1,1,0,0,3,1352,17.01
3920,1,0,1,1,0,0,3,1352,17.01
3921,1,1,0,1,0,0,3,1352,17.01
3922,1,1,0,1,0,6,9,15950,87.44
3923,1,1,1,1,0,0,4,4966,36.77
3924,1,1,0,1,0,0,3,1352,17.01
3925,3,0,5,2,5,0,15,17888,96.85
3926,1,4,2,1,0,0,8,15186,83.84
3927,3,0,5,2,5,0,15,17888,96.85
3928,1,3,0,1,0,0,5,8690,54.42
3929,1,1,1,1,0,0,4,4966,36.77
3930,1,0,1,1,0,0,3,1352,17.01
3931,1,0,1,1,0,0,3,1352,17.01
3932,1,4,0,1,0,0,6,11521,68.36
3933,1,1,1,1,0,0,4,4966,36.77
3934,1,0,1,1,0,0,3,1352,17.01
3935,1,0,0,1,1,0,3,1352,17.01
3936,1,0,1,1,1,6,10,16522,90.12
3937,1,4,1,1,0,0,7,13868,78.23
3938,1,0,1,1,0,0,3,1352,17.01
3939,1,2,0,1,3,0,7,13868,78.23
3940,1,4,2,2,1,0,10,16522,90.12
3941,1,2,1,1,0,0,5,8690,54.42
3942,1,1,0,1,0,0,3,1352,17.01
3943,1,3,0,1,0,0,5,8690,54.42
3944,1,4,0,1,1,0,7,13868,78.23
3945,1,2,1,1,0,0,5,8690,54.42
3946,1,1,0,1,0,0,3,1352,17.01
3947,1,3,1,1,1,0,7,13868,78.23
3948,3,0,5,2,3,6,19,18362,99.04
3949,1,3,1,1,0,0,6,11521,68.36
3950,1,0,1,1,0,0,3,1352,17.01
3951,1,0,1,1,0,0,3,1352,17.01
3952,1,0,3,1,0,0,5,8690,54.42
3953,1,0,0,1,3,0,5,8690,54.42
3954,3,0,5,3,5,0,16,18081,97.67
3955,1,4,2,1,0,0,8,15186,83.84
3956,1,0,2,1,0,0,4,4966,36.77
3957,1,3,3,2,0,6,15,17888,96.85
3958,1,0,1,1,0,10,13,17456,94.66
3959,1,0,2,1,2,0,6,11521,68.36
3960,1,1,0,1,0,0,3,1352,17.01
3961,1,2,0,1,0,0,4,4966,36.77
3962,1,0,1,1,0,6,9,15950,87.44
3963,1,3,1,1,4,0,10,16522,90.12
3964,1,0,2,1,0,0,4,4966,36.77
3965,1,4,1,1,0,0,7,13868,78.23
3966,1,1,1,1,0,0,4,4966,36.77
3967,1,4,0,1,0,0,6,11521,68.36
3968,1,0,0,1,3,0,5,8690,54.42
3969,1,1,0,1,0,0,3,1352,17.01
3970,1,0,0,1,0,0,2,32,3.72
3971,1,1,0,1,0,6,9,15950,87.44
3972,1,1,0,1,0,0,3,1352,17.01
3973,3,0,5,4,3,0,15,17888,96.85
3974,1,1,0,1,0,6,9,15950,87.44
3975,1,2,0,1,0,0,4,4966,36.77
3976,1,4,1,1,2,0,9,15950,87.44
3977,1,1,1,1,0,0,4,4966,36.77
3978,1,0,1,1,0,2,5,8690,54.42
3979,1,0,2,1,0,0,4,4966,36.77
3980,1,3,3,1,0,0,8,15186,83.84
3981,1,0,1,1,0,2,5,8690,54.42
3983,3,1,5,2,3,0,14,17699,95.82
3984,3,1,5,2,2,0,13,17456,94.66
3985,1,2,0,1,0,0,4,4966,36.77
3986,1,2,0,1,3,0,7,13868,78.23
3987,3,0,5,2,5,0,15,17888,96.85
3988,1,1,0,1,0,0,3,1352,17.01
3989,1,0,0,1,0,6,8,15186,83.84
3990,1,3,1,1,2,0,8,15186,83.84
3991,1,1,0,1,1,0,4,4966,36.77
3992,1,4,1,1,0,0,7,13868,78.23
3993,1,0,0,1,0,0,2,32,3.72
3994,1,3,0,1,0,0,5,8690,54.42
3995,1,0,0,1,2,0,4,4966,36.77
3996,1,1,0,1,0,0,3,1352,17.01
3997,1,1,1,1,0,0,4,4966,36.77
3998,1,0,2,1,0,0,4,4966,36.77
3999,1,2,0,1,0,0,4,4966,36.77
4000,1,0,2,1,1,0,5,8690,54.42
4001,1,0,0,0,2,0,3,1352,17.01
4002,1,2,0,1,1,0,5,8690,54.42
4003,1,0,1,1,0,0,3,1352,17.01
4004,1,0,1,1,3,0,6,11521,68.36
4005,1,0,1,1,1,0,4,4966,36.77
4006,1,4,1,1,2,0,9,15950,87.44
4007,1,0,1,1,0,0,3,1352,17.01
4008,1,0,2,1,1,0,5,8690,54.42
4009,1,0,1,1,4,0,7,13868,78.23
4010,1,1,2,1,0,0,5,8690,54.42
4011,1,4,0,1,0,0,6,11521,68.36
4012,1,1,1,1,1,0,5,8690,54.42
4013,1,0,1,1,0,0,3,1352,17.01
4014,1,4,0,1,1,0,7,13868,78.23
4015,1,4,2,1,2,0,10,16522,90.12
4016,1,4,0,1,0,0,6,11521,68.36
4017,1,0,2,1,0,0,4,4966,36.77
4018,1,1,1,1,0,0,4,4966,36.77
4019,1,0,2,1,1,0,5,8690,54.42
4020,1,4,2,1,3,0,11,16947,91.91
4021,1,1,3,1,1,0,7,13868,78.23
4022,1,2,2,1,0,0,6,11521,68.36
4023,1,2,0,1,0,0,4,4966,36.77
4024,1,3,0,1,0,0,5,8690,54.42
4025,1,3,0,1,0,0,5,8690,54.42
4026,1,0,5,2,3,0,11,16947,91.91
4027,1,5,1,1,0,0,8,15186,83.84
4028,3,0,5,2,3,0,13,17456,94.66
4029,1,2,1,1,0,0,5,8690,54.42
4030,1,1,1,1,0,0,4,4966,36.77
4031,3,0,5,2,3,0,13,17456,94.66
4032,1,4,1,1,0,0,7,13868,78.23
4033,1,4,0,2,0,0,7,13868,78.23
4034,1,0,1,1,0,0,3,1352,17.01
4035,1,5,0,1,3,0,10,16522,90.12
4036,1,2,1,1,0,0,5,8690,54.42
4037,1,5,0,1,0,0,7,13868,78.23
4038,1,0,1,1,0,0,3,1352,17.01
4039,1,0,1,1,0,0,3,1352,17.01
4040,1,1,1,1,0,0,4,4966,36.77
4041,1,1,2,1,0,0,5,8690,54.42
4042,1,1,0,1,2,0,5,8690,54.42
4043,1,0,1,1,0,0,3,1352,17.01
4044,1,1,1,1,0,0,4,4966,36.77
4045,1,2,1,1,0,0,5,8690,54.42
4046,1,4,1,1,1,0,8,15186,83.84
4047,1,3,2,1,0,0,7,13868,78.23
4048,1,1,1,1,0,0,4,4966,36.77
4049,1,0,0,1,0,0,2,32,3.72
4050,3,0,5,2,3,6,19,18362,99.04
4051,1,0,3,1,0,0,5,8690,54.42
4052,1,2,2,2,0,0,7,13868,78.23
4053,1,3,0,1,0,0,5,8690,54.42
4054,1,3,2,1,1,0,8,15186,83.84
4055,1,2,1,1,0,0,5,8690,54.42
4056,1,1,1,1,0,0,4,4966,36.77
4057,1,0,0,1,1,2,5,8690,54.42
4058,1,0,1,1,0,0,3,1352,17.01
4059,1,0,5,2,4,0,12,17186,93.28
4060,1,1,1,1,0,0,4,4966,36.77
4061,1,0,2,1,1,0,5,8690,54.42
4062,1,0,1,1,1,0,4,4966,36.77
4063,1,0,1,1,1,6,10,16522,90.12
4064,1,2,1,1,0,0,5,8690,54.42
4065,1,2,0,1,0,0,4,4966,36.77
4066,1,2,1,1,0,0,5,8690,54.42
4067,1,1,1,1,0,0,4,4966,36.77
4068,1,0,0,1,0,0,2,32,3.72
4069,1,0,0,1,0,0,2,32,3.72
4070,1,2,1,1,2,0,7,13868,78.23
4071,1,2,1,1,4,0,9,15950,87.44
4072,1,1,0,1,3,0,6,11521,68.36
4073,1,0,2,1,3,6,13,17456,94.66
4074,1,0,1,1,0,0,3,1352,17.01
4075,1,0,1,1,0,0,3,1352,17.01
4076,1,0,1,1,0,0,3,1352,17.01
4077,1,1,0,1,1,0,4,4966,36.77
4078,1,0,1,1,3,0,6,11521,68.36
4079,1,0,0,1,3,0,5,8690,54.42
4080,1,2,0,1,0,0,4,4966,36.77
4081,1,3,0,1,3,0,8,15186,83.84
4082,1,1,2,1,1,0,6,11521,68.36
4083,1,3,0,1,0,0,5,8690,54.42
4084,1,1,1,1,0,0,4,4966,36.77
4085,1,1,0,1,3,0,6,11521,68.36
4086,1,4,2,1,0,0,8,15186,83.84
4087,1,2,1,1,0,0,5,8690,54.42
4088,1,0,1,1,0,0,3,1352,17.01
4089,1,1,0,1,0,0,3,1352,17.01
4090,3,0,5,2,2,0,12,17186,93.28
4091,1,0,1,1,0,6,9,15950,87.44
4092,1,1,0,1,0,0,3,1352,17.01
4093,1,0,2,1,0,0,4,4966,36.77
4094,1,2,0,1,0,0,4,4966,36.77
4095,1,2,0,1,0,0,4,4966,36.77
4096,3,3,3,3,3,0,15,17888,96.85
4097,3,0,5,2,5,10,25,18550,99.91
4099,1,0,0,1,0,6,8,15186,83.84
4100,3,0,5,2,5,0,15,17888,96.85
4101,1,0,0,1,0,0,2,32,3.72
4102,1,4,0,1,0,0,6,11521,68.36
4103,3,0,5,2,2,4,16,18081,97.67
4104,1,0,1,1,0,0,3,1352,17.01
4105,1,0,2,1,3,4,11,16947,91.91
4106,1,3,0,1,0,0,5,8690,54.42
4107,1,0,0,1,0,0,2,32,3.72
4108,1,0,1,1,0,0,3,1352,17.01
4109,1,4,0,1,0,0,6,11521,68.36
4110,1,0,2,1,1,0,5,8690,54.42
4111,1,2,1,1,1,0,6,11521,68.36
4112,1,2,2,1,3,0,9,15950,87.44
4113,1,0,0,1,0,0,2,32,3.72
4114,1,0,2,1,0,0,4,4966,36.77
4115,1,3,0,1,0,0,5,8690,54.42
4116,1,2,1,1,0,0,5,8690,54.42
4117,1,0,2,1,3,0,7,13868,78.23
4118,1,4,1,1,0,0,7,13868,78.23
4119,1,2,3,1,0,0,7,13868,78.23
4120,1,2,1,1,0,6,11,16947,91.91
4121,1,2,1,1,1,0,6,11521,68.36
4122,1,4,0,1,3,0,9,15950,87.44
4123,1,0,2,1,2,0,6,11521,68.36
4124,1,2,3,1,0,0,7,13868,78.23
4125,1,1,1,1,1,6,11,16947,91.91
4126,1,1,0,1,0,0,3,1352,17.01
4127,3,3,5,2,1,0,14,17699,95.82
4128,3,0,4,1,5,4,17,18193,98.23
4129,1,0,3,1,1,0,6,11521,68.36
4130,1,3,2,2,0,0,8,15186,83.84
4131,1,2,0,1,3,0,7,13868,78.23
4132,1,1,0,1,0,0,3,1352,17.01
4133,1,0,1,1,0,4,7,13868,78.23
4134,1,3,0,1,0,0,5,8690,54.42
4135,3,0,5,2,5,0,15,17888,96.85
4136,1,1,2,1,2,0,7,13868,78.23
4137,1,1,1,1,1,0,5,8690,54.42
4138,3,0,5,2,3,4,17,18193,98.23
4139,1,0,5,4,0,0,10,16522,90.12
4140,1,4,1,1,0,0,7,13868,78.23
4141,1,0,1,1,0,0,3,1352,17.01
4142,1,0,1,1,0,6,9,15950,87.44
4143,1,1,0,1,0,0,3,1352,17.01
4144,1,1,0,1,0,0,3,1352,17.01
4145,1,0,1,1,0,6,9,15950,87.44
4146,1,1,2,1,1,0,6,11521,68.36
4147,1,0,3,1,1,6,12,17186,93.28
4148,1,1,0,1,3,0,6,11521,68.36
4149,1,0,2,1,0,0,4,4966,36.77
4150,1,4,2,1,0,0,8,15186,83.84
4151,1,1,1,1,0,0,4,4966,36.77
4153,1,0,0,1,0,0,2,32,3.72
4154,1,1,2,1,4,0,9,15950,87.44
4155,1,1,0,1,3,0,6,11521,68.36
4156,1,1,1,1,0,0,4,4966,36.77
4157,1,0,1,1,0,0,3,1352,17.01
4158,1,1,1,1,0,0,4,4966,36.77
4159,3,1,5,1,3,0,13,17456,94.66
4160,1,0,0,1,2,0,4,4966,36.77
4161,1,1,1,1,0,0,4,4966,36.77
4162,1,0,5,1,3,0,10,16522,90.12
4163,1,4,3,1,0,0,9,15950,87.44
4164,3,0,5,2,3,0,13,17456,94.66
4165,1,4,4,1,1,0,11,16947,91.91
4166,4,0,5,1,5,6,21,18462,99.52
4167,1,1,1,1,4,4,12,17186,93.28
4169,1,3,2,1,2,0,9,15950,87.44
4170,1,1,0,1,0,0,3,1352,17.01
4171,1,1,2,1,0,0,5,8690,54.42
4172,3,0,5,1,5,0,14,17699,95.82
4173,1,2,0,1,0,0,4,4966,36.77
4174,1,5,0,1,0,0,7,13868,78.23
4175,1,1,3,2,0,0,7,13868,78.23
4176,1,1,1,1,0,0,4,4966,36.77
4177,3,0,5,2,3,0,13,17456,94.66
4178,3,0,5,1,3,6,18,18287,98.68
4179,1,0,1,1,0,0,3,1352,17.01
4180,1,0,1,1,0,0,3,1352,17.01
4181,1,0,3,1,1,0,6,11521,68.36
4182,1,1,3,1,0,0,6,11521,68.36
4183,1,2,1,1,0,0,5,8690,54.42
4184,1,3,0,1,0,0,5,8690,54.42
4185,1,2,1,1,0,0,5,8690,54.42
4186,1,0,1,1,1,0,4,4966,36.77
4187,1,0,0,1,0,0,2,32,3.72
4188,1,1,2,1,0,0,5,8690,54.42
4189,1,1,1,1,1,0,5,8690,54.42
4190,1,1,1,1,0,0,4,4966,36.77
4191,1,0,5,1,1,0,8,15186,83.84
4192,1,1,1,1,1,0,5,8690,54.42
4193,1,0,1,1,0,4,7,13868,78.23
4194,1,0,1,1,0,0,3,1352,17.01
4195,1,0,0,1,0,0,2,32,3.72
4196,1,0,1,1,0,6,9,15950,87.44
4197,1,1,0,1,3,0,6,11521,68.36
4198,1,0,0,1,0,0,2,32,3.72
4199,1,1,2,1,0,0,5,8690,54.42
4200,1,1,2,1,0,0,5,8690,54.42
4201,1,0,1,1,0,0,3,1352,17.01
4202,1,1,1,1,0,0,4,4966,36.77
4203,1,1,1,1,0,6,10,16522,90.12
4204,1,4,0,1,4,0,10,16522,90.12
4205,1,3,1,1,0,0,6,11521,68.36
4206,1,0,1,1,0,0,3,1352,17.01
4207,1,1,1,1,0,6,10,16522,90.12
4208,1,3,1,1,3,0,9,15950,87.44
4209,1,3,0,1,0,0,5,8690,54.42
4210,1,0,2,1,0,0,4,4966,36.77
4211,1,1,0,1,0,0,3,1352,17.01
4212,1,0,1,1,3,0,6,11521,68.36
4213,1,0,1,1,0,0,3,1352,17.01
4214,1,0,0,1,2,0,4,4966,36.77
4215,1,1,0,1,0,0,3,1352,17.01
4216,1,0,1,1,3,0,6,11521,68.36
4217,1,0,2,1,2,0,6,11521,68.36
4218,1,0,5,1,0,0,7,13868,78.23
4219,3,0,5,2,5,0,15,17888,96.85
4220,1,0,0,1,1,0,3,1352,17.01
4221,1,2,1,1,3,0,8,15186,83.84
4222,1,3,1,1,0,0,6,11521,68.36
4223,1,0,2,1,0,0,4,4966,36.77
4224,1,0,1,1,1,10,14,17699,95.82
4226,1,1,2,1,4,0,9,15950,87.44
4227,1,0,1,1,0,6,9,15950,87.44
4228,1,0,0,1,0,0,2,32,3.72
4229,1,1,0,1,0,0,3,1352,17.01
4230,1,0,1,1,0,0,3,1352,17.01
4231,1,0,0,1,3,0,5,8690,54.42
4233,1,3,0,1,0,0,5,8690,54.42
4234,1,2,2,1,0,0,6,11521,68.36
4235,1,1,1,1,0,0,4,4966,36.77
4236,1,0,1,1,0,0,3,1352,17.01
4237,1,2,2,1,1,0,7,13868,78.23
4238,1,2,1,1,0,0,5,8690,54.42
4239,1,4,2,1,0,0,8,15186,83.84
4240,1,0,0,1,0,0,2,32,3.72
4241,1,0,2,1,1,0,5,8690,54.42
4243,1,0,1,1,1,0,4,4966,36.77
4244,1,1,2,1,0,0,5,8690,54.42
4245,3,0,5,3,2,0,13,17456,94.66
4246,1,1,0,1,0,0,3,1352,17.01
4247,1,0,3,1,3,0,8,15186,83.84
4248,1,1,0,1,0,0,3,1352,17.01
4249,1,1,1,1,0,0,4,4966,36.77
4250,1,4,1,1,0,0,7,13868,78.23
4251,1,1,0,1,0,0,3,1352,17.01
4252,1,2,0,1,0,0,4,4966,36.77
4253,1,0,1,1,3,2,8,15186,83.84
4254,1,2,0,1,0,0,4,4966,36.77
4255,1,0,2,1,0,0,4,4966,36.77
4256,1,1,2,1,2,0,7,13868,78.23
4257,1,1,1,1,0,0,4,4966,36.77
4258,1,2,1,1,0,0,5,8690,54.42
4259,1,0,2,1,0,0,4,4966,36.77
4260,1,4,0,1,1,0,7,13868,78.23
4261,1,0,2,1,0,0,4,4966,36.77
4262,1,3,0,1,0,0,5,8690,54.42
4263,1,1,1,1,0,0,4,4966,36.77
4265,1,0,2,1,0,0,4,4966,36.77
4266,3,3,3,1,2,0,12,17186,93.28
4267,1,2,1,1,3,0,8,15186,83.84
4268,1,0,1,1,2,0,5,8690,54.42
4269,3,0,5,3,5,0,16,18081,97.67
4270,1,1,1,1,0,0,4,4966,36.77
4271,3,4,3,3,2,0,15,17888,96.85
4272,1,3,1,1,0,0,6,11521,68.36
4273,1,2,1,1,0,0,5,8690,54.42
4274,1,4,1,1,1,0,8,15186,83.84
4275,1,2,0,1,2,0,6,11521,68.36
4276,1,2,3,1,0,0,7,13868,78.23
4277,1,5,1,1,0,0,8,15186,83.84
4278,1,2,0,1,0,0,4,4966,36.77
4279,1,3,1,1,0,0,6,11521,68.36
4280,1,0,2,1,0,0,4,4966,36.77
4281,1,2,3,1,4,0,11,16947,91.91
4282,1,4,0,1,1,0,7,13868,78.23
4283,1,4,2,2,0,0,9,15950,87.44
4284,1,0,3,2,1,0,7,13868,78.23
4285,1,0,1,1,0,0,3,1352,17.01
4286,1,2,0,1,2,0,6,11521,68.36
4287,3,0,5,1,3,10,22,18498,99.73
4288,1,1,3,2,0,0,7,13868,78.23
4289,1,4,0,1,0,0,6,11521,68.36
4290,1,0,1,1,0,0,3,1352,17.01
4291,1,0,1,1,0,0,3,1352,17.01
4292,1,0,1,1,0,0,3,1352,17.01
4293,1,4,0,1,0,0,6,11521,68.36
4294,1,4,0,1,0,0,6,11521,68.36
4295,1,0,3,2,1,2,9,15950,87.44
4296,1,0,2,1,1,0,5,8690,54.42
4297,1,0,2,1,0,0,4,4966,36.77
4298,1,1,0,1,0,0,3,1352,17.01
4299,3,0,5,2,3,0,13,17456,94.66
4300,1,1,1,1,0,0,4,4966,36.77
4301,1,2,0,1,3,0,7,13868,78.23
4302,1,0,1,1,0,0,3,1352,17.01
4303,1,1,0,1,0,0,3,1352,17.01
4304,1,1,0,1,0,0,3,1352,17.01
4305,1,2,1,1,0,0,5,8690,54.42
4306,1,1,1,1,3,0,7,13868,78.23
4307,1,0,0,1,1,0,3,1352,17.01
4308,1,0,3,2,0,0,6,11521,68.36
4309,1,0,1,1,0,0,3,1352,17.01
4311,1,3,1,1,0,0,6,11521,68.36
4312,1,0,3,1,0,0,5,8690,54.42
4313,1,1,2,1,0,0,5,8690,54.42
4316,1,3,0,1,1,0,6,11521,68.36
4317,1,4,0,1,0,0,6,11521,68.36
4318,1,0,0,1,0,0,2,32,3.72
4319,1,3,2,1,2,0,9,15950,87.44
4320,1,1,1,1,0,0,4,4966,36.77
4321,1,2,3,2,0,0,8,15186,83.84
4323,1,4,3,1,0,0,9,15950,87.44
4324,1,1,0,1,0,0,3,1352,17.01
4325,1,2,0,1,1,0,5,8690,54.42
4326,1,2,3,1,0,0,7,13868,78.23
4327,1,4,0,1,0,0,6,11521,68.36
4328,1,2,0,1,0,0,4,4966,36.77
4329,1,0,1,1,0,4,7,13868,78.23
4330,1,4,3,2,3,0,13,17456,94.66
4331,1,4,0,1,0,0,6,11521,68.36
4332,1,0,1,1,0,0,3,1352,17.01
4333,1,0,0,1,0,6,8,15186,83.84
4334,1,2,0,1,1,0,5,8690,54.42
4335,1,1,2,1,2,0,7,13868,78.23
4336,1,1,1,1,0,0,4,4966,36.77
4338,1,1,1,1,0,0,4,4966,36.77
4339,1,0,3,1,0,0,5,8690,54.42
4340,1,0,0,1,0,0,2,32,3.72
4341,1,4,0,1,0,0,6,11521,68.36
4342,1,0,0,1,0,0,2,32,3.72
4343,1,0,1,1,1,4,8,15186,83.84
4344,1,1,1,1,1,6,11,16947,91.91
4345,1,1,2,1,2,0,7,13868,78.23
4346,1,3,0,1,4,0,9,15950,87.44
4347,1,0,1,1,0,0,3,1352,17.01
4348,1,1,1,1,0,0,4,4966,36.77
4349,1,0,1,1,3,6,12,17186,93.28
4350,1,1,0,1,2,0,5,8690,54.42
4351,3,0,4,2,5,0,14,17699,95.82
4352,1,1,3,2,2,0,9,15950,87.44
4353,1,1,0,1,1,0,4,4966,36.77
4354,1,4,1,1,0,0,7,13868,78.23
4355,1,4,0,1,0,0,6,11521,68.36
4356,1,1,1,1,0,0,4,4966,36.77
4357,1,3,1,1,0,0,6,11521,68.36
4358,1,0,2,1,0,0,4,4966,36.77
4359,1,1,2,1,1,0,6,11521,68.36
4360,1,0,1,1,0,0,3,1352,17.01
4361,1,0,0,1,2,0,4,4966,36.77
4362,1,0,1,1,0,0,3,1352,17.01
4363,1,0,1,1,0,0,3,1352,17.01
4364,1,5,0,1,0,0,7,13868,78.23
4365,1,4,0,1,0,0,6,11521,68.36
4366,1,3,0,1,0,0,5,8690,54.42
4367,1,3,1,1,0,0,6,11521,68.36
4368,1,0,1,1,0,0,3,1352,17.01
4369,1,1,0,1,0,0,3,1352,17.01
4370,1,2,0,1,0,0,4,4966,36.77
4371,1,4,0,1,0,0,6,11521,68.36
4372,1,3,2,1,3,0,10,16522,90.12
4373,3,0,5,2,4,0,14,17699,95.82
4374,1,2,1,1,0,0,5,8690,54.42
4375,1,1,0,1,0,0,3,1352,17.01
4376,1,1,0,1,1,0,4,4966,36.77
4377,1,0,1,1,0,0,3,1352,17.01
4378,1,3,0,1,0,0,5,8690,54.42
4379,1,0,1,1,0,0,3,1352,17.01
4380,1,0,0,1,0,0,2,32,3.72
4381,1,3,0,1,0,0,5,8690,54.42
4382,1,2,0,1,0,0,4,4966,36.77
4383,1,1,1,1,2,0,6,11521,68.36
4384,1,1,1,1,0,0,4,4966,36.77
4385,1,0,3,1,0,0,5,8690,54.42
4386,1,1,2,1,0,0,5,8690,54.42
4387,1,0,1,1,0,0,3,1352,17.01
4388,1,0,1,1,1,0,4,4966,36.77
4389,1,5,2,2,0,0,10,16522,90.12
4390,1,0,2,1,3,0,7,13868,78.23
4391,1,4,0,1,0,0,6,11521,68.36
4392,1,1,0,1,0,0,3,1352,17.01
4393,1,2,1,1,0,0,5,8690,54.42
4394,1,2,0,1,3,0,7,13868,78.23
4395,1,5,0,1,0,0,7,13868,78.23
4396,1,0,1,1,0,0,3,1352,17.01
4397,1,0,2,1,0,0,4,4966,36.77
4398,1,1,1,1,0,0,4,4966,36.77
4399,1,1,1,1,0,0,4,4966,36.77
4400,1,1,1,1,2,0,6,11521,68.36
4401,1,2,0,1,0,0,4,4966,36.77
4402,1,0,1,1,0,0,3,1352,17.01
4403,1,4,0,0,0,0,5,8690,54.42
4404,3,3,5,3,2,0,16,18081,97.67
4405,1,1,3,1,4,0,10,16522,90.12
4406,1,0,1,1,0,6,9,15950,87.44
4407,1,0,4,2,0,0,7,13868,78.23
4408,1,1,1,1,2,0,6,11521,68.36
4409,1,1,0,1,0,0,3,1352,17.01
4410,1,0,0,1,1,6,9,15950,87.44
4411,1,5,0,1,0,0,7,13868,78.23
4412,3,0,5,2,2,0,12,17186,93.28
4413,1,1,0,1,0,0,3,1352,17.01
4414,1,2,1,1,0,0,5,8690,54.42
4415,1,2,1,1,2,0,7,13868,78.23
4416,1,1,0,1,0,0,3,1352,17.01
4417,1,0,0,1,0,4,6,11521,68.36
4418,1,0,0,1,0,0,2,32,3.72
4419,1,2,0,1,0,0,4,4966,36.77
4420,1,1,0,1,0,0,3,1352,17.01
4421,1,1,0,1,2,0,5,8690,54.42
4422,1,1,0,1,0,0,3,1352,17.01
4423,1,0,0,1,0,0,2,32,3.72
4424,1,0,1,1,0,0,3,1352,17.01
4425,1,0,1,1,1,0,4,4966,36.77
4426,1,1,0,1,0,0,3,1352,17.01
4427,1,4,0,1,0,0,6,11521,68.36
4428,1,1,1,1,0,0,4,4966,36.77
4429,1,2,0,1,0,0,4,4966,36.77
4430,1,4,0,1,0,0,6,11521,68.36
4431,1,0,2,1,0,0,4,4966,36.77
4432,1,0,0,1,0,0,2,32,3.72
4433,3,0,3,1,4,0,11,16947,91.91
4434,1,2,0,1,0,0,4,4966,36.77
4435,1,0,0,1,0,0,2,32,3.72
4436,1,1,1,1,0,0,4,4966,36.77
4437,1,3,3,1,0,0,8,15186,83.84
4438,1,0,0,1,0,0,2,32,3.72
4439,1,1,2,1,0,0,5,8690,54.42
4440,1,0,1,1,0,0,3,1352,17.01
4441,1,0,3,2,2,0,8,15186,83.84
4442,1,4,1,1,3,0,10,16522,90.12
4443,1,4,0,1,0,0,6,11521,68.36
4444,1,1,1,1,0,0,4,4966,36.77
4445,1,3,0,1,0,0,5,8690,54.42
4448,1,3,1,2,0,0,7,13868,78.23
4450,1,0,0,1,0,2,4,4966,36.77
4451,1,0,0,1,3,0,5,8690,54.42
4452,1,5,3,1,1,0,11,16947,91.91
4453,1,1,2,1,0,0,5,8690,54.42
4454,1,0,2,1,2,0,6,11521,68.36
4455,1,2,0,1,0,0,4,4966,36.77
4456,1,1,0,1,3,0,6,11521,68.36
4457,1,0,4,2,0,0,7,13868,78.23
4458,1,1,1,1,0,0,4,4966,36.77
4459,1,2,0,1,0,0,4,4966,36.77
4460,1,1,0,1,3,0,6,11521,68.36
4461,1,0,2,1,0,0,4,4966,36.77
4462,1,0,0,1,0,0,2,32,3.72
4463,1,0,0,1,0,0,2,32,3.72
4464,1,2,1,1,1,0,6,11521,68.36
4465,1,0,1,1,0,0,3,1352,17.01
4466,1,0,1,1,0,0,3,1352,17.01
4467,3,0,3,1,3,8,18,18287,98.68
4468,1,1,2,1,0,0,5,8690,54.42
4469,1,2,0,1,0,0,4,4966,36.77
4470,1,0,5,2,0,0,8,15186,83.84
4471,1,0,0,1,4,0,6,11521,68.36
4472,1,4,0,1,0,0,6,11521,68.36
4473,1,1,0,1,1,0,4,4966,36.77
4474,1,1,0,0,0,0,2,32,3.72
4475,3,0,5,2,5,0,15,17888,96.85
4476,1,4,0,1,0,0,6,11521,68.36
4477,1,0,1,1,0,0,3,1352,17.01
4478,1,0,3,1,1,0,6,11521,68.36
4479,1,0,3,2,0,0,6,11521,68.36
4480,3,2,5,3,3,0,16,18081,97.67
4481,1,0,1,1,1,0,4,4966,36.77
4482,1,4,4,2,1,0,12,17186,93.28
4483,1,1,1,1,0,0,4,4966,36.77
4484,3,0,5,3,5,0,16,18081,97.67
4485,3,0,4,2,3,0,12,17186,93.28
4486,1,1,0,1,0,0,3,1352,17.01
4487,1,1,0,1,0,0,3,1352,17.01
4488,1,0,0,1,0,0,2,32,3.72
4489,1,0,1,1,0,0,3,1352,17.01
4490,1,3,1,1,0,0,6,11521,68.36
4491,3,0,4,1,1,0,9,15950,87.44
4492,1,1,1,1,4,0,8,15186,83.84
4493,1,3,1,1,0,0,6,11521,68.36
4494,1,2,0,1,0,0,4,4966,36.77
4495,1,0,0,1,0,0,2,32,3.72
4496,1,1,1,1,3,0,7,13868,78.23
4497,1,1,0,1,0,0,3,1352,17.01
4498,1,0,3,1,0,0,5,8690,54.42
4499,1,3,0,1,0,0,5,8690,54.42
4500,1,3,0,1,0,0,5,8690,54.42
4501,1,1,1,1,3,0,7,13868,78.23
4502,1,0,0,1,1,0,3,1352,17.01
4503,1,0,1,1,1,0,4,4966,36.77
4504,1,0,1,1,0,0,3,1352,17.01
4506,1,1,1,1,1,0,5,8690,54.42
4507,1,3,2,1,0,0,7,13868,78.23
4508,1,0,1,1,3,0,6,11521,68.36
4509,1,1,0,1,0,0,3,1352,17.01
4510,1,0,0,1,0,0,2,32,3.72
4511,1,0,1,1,0,6,9,15950,87.44
4512,1,2,1,1,0,0,5,8690,54.42
4513,1,0,0,1,1,0,3,1352,17.01
4514,1,1,0,1,0,0,3,1352,17.01
4515,1,0,1,1,0,0,3,1352,17.01
4516,1,0,1,1,0,0,3,1352,17.01
4517,3,0,5,1,3,0,12,17186,93.28
4518,1,1,4,1,3,6,16,18081,97.67
4519,1,0,3,1,3,0,8,15186,83.84
4520,1,1,1,1,0,0,4,4966,36.77
4521,1,0,0,1,0,0,2,32,3.72
4522,1,5,3,1,3,0,13,17456,94.66
4523,1,4,0,1,0,0,6,11521,68.36
4524,1,1,1,1,0,0,4,4966,36.77
4525,1,1,1,1,0,0,4,4966,36.77
4526,1,0,1,1,0,0,3,1352,17.01
4527,1,4,0,1,0,0,6,11521,68.36
4528,1,1,1,1,0,2,6,11521,68.36
4529,1,0,0,1,0,0,2,32,3.72
4530,1,3,1,1,0,0,6,11521,68.36
4531,1,1,0,1,0,0,3,1352,17.01
4532,1,1,0,1,0,0,3,1352,17.01
4533,1,1,0,1,0,0,3,1352,17.01
4534,1,0,1,1,3,0,6,11521,68.36
4535,1,1,1,1,0,0,4,4966,36.77
4536,1,0,0,1,0,0,2,32,3.72
4537,1,1,1,1,0,0,4,4966,36.77
4538,1,2,3,1,0,0,7,13868,78.23
4539,1,0,0,1,0,0,2,32,3.72
4540,1,2,1,1,0,0,5,8690,54.42
4541,1,1,1,1,2,0,6,11521,68.36
4542,1,4,0,1,0,0,6,11521,68.36
4543,1,4,0,1,0,0,6,11521,68.36
4544,1,0,4,1,2,0,8,15186,83.84
4545,1,0,2,1,0,0,4,4966,36.77
4546,1,0,2,1,0,0,4,4966,36.77
4547,1,3,0,1,0,0,5,8690,54.42
4548,3,0,5,2,5,0,15,17888,96.85
4549,1,0,0,1,0,0,2,32,3.72
4550,1,0,1,1,0,0,3,1352,17.01
4551,1,0,1,1,0,0,3,1352,17.01
4552,1,0,2,1,0,0,4,4966,36.77
4553,1,0,1,1,0,2,5,8690,54.42
4554,1,3,0,1,0,0,5,8690,54.42
4555,1,2,0,1,0,0,4,4966,36.77
4556,1,0,2,1,0,0,4,4966,36.77
4557,1,1,2,1,0,0,5,8690,54.42
4558,1,0,1,1,1,0,4,4966,36.77
4559,1,3,1,1,0,0,6,11521,68.36
4560,1,1,3,1,0,0,6,11521,68.36
4561,3,0,5,2,5,0,15,17888,96.85
4562,1,1,0,1,0,0,3,1352,17.01
4563,1,1,0,1,0,0,3,1352,17.01
4564,1,4,0,1,1,0,7,13868,78.23
4565,1,1,0,1,0,0,3,1352,17.01
4566,1,0,0,1,0,0,2,32,3.72
4567,1,0,3,1,0,0,5,8690,54.42
4568,1,2,3,1,0,0,7,13868,78.23
4570,3,0,5,2,5,0,15,17888,96.85
4571,1,0,0,1,0,0,2,32,3.72
4572,1,2,0,1,0,0,4,4966,36.77
4573,1,0,0,1,0,6,8,15186,83.84
4574,1,0,2,1,0,0,4,4966,36.77
4575,1,5,1,1,0,0,8,15186,83.84
4576,1,3,0,1,0,0,5,8690,54.42
4577,1,0,0,1,0,0,2,32,3.72
4578,1,2,1,1,0,0,5,8690,54.42
4579,3,0,5,2,3,0,13,17456,94.66
4580,3,0,5,1,1,0,10,16522,90.12
4581,1,3,0,1,0,0,5,8690,54.42
4582,3,4,3,2,0,0,12,17186,93.28
4583,1,0,0,1,0,0,2,32,3.72
4584,1,3,3,1,0,0,8,15186,83.84
4587,1,4,0,1,0,0,6,11521,68.36
4588,1,0,0,1,2,0,4,4966,36.77
4589,1,0,0,1,2,6,10,16522,90.12
4590,1,0,2,1,2,0,6,11521,68.36
4591,1,1,1,1,0,10,14,17699,95.82
4592,1,0,2,1,2,0,6,11521,68.36
4593,1,2,0,1,2,0,6,11521,68.36
4594,1,3,0,1,0,0,5,8690,54.42
4595,1,4,1,1,0,0,7,13868,78.23
4596,1,0,0,1,0,0,2,32,3.72
4597,1,1,1,1,1,0,5,8690,54.42
4598,1,1,1,1,0,8,12,17186,93.28
4599,1,3,0,1,0,0,5,8690,54.42
4600,3,0,5,2,3,2,15,17888,96.85
4601,1,2,0,1,3,0,7,13868,78.23
4602,1,0,2,1,1,0,5,8690,54.42
4603,1,1,0,1,0,0,3,1352,17.01
4604,1,1,1,1,0,0,4,4966,36.77
4605,1,0,0,1,0,0,2,32,3.72
4606,1,2,0,1,0,0,4,4966,36.77
4607,1,2,1,1,0,0,5,8690,54.42
4608,1,0,1,1,0,0,3,1352,17.01
4609,1,1,2,1,1,0,6,11521,68.36
4610,1,0,1,1,1,0,4,4966,36.77
4611,1,0,1,1,0,6,9,15950,87.44
4612,1,0,0,1,1,0,3,1352,17.01
4613,1,0,0,1,2,0,4,4966,36.77
4614,1,1,1,1,0,0,4,4966,36.77
4615,1,0,1,1,0,0,3,1352,17.01
4617,1,1,1,1,0,0,4,4966,36.77
4618,1,2,0,1,0,0,4,4966,36.77
4619,1,0,1,1,0,0,3,1352,17.01
4620,1,0,1,1,3,0,6,11521,68.36
4621,1,0,0,1,0,6,8,15186,83.84
4622,1,3,0,1,1,0,6,11521,68.36
4623,1,2,1,1,0,0,5,8690,54.42
4624,1,0,3,1,0,0,5,8690,54.42
4625,1,1,1,1,2,4,10,16522,90.12
4626,1,0,3,1,4,6,15,17888,96.85
4627,1,4,0,1,1,0,7,13868,78.23
4628,3,0,5,1,2,6,17,18193,98.23
4629,1,0,0,1,0,0,2,32,3.72
4630,1,0,1,1,1,0,4,4966,36.77
4631,1,1,0,1,0,0,3,1352,17.01
4632,1,0,0,1,2,0,4,4966,36.77
4633,1,0,1,1,0,0,3,1352,17.01
4634,1,2,1,1,0,0,5,8690,54.42
4635,1,0,2,1,1,0,5,8690,54.42
4636,1,1,1,1,0,0,4,4966,36.77
4637,3,0,5,2,3,0,13,17456,94.66
4638,1,2,0,1,0,0,4,4966,36.77
4639,1,0,0,1,0,0,2,32,3.72
4640,1,3,2,1,0,0,7,13868,78.23
4641,1,2,1,1,0,0,5,8690,54.42
4642,1,0,1,1,0,0,3,1352,17.01
4643,1,0,1,1,0,0,3,1352,17.01
4644,1,1,0,1,0,0,3,1352,17.01
4645,1,1,1,1,0,0,4,4966,36.77
4646,1,3,1,1,0,0,6,11521,68.36
4647,1,2,1,1,0,0,5,8690,54.42
4648,1,1,2,1,3,0,8,15186,83.84
4649,1,3,1,1,2,0,8,15186,83.84
4650,1,1,0,1,0,2,5,8690,54.42
4651,1,0,3,1,1,0,6,11521,68.36
4652,1,3,1,1,1,0,7,13868,78.23
4653,1,1,1,1,0,0,4,4966,36.77
4654,1,1,0,0,0,0,2,32,3.72
4655,1,2,0,1,2,0,6,11521,68.36
4656,1,0,2,1,0,0,4,4966,36.77
4657,1,0,0,1,0,0,2,32,3.72
4658,3,0,5,2,5,4,19,18362,99.04
4659,1,0,2,1,2,0,6,11521,68.36
4660,1,1,1,1,0,6,10,16522,90.12
4662,1,1,0,1,0,0,3,1352,17.01
4663,1,1,0,1,0,6,9,15950,87.44
4664,1,2,1,1,0,0,5,8690,54.42
4665,1,1,1,1,2,0,6,11521,68.36
4666,1,0,1,1,0,0,3,1352,17.01
4667,1,0,0,1,0,0,2,32,3.72
4668,1,1,0,1,0,0,3,1352,17.01
4669,1,1,3,1,0,0,6,11521,68.36
4670,1,0,0,1,1,0,3,1352,17.01
4671,1,0,0,1,0,6,8,15186,83.84
4672,1,1,1,1,1,0,5,8690,54.42
4673,1,0,0,1,0,0,2,32,3.72
4674,1,3,2,1,0,0,7,13868,78.23
4675,1,0,3,2,1,0,7,13868,78.23
4676,1,2,1,1,1,0,6,11521,68.36
4677,1,2,1,1,2,0,7,13868,78.23
4678,1,0,2,1,2,0,6,11521,68.36
4679,1,0,5,2,0,0,8,15186,83.84
4680,1,0,1,1,0,6,9,15950,87.44
4681,1,2,1,1,0,0,5,8690,54.42
4682,3,0,5,1,4,8,21,18462,99.52
4683,1,2,0,1,0,0,4,4966,36.77
4684,1,1,0,1,0,0,3,1352,17.01
4685,1,0,1,1,0,0,3,1352,17.01
4686,1,1,1,1,0,0,4,4966,36.77
4687,1,0,2,2,3,0,8,15186,83.84
4688,1,1,1,1,0,0,4,4966,36.77
4689,3,0,5,2,5,6,21,18462,99.52
4690,1,4,0,1,1,0,7,13868,78.23
4691,1,2,3,2,0,0,8,15186,83.84
4692,1,1,1,1,0,0,4,4966,36.77
4693,1,0,2,1,1,6,11,16947,91.91
4694,1,0,1,1,1,0,4,4966,36.77
4695,1,0,0,1,1,0,3,1352,17.01
4696,3,0,5,1,5,4,18,18287,98.68
4697,1,4,1,1,0,0,7,13868,78.23
4698,1,1,1,1,0,0,4,4966,36.77
4699,1,1,0,1,1,0,4,4966,36.77
4700,1,0,1,1,0,0,3,1352,17.01
4701,1,2,0,1,0,0,4,4966,36.77
4702,1,0,1,1,0,6,9,15950,87.44
4703,1,1,3,1,1,6,13,17456,94.66
4704,1,0,3,1,1,0,6,11521,68.36
4705,1,2,0,1,0,0,4,4966,36.77
4706,1,0,1,1,0,0,3,1352,17.01
4707,1,5,2,2,0,0,10,16522,90.12
4708,1,1,3,1,0,0,6,11521,68.36
4709,1,0,2,1,3,6,13,17456,94.66
4710,1,0,1,1,0,0,3,1352,17.01
4711,1,0,2,2,0,0,5,8690,54.42
4712,1,0,1,1,1,2,6,11521,68.36
4713,1,0,0,1,0,2,4,4966,36.77
4714,1,0,3,2,3,0,9,15950,87.44
4715,3,0,5,1,3,0,12,17186,93.28
4716,1,2,2,1,0,0,6,11521,68.36
4717,1,4,1,1,0,0,7,13868,78.23
4719,1,4,0,1,0,0,6,11521,68.36
4720,1,2,2,1,0,0,6,11521,68.36
4721,1,0,2,1,0,0,4,4966,36.77
4722,1,1,2,1,0,0,5,8690,54.42
4723,1,1,0,1,0,0,3,1352,17.01
4724,1,1,0,1,0,0,3,1352,17.01
4725,1,2,1,1,0,0,5,8690,54.42
4726,1,0,3,2,3,0,9,15950,87.44
4727,1,0,2,1,1,0,5,8690,54.42
4728,1,1,1,1,2,0,6,11521,68.36
4729,1,0,2,1,0,0,4,4966,36.77
4730,1,1,0,1,0,0,3,1352,17.01
4731,1,0,1,1,0,0,3,1352,17.01
4732,1,0,0,1,0,0,2,32,3.72
4733,1,0,1,1,0,0,3,1352,17.01
4734,1,1,1,1,0,0,4,4966,36.77
4735,1,3,2,1,1,0,8,15186,83.84
4736,1,0,3,1,0,6,11,16947,91.91
4737,1,2,0,1,0,0,4,4966,36.77
4738,1,3,1,1,0,0,6,11521,68.36
4739,3,0,5,1,3,6,18,18287,98.68
4740,1,1,2,1,2,0,7,13868,78.23
4741,3,2,3,2,5,0,15,17888,96.85
4742,1,0,4,2,0,0,7,13868,78.23
4743,1,1,0,1,0,0,3,1352,17.01
4744,1,4,0,1,0,0,6,11521,68.36
4745,1,1,1,1,0,0,4,4966,36.77
4746,1,2,3,1,0,0,7,13868,78.23
4747,1,2,2,1,1,0,7,13868,78.23
4749,1,1,1,1,0,0,4,4966,36.77
4750,1,0,4,1,0,0,6,11521,68.36
4751,1,2,1,1,0,0,5,8690,54.42
4752,1,0,1,1,0,6,9,15950,87.44
4753,1,1,0,1,0,0,3,1352,17.01
4754,1,5,1,2,0,0,9,15950,87.44
4755,1,0,2,1,2,0,6,11521,68.36
4756,1,0,0,1,0,0,2,32,3.72
4757,1,1,0,1,1,0,4,4966,36.77
4758,1,3,1,1,2,0,8,15186,83.84
4759,3,0,3,1,4,0,11,16947,91.91
4760,1,0,0,1,0,0,2,32,3.72
4761,1,1,0,1,0,0,3,1352,17.01
4762,1,1,1,1,3,0,7,13868,78.23
4763,1,2,0,1,0,0,4,4966,36.77
4764,1,0,4,2,1,0,8,15186,83.84
4765,1,0,3,1,0,0,5,8690,54.42
4766,1,2,0,1,1,0,5,8690,54.42
4767,1,3,1,1,0,0,6,11521,68.36
4768,1,0,2,1,1,0,5,8690,54.42
4769,1,0,3,1,0,0,5,8690,54.42
4770,1,0,5,1,0,8,15,17888,96.85
4771,1,0,2,1,2,0,6,11521,68.36
4772,1,1,1,1,1,0,5,8690,54.42
4773,1,0,0,1,0,0,2,32,3.72
4774,1,2,0,1,3,0,7,13868,78.23
4775,1,0,0,1,3,0,5,8690,54.42
4776,1,1,1,1,0,0,4,4966,36.77
4777,1,2,0,1,0,0,4,4966,36.77
4778,1,2,1,1,0,0,5,8690,54.42
4779,1,0,1,1,0,0,3,1352,17.01
4780,1,1,0,1,0,0,3,1352,17.01
4781,1,4,1,2,0,0,8,15186,83.84
4782,1,0,1,1,3,2,8,15186,83.84
4783,1,0,3,2,0,0,6,11521,68.36
4784,1,2,0,1,0,0,4,4966,36.77
4785,1,1,1,1,0,6,10,16522,90.12
4786,1,0,0,1,0,6,8,15186,83.84
4787,1,1,1,1,1,0,5,8690,54.42
4788,3,0,3,1,2,6,15,17888,96.85
4789,3,0,5,2,5,2,17,18193,98.23
4790,1,4,0,1,0,0,6,11521,68.36
4791,1,3,0,1,0,0,5,8690,54.42
4792,1,0,0,1,4,0,6,11521,68.36
4793,1,0,2,1,0,0,4,4966,36.77
4794,1,3,1,1,0,0,6,11521,68.36
4795,1,0,2,1,1,0,5,8690,54.42
4796,3,2,5,1,3,0,14,17699,95.82
4797,1,1,0,1,0,0,3,1352,17.01
4798,1,2,0,1,0,0,4,4966,36.77
4799,1,0,1,1,0,0,3,1352,17.01
4800,1,2,2,1,0,0,6,11521,68.36
4801,1,0,1,1,2,0,5,8690,54.42
4802,1,2,2,1,3,6,15,17888,96.85
4803,1,0,1,1,2,0,5,8690,54.42
4804,1,0,1,1,1,0,4,4966,36.77
4805,1,1,1,1,0,0,4,4966,36.77
4806,1,2,1,1,1,0,6,11521,68.36
4807,1,0,1,1,0,0,3,1352,17.01
4808,1,2,0,1,0,0,4,4966,36.77
4809,1,0,2,1,0,0,4,4966,36.77
4810,1,4,0,1,0,0,6,11521,68.36
4811,1,3,0,1,0,0,5,8690,54.42
4812,1,1,1,1,3,0,7,13868,78.23
4814,1,0,2,1,0,0,4,4966,36.77
4815,1,0,0,1,2,0,4,4966,36.77
4816,1,1,2,1,4,6,15,17888,96.85
4817,1,1,0,1,3,0,6,11521,68.36
4818,3,0,4,1,3,4,15,17888,96.85
4819,1,1,0,1,0,0,3,1352,17.01
4820,1,0,2,1,0,0,4,4966,36.77
4821,1,0,3,1,3,0,8,15186,83.84
4822,1,4,0,1,0,0,6,11521,68.36
4823,1,0,0,1,3,0,5,8690,54.42
4824,1,0,3,1,0,0,5,8690,54.42
4825,1,4,0,1,0,0,6,11521,68.36
4826,1,0,1,1,0,0,3,1352,17.01
4827,1,0,3,1,0,0,5,8690,54.42
4828,1,2,0,1,0,0,4,4966,36.77
4829,1,2,0,1,0,0,4,4966,36.77
4830,1,1,0,1,0,0,3,1352,17.01
4831,1,0,5,1,0,0,7,13868,78.23
4832,1,1,0,1,0,0,3,1352,17.01
4833,1,1,1,1,0,0,4,4966,36.77
4834,1,0,3,1,0,10,15,17888,96.85
4835,1,0,2,1,0,0,4,4966,36.77
4836,3,1,5,2,3,0,14,17699,95.82
4837,1,3,0,1,0,0,5,8690,54.42
4838,1,1,0,1,3,0,6,11521,68.36
4839,1,0,1,1,1,4,8,15186,83.84
4840,1,0,2,1,3,10,17,18193,98.23
4841,1,1,1,1,0,0,4,4966,36.77
4842,1,0,0,1,0,0,2,32,3.72
4843,3,0,5,2,5,0,15,17888,96.85
4844,1,2,1,1,2,0,7,13868,78.23
4845,3,0,3,2,4,2,14,17699,95.82
4846,1,4,2,2,0,0,9,15950,87.44
4847,1,1,0,1,0,0,3,1352,17.01
4848,1,4,2,1,0,0,8,15186,83.84
4849,1,0,2,1,4,0,8,15186,83.84
4850,1,2,0,1,0,0,4,4966,36.77
4851,1,0,4,2,0,0,7,13868,78.23
4852,1,0,3,2,3,0,9,15950,87.44
4853,1,1,0,1,0,0,3,1352,17.01
4854,1,3,0,1,0,0,5,8690,54.42
4855,1,1,1,1,2,0,6,11521,68.36
4856,1,2,0,1,0,0,4,4966,36.77
4857,1,3,1,1,0,0,6,11521,68.36
4858,1,1,2,1,0,0,5,8690,54.42
4859,1,0,0,1,0,0,2,32,3.72
4860,1,0,2,1,0,0,4,4966,36.77
4861,1,4,0,1,0,0,6,11521,68.36
4862,1,2,2,1,0,0,6,11521,68.36
4863,1,4,1,1,0,0,7,13868,78.23
4864,1,0,0,1,0,0,2,32,3.72
4865,1,0,3,1,1,0,6,11521,68.36
4866,3,1,5,1,3,6,19,18362,99.04
4867,1,2,3,2,2,0,10,16522,90.12
4868,1,4,1,1,0,0,7,13868,78.23
4869,1,2,0,1,0,0,4,4966,36.77
4870,1,4,2,1,0,0,8,15186,83.84
4871,1,2,1,1,0,0,5,8690,54.42
4872,1,0,1,1,0,0,3,1352,17.01
4873,1,1,2,1,3,4,12,17186,93.28
4874,1,0,1,1,0,0,3,1352,17.01
4876,1,1,1,1,0,0,4,4966,36.77
4877,1,0,0,1,0,0,2,32,3.72
4878,1,0,3,1,0,0,5,8690,54.42
4879,1,2,0,1,0,0,4,4966,36.77
4880,1,0,4,2,4,0,11,16947,91.91
4881,1,1,0,1,0,6,9,15950,87.44
4882,1,2,0,1,0,0,4,4966,36.77
4883,1,0,2,1,0,0,4,4966,36.77
4884,1,0,0,1,3,0,5,8690,54.42
4885,3,0,5,2,3,0,13,17456,94.66
4886,1,2,0,1,0,0,4,4966,36.77
4887,3,0,3,1,5,0,12,17186,93.28
4888,1,1,0,1,0,0,3,1352,17.01
4889,1,1,2,1,0,0,5,8690,54.42
4890,1,4,0,1,0,0,6,11521,68.36
4891,1,2,1,1,0,0,5,8690,54.42
4892,3,0,5,1,5,6,20,18419,99.31
4893,1,1,2,1,1,0,6,11521,68.36
4894,1,1,1,1,0,0,4,4966,36.77
4895,1,1,2,1,2,0,7,13868,78.23
4896,1,0,1,1,0,0,3,1352,17.01
4897,1,0,0,1,0,2,4,4966,36.77
4898,1,4,0,1,0,0,6,11521,68.36
4899,1,0,1,1,0,6,9,15950,87.44
4900,1,0,4,1,0,0,6,11521,68.36
4901,1,1,0,1,2,0,5,8690,54.42
4902,1,2,0,1,0,0,4,4966,36.77
4903,3,0,5,2,3,0,13,17456,94.66
4904,1,2,1,1,2,0,7,13868,78.23
4905,1,3,0,1,0,0,5,8690,54.42
4906,1,4,0,1,0,0,6,11521,68.36
4907,1,0,2,1,0,0,4,4966,36.77
4908,1,0,1,1,3,6,12,17186,93.28
4909,1,1,1,1,0,0,4,4966,36.77
4910,1,0,4,2,0,0,7,13868,78.23
4911,1,0,3,1,2,0,7,13868,78.23
4912,1,1,0,1,0,0,3,1352,17.01
4913,1,3,1,1,0,0,6,11521,68.36
4914,1,1,1,1,0,0,4,4966,36.77
4915,1,0,0,1,0,0,2,32,3.72
4916,1,0,1,1,0,0,3,1352,17.01
4917,1,1,2,1,0,0,5,8690,54.42
4918,1,2,0,1,0,0,4,4966,36.77
4919,1,4,2,2,0,0,9,15950,87.44
4920,1,0,0,1,0,0,2,32,3.72
4921,1,1,2,1,0,0,5,8690,54.42
4922,1,0,1,1,0,0,3,1352,17.01
4923,1,0,3,2,1,0,7,13868,78.23
4924,3,0,5,2,5,0,15,17888,96.85
4925,1,0,1,1,0,0,3,1352,17.01
4926,3,2,5,1,5,0,16,18081,97.67
4927,1,0,1,1,0,0,3,1352,17.01
4928,1,0,1,1,0,0,3,1352,17.01
4929,1,1,0,1,3,0,6,11521,68.36
4930,1,2,0,1,0,0,4,4966,36.77
4931,3,0,5,2,5,6,21,18462,99.52
4932,1,2,2,1,0,0,6,11521,68.36
4933,1,0,1,1,0,0,3,1352,17.01
4934,1,1,1,1,1,0,5,8690,54.42
4935,1,0,5,2,0,0,8,15186,83.84
4936,1,1,0,1,1,0,4,4966,36.77
4937,1,0,1,1,2,0,5,8690,54.42
4938,1,2,1,1,1,0,6,11521,68.36
4939,1,1,1,1,0,0,4,4966,36.77
4940,1,4,0,1,0,0,6,11521,68.36
4941,1,5,1,1,0,0,8,15186,83.84
4942,1,1,2,1,3,0,8,15186,83.84
4943,1,0,1,1,0,0,3,1352,17.01
4944,1,0,4,1,0,0,6,11521,68.36
4945,1,0,2,1,3,0,7,13868,78.23
4946,1,2,1,1,0,6,11,16947,91.91
4947,1,1,4,1,1,6,14,17699,95.82
4948,1,1,0,0,0,0,2,32,3.72
4949,1,0,0,1,1,0,3,1352,17.01
4950,1,3,2,1,0,0,7,13868,78.23
4951,1,0,0,1,0,0,2,32,3.72
4952,1,0,2,1,0,0,4,4966,36.77
4953,1,0,1,1,0,0,3,1352,17.01
4954,1,3,0,1,0,0,5,8690,54.42
4955,1,0,1,1,0,0,3,1352,17.01
4956,1,0,0,1,2,2,6,11521,68.36
4957,3,0,5,2,4,0,14,17699,95.82
4958,1,1,1,2,0,0,5,8690,54.42
4959,1,2,1,1,0,0,5,8690,54.42
4960,1,1,0,1,0,0,3,1352,17.01
4961,1,0,2,1,1,0,5,8690,54.42
4962,1,0,1,1,0,0,3,1352,17.01
4963,1,2,0,1,1,0,5,8690,54.42
4964,1,1,0,1,3,0,6,11521,68.36
4965,1,0,1,1,0,0,3,1352,17.01
4966,1,1,1,1,0,0,4,4966,36.77
4967,1,3,0,1,0,0,5,8690,54.42
4968,1,0,1,1,1,0,4,4966,36.77
4969,1,3,0,1,0,0,5,8690,54.42
4970,1,0,1,1,1,0,4,4966,36.77
4971,1,1,2,1,0,6,11,16947,91.91
4972,1,1,0,1,0,0,3,1352,17.01
4973,1,1,1,1,0,0,4,4966,36.77
4974,1,1,2,1,0,0,5,8690,54.42
4975,1,1,1,1,0,0,4,4966,36.77
4976,1,4,0,1,0,0,6,11521,68.36
4977,1,0,0,1,0,0,2,32,3.72
4978,1,1,1,1,0,0,4,4966,36.77
4979,1,1,2,1,0,0,5,8690,54.42
4980,1,1,3,1,0,0,6,11521,68.36
4981,1,1,1,1,0,0,4,4966,36.77
4982,1,0,1,1,0,0,3,1352,17.01
4983,1,1,1,1,2,0,6,11521,68.36
4984,1,0,0,1,3,0,5,8690,54.42
4985,1,0,1,1,0,0,3,1352,17.01
4986,1,0,1,1,0,0,3,1352,17.01
4987,1,0,3,1,1,6,12,17186,93.28
4988,1,5,0,1,0,0,7,13868,78.23
4989,1,3,0,1,1,0,6,11521,68.36
4990,1,1,0,1,0,0,3,1352,17.01
4992,1,1,0,1,0,0,3,1352,17.01
4993,1,0,1,1,0,0,3,1352,17.01
4994,1,5,2,1,0,0,9,15950,87.44
4995,1,0,1,1,0,0,3,1352,17.01
4996,1,1,0,1,3,0,6,11521,68.36
4997,1,0,1,1,2,0,5,8690,54.42
4998,1,4,0,0,0,0,5,8690,54.42
4999,1,0,4,1,0,0,6,11521,68.36
5000,1,0,1,1,0,6,9,15950,87.44
5001,1,0,2,1,0,0,4,4966,36.77
5002,1,0,0,1,0,0,2,32,3.72
5003,1,2,0,1,0,0,4,4966,36.77
5004,1,1,1,1,0,0,4,4966,36.77
5005,1,4,0,1,0,0,6,11521,68.36
5006,1,3,0,1,0,0,5,8690,54.42
5007,1,1,1,1,0,0,4,4966,36.77
5008,1,2,0,1,0,0,4,4966,36.77
5009,1,0,3,2,1,0,7,13868,78.23
5010,1,5,0,1,0,0,7,13868,78.23
5011,1,0,3,1,2,2,9,15950,87.44
5012,1,0,2,1,0,0,4,4966,36.77
5013,1,0,0,1,1,6,9,15950,87.44
5014,1,3,0,0,0,0,4,4966,36.77
5015,1,0,1,1,1,0,4,4966,36.77
5016,1,0,1,1,0,0,3,1352,17.01
5017,1,0,3,1,2,0,7,13868,78.23
5018,1,0,2,1,0,0,4,4966,36.77
5019,1,0,2,1,0,0,4,4966,36.77
5020,1,3,1,1,0,0,6,11521,68.36
5021,1,3,1,1,0,0,6,11521,68.36
5023,1,1,1,1,0,0,4,4966,36.77
5024,1,4,0,1,0,0,6,11521,68.36
5025,1,0,0,1,0,0,2,32,3.72
5026,1,1,0,1,0,0,3,1352,17.01
5027,1,0,2,1,0,0,4,4966,36.77
5028,1,1,1,1,0,0,4,4966,36.77
5029,1,0,2,1,0,0,4,4966,36.77
5030,1,4,0,1,0,0,6,11521,68.36
5031,1,4,0,1,0,0,6,11521,68.36
5032,1,2,0,1,0,0,4,4966,36.77
5033,1,4,0,1,2,0,8,15186,83.84
5034,1,0,0,1,2,0,4,4966,36.77
5035,1,0,1,1,0,6,9,15950,87.44
5036,1,0,0,1,3,0,5,8690,54.42
5037,1,3,0,1,0,0,5,8690,54.42
5038,1,1,4,2,0,0,8,15186,83.84
5039,3,0,5,2,4,0,14,17699,95.82
5040,1,0,1,1,0,0,3,1352,17.01
5041,3,1,5,1,3,0,13,17456,94.66
5042,1,4,0,1,3,0,9,15950,87.44
5043,1,0,3,1,0,0,5,8690,54.42
5044,1,1,1,1,0,0,4,4966,36.77
5045,1,1,3,1,0,0,6,11521,68.36
5046,1,1,1,1,0,0,4,4966,36.77
5047,1,0,1,1,0,0,3,1352,17.01
5048,1,0,2,1,1,0,5,8690,54.42
5049,1,2,0,1,0,0,4,4966,36.77
5050,1,3,3,1,0,0,8,15186,83.84
5051,1,1,0,1,1,0,4,4966,36.77
5052,1,1,1,1,0,0,4,4966,36.77
5053,1,0,4,2,4,0,11,16947,91.91
5054,1,1,0,1,0,4,7,13868,78.23
5055,1,0,2,2,3,6,14,17699,95.82
5056,3,0,4,1,3,10,21,18462,99.52
5057,1,1,0,1,0,0,3,1352,17.01
5058,1,0,1,1,2,0,5,8690,54.42
5059,1,2,0,1,2,0,6,11521,68.36
5060,1,4,0,1,2,0,8,15186,83.84
5061,1,1,2,1,0,0,5,8690,54.42
5062,1,0,1,1,0,0,3,1352,17.01
5063,1,1,1,1,0,0,4,4966,36.77
5064,1,0,1,1,1,0,4,4966,36.77
5065,1,1,1,1,0,0,4,4966,36.77
5066,1,1,0,1,0,0,3,1352,17.01
5067,1,2,0,1,0,0,4,4966,36.77
5068,3,0,5,2,5,10,25,18550,99.91
5069,1,0,1,1,0,0,3,1352,17.01
5070,1,0,0,1,0,0,2,32,3.72
5071,1,1,0,1,0,0,3,1352,17.01
5072,1,3,0,0,0,0,4,4966,36.77
5073,1,4,1,1,2,0,9,15950,87.44
5074,1,0,1,1,3,0,6,11521,68.36
5075,1,4,1,1,1,0,8,15186,83.84
5076,1,1,1,1,0,0,4,4966,36.77
5077,1,0,4,1,2,6,14,17699,95.82
5078,3,0,5,2,2,0,12,17186,93.28
5079,1,1,2,1,0,0,5,8690,54.42
5080,1,2,0,1,0,0,4,4966,36.77
5081,1,0,0,1,0,0,2,32,3.72
5082,1,0,0,1,0,0,2,32,3.72
5083,1,0,0,1,0,0,2,32,3.72
5084,1,1,0,1,0,0,3,1352,17.01
5085,1,0,4,1,1,0,7,13868,78.23
5086,1,0,1,1,0,0,3,1352,17.01
5087,3,0,5,2,5,0,15,17888,96.85
5088,1,4,0,1,2,0,8,15186,83.84
5089,1,5,3,1,0,0,10,16522,90.12
5090,1,1,1,1,0,0,4,4966,36.77
5091,1,1,0,1,0,0,3,1352,17.01
5092,3,0,5,2,3,0,13,17456,94.66
5093,1,0,3,2,1,0,7,13868,78.23
5094,1,0,0,1,1,0,3,1352,17.01
5095,1,1,0,1,1,0,4,4966,36.77
5096,1,0,2,1,2,0,6,11521,68.36
5097,1,0,5,2,0,6,14,17699,95.82
5098,1,1,0,1,0,0,3,1352,17.01
5099,1,0,0,1,2,0,4,4966,36.77
5100,1,1,1,1,0,0,4,4966,36.77
5101,3,0,5,1,3,0,12,17186,93.28
5102,1,0,0,1,0,0,2,32,3.72
5103,1,4,0,1,0,0,6,11521,68.36
5104,1,0,1,1,0,0,3,1352,17.01
5105,1,2,1,1,0,0,5,8690,54.42
5106,1,2,1,1,0,0,5,8690,54.42
5107,1,2,1,1,0,0,5,8690,54.42
5108,1,0,1,1,0,6,9,15950,87.44
5109,1,0,0,1,0,0,2,32,3.72
5110,1,2,0,1,2,0,6,11521,68.36
5111,1,0,1,1,3,2,8,15186,83.84
5112,1,0,0,1,0,0,2,32,3.72
5113,1,1,0,1,0,0,3,1352,17.01
5114,1,2,2,1,0,0,6,11521,68.36
5115,1,1,0,1,0,0,3,1352,17.01
5116,1,0,5,1,3,0,10,16522,90.12
5117,1,4,0,1,0,0,6,11521,68.36
5118,1,2,1,1,0,0,5,8690,54.42
5119,1,1,1,1,2,0,6,11521,68.36
5120,1,4,0,1,0,0,6,11521,68.36
5121,1,2,0,1,0,0,4,4966,36.77
5122,1,0,1,1,0,0,3,1352,17.01
5123,1,0,4,1,0,0,6,11521,68.36
5124,1,0,0,1,0,0,2,32,3.72
5125,1,1,1,1,0,0,4,4966,36.77
5126,1,0,3,1,3,0,8,15186,83.84
5127,3,0,5,1,5,0,14,17699,95.82
5128,1,0,3,1,1,0,6,11521,68.36
5129,1,0,3,1,1,0,6,11521,68.36
5130,1,3,1,1,1,0,7,13868,78.23
5131,1,0,0,1,1,0,3,1352,17.01
5132,1,0,2,1,3,0,7,13868,78.23
5133,1,0,3,1,0,4,9,15950,87.44
5134,1,1,0,1,1,0,4,4966,36.77
5135,1,0,3,1,1,6,12,17186,93.28
5136,1,0,1,1,0,6,9,15950,87.44
5137,1,0,0,1,0,0,2,32,3.72
5138,3,0,5,3,5,0,16,18081,97.67
5139,1,2,0,1,0,0,4,4966,36.77
5140,1,0,0,1,0,0,2,32,3.72
5141,1,4,3,1,0,0,9,15950,87.44
5142,1,0,1,1,0,0,3,1352,17.01
5143,1,1,0,1,0,0,3,1352,17.01
5144,3,0,5,2,5,0,15,17888,96.85
5145,1,1,1,1,3,0,7,13868,78.23
5146,1,0,3,1,1,8,14,17699,95.82
5147,1,0,2,1,0,6,10,16522,90.12
5148,1,0,1,1,0,0,3,1352,17.01
5149,1,0,3,1,0,0,5,8690,54.42
5151,1,1,2,1,0,0,5,8690,54.42
5152,1,0,5,2,0,0,8,15186,83.84
5153,1,0,1,1,0,0,3,1352,17.01
5154,3,0,5,1,1,0,10,16522,90.12
5155,1,1,1,1,0,2,6,11521,68.36
5156,1,1,1,1,0,0,4,4966,36.77
5157,1,4,0,1,0,0,6,11521,68.36
5158,3,0,5,1,3,4,16,18081,97.67
5159,1,0,3,1,1,0,6,11521,68.36
5160,1,1,1,1,0,0,4,4966,36.77
5161,1,1,1,1,0,0,4,4966,36.77
5162,1,1,1,1,0,0,4,4966,36.77
5163,1,2,3,1,0,0,7,13868,78.23
5164,3,0,5,2,3,6,19,18362,99.04
5165,1,0,1,1,0,0,3,1352,17.01
5166,1,1,1,1,0,0,4,4966,36.77
5167,1,0,2,1,0,0,4,4966,36.77
5168,1,3,0,1,0,0,5,8690,54.42
5169,1,2,0,1,0,0,4,4966,36.77
5170,1,0,0,1,0,0,2,32,3.72
5171,1,0,3,1,1,0,6,11521,68.36
5172,3,0,5,2,5,0,15,17888,96.85
5173,1,0,2,1,0,0,4,4966,36.77
5174,1,0,4,1,0,8,14,17699,95.82
5175,1,0,1,1,2,4,9,15950,87.44
5176,1,1,1,1,0,0,4,4966,36.77
5177,1,0,0,1,1,0,3,1352,17.01
5178,1,1,0,1,0,0,3,1352,17.01
5179,1,1,1,1,2,0,6,11521,68.36
5180,1,1,0,1,0,0,3,1352,17.01
5181,1,0,2,1,3,0,7,13868,78.23
5182,1,3,0,1,2,0,7,13868,78.23
5183,1,1,1,1,0,0,4,4966,36.77
5184,1,0,1,1,0,0,3,1352,17.01
5185,3,0,5,1,3,6,18,18287,98.68
5186,1,3,0,1,1,0,6,11521,68.36
5187,1,2,1,1,1,0,6,11521,68.36
5188,3,0,5,1,2,0,11,16947,91.91
5189,1,5,2,2,0,0,10,16522,90.12
5190,1,4,0,1,0,0,6,11521,68.36
5191,1,0,0,1,0,0,2,32,3.72
5192,1,3,0,1,0,0,5,8690,54.42
5193,1,0,1,1,0,0,3,1352,17.01
5194,1,3,0,0,0,0,4,4966,36.77
5195,1,2,1,1,0,0,5,8690,54.42
5196,1,1,1,1,0,0,4,4966,36.77
5197,1,0,1,1,0,0,3,1352,17.01
5198,1,0,2,1,1,0,5,8690,54.42
5199,1,0,1,1,0,4,7,13868,78.23
5200,1,3,0,1,0,0,5,8690,54.42
5202,1,4,4,2,0,0,11,16947,91.91
5203,1,2,0,1,0,0,4,4966,36.77
5204,3,0,5,2,3,0,13,17456,94.66
5205,1,0,2,1,0,0,4,4966,36.77
5206,1,0,1,1,0,0,3,1352,17.01
5207,1,0,2,1,2,0,6,11521,68.36
5208,1,3,2,1,0,0,7,13868,78.23
5209,3,1,5,2,1,0,12,17186,93.28
5210,1,1,2,1,1,0,6,11521,68.36
5211,1,2,2,1,0,6,12,17186,93.28
5212,3,0,5,1,5,4,18,18287,98.68
5213,1,4,0,1,0,0,6,11521,68.36
5214,1,0,1,1,0,0,3,1352,17.01
5215,1,0,2,1,0,0,4,4966,36.77
5216,1,2,0,1,0,0,4,4966,36.77
5217,1,1,1,1,3,0,7,13868,78.23
5218,1,0,2,2,3,0,8,15186,83.84
5219,1,0,1,1,0,0,3,1352,17.01
5220,1,4,0,1,0,0,6,11521,68.36
5221,1,1,1,1,0,0,4,4966,36.77
5222,1,4,0,1,0,0,6,11521,68.36
5223,1,0,0,1,0,0,2,32,3.72
5224,1,1,1,1,0,0,4,4966,36.77
5225,1,4,1,1,2,0,9,15950,87.44
5226,1,4,2,2,0,0,9,15950,87.44
5227,1,0,2,1,0,0,4,4966,36.77
5228,1,4,1,1,0,0,7,13868,78.23
5229,1,0,0,1,0,0,2,32,3.72
5230,1,0,1,1,0,4,7,13868,78.23
5231,1,1,1,1,0,0,4,4966,36.77
5232,1,3,2,1,0,0,7,13868,78.23
5233,1,2,1,1,0,0,5,8690,54.42
5234,1,0,0,1,0,0,2,32,3.72
5235,1,0,2,1,0,0,4,4966,36.77
5236,1,0,3,1,0,0,5,8690,54.42
5237,1,2,1,1,0,0,5,8690,54.42
5238,1,4,0,1,0,0,6,11521,68.36
5239,1,5,1,1,0,0,8,15186,83.84
5240,1,0,2,1,2,0,6,11521,68.36
5241,1,1,1,1,2,0,6,11521,68.36
5242,1,1,0,1,0,0,3,1352,17.01
5243,1,0,1,1,0,0,3,1352,17.01
5244,1,4,0,1,0,0,6,11521,68.36
5245,1,1,0,1,1,0,4,4966,36.77
5246,1,2,1,1,0,0,5,8690,54.42
5247,1,1,1,1,0,0,4,4966,36.77
5248,1,0,1,1,0,0,3,1352,17.01
5249,1,1,5,2,0,0,9,15950,87.44
5250,1,0,1,1,0,0,3,1352,17.01
5251,1,1,1,1,0,0,4,4966,36.77
5252,1,0,0,1,3,0,5,8690,54.42
5253,1,1,0,1,0,0,3,1352,17.01
5254,1,0,3,2,0,0,6,11521,68.36
5255,1,0,3,1,3,0,8,15186,83.84
5256,1,3,0,1,1,0,6,11521,68.36
5257,1,1,1,1,0,0,4,4966,36.77
5258,1,3,1,1,0,0,6,11521,68.36
5259,1,1,0,1,0,0,3,1352,17.01
5260,1,0,5,2,0,0,8,15186,83.84
5261,3,0,5,1,5,0,14,17699,95.82
5262,1,0,5,1,0,0,7,13868,78.23
5263,1,2,1,1,0,0,5,8690,54.42
5264,1,3,0,1,0,0,5,8690,54.42
5265,1,0,1,1,0,0,3,1352,17.01
5266,1,0,1,1,0,0,3,1352,17.01
5267,3,1,5,2,3,0,14,17699,95.82
5268,1,0,4,1,3,6,15,17888,96.85
5269,1,0,1,1,0,0,3,1352,17.01
5270,1,2,4,1,0,0,8,15186,83.84
5271,1,1,1,1,3,0,7,13868,78.23
5272,1,2,0,1,0,0,4,4966,36.77
5273,1,1,1,1,0,0,4,4966,36.77
5275,1,2,1,1,0,0,5,8690,54.42
5276,1,0,2,1,0,0,4,4966,36.77
5277,1,0,2,1,0,6,10,16522,90.12
5278,1,3,1,1,0,0,6,11521,68.36
5279,1,2,0,1,0,0,4,4966,36.77
5280,1,0,1,1,0,0,3,1352,17.01
5281,3,0,4,2,3,0,12,17186,93.28
5282,1,1,1,1,3,0,7,13868,78.23
5284,1,1,3,2,0,0,7,13868,78.23
5285,1,0,1,1,0,0,3,1352,17.01
5286,1,0,2,1,1,0,5,8690,54.42
5287,1,0,1,1,0,0,3,1352,17.01
5288,1,4,0,1,0,0,6,11521,68.36
5289,1,1,0,1,0,0,3,1352,17.01
5290,1,3,3,2,0,0,9,15950,87.44
5291,1,3,1,1,2,0,8,15186,83.84
5292,1,4,0,1,0,0,6,11521,68.36
5293,1,1,0,0,0,0,2,32,3.72
5294,1,0,0,1,2,0,4,4966,36.77
5295,1,2,1,1,0,0,5,8690,54.42
5296,3,0,5,2,5,0,15,17888,96.85
5297,3,0,5,1,3,6,18,18287,98.68
5298,1,0,1,1,0,0,3,1352,17.01
5299,1,2,1,1,0,0,5,8690,54.42
5300,1,2,0,1,0,0,4,4966,36.77
5301,1,1,2,1,1,0,6,11521,68.36
5302,3,0,5,2,4,0,14,17699,95.82
5303,1,0,2,1,0,0,4,4966,36.77
5304,1,0,0,1,0,0,2,32,3.72
5305,1,2,1,1,0,0,5,8690,54.42
5306,1,1,0,1,0,0,3,1352,17.01
5307,1,2,0,1,0,0,4,4966,36.77
5308,1,4,1,1,0,0,7,13868,78.23
5309,1,1,2,1,0,0,5,8690,54.42
5310,1,4,0,1,0,0,6,11521,68.36
5311,1,4,0,1,0,0,6,11521,68.36
5312,1,3,2,2,1,0,9,15950,87.44
5313,3,0,4,1,4,6,18,18287,98.68
5314,1,3,0,1,3,0,8,15186,83.84
5315,1,1,1,1,0,0,4,4966,36.77
5316,1,0,2,1,0,0,4,4966,36.77
5317,1,4,4,1,0,0,10,16522,90.12
5318,1,1,1,1,0,0,4,4966,36.77
5319,1,0,0,1,0,0,2,32,3.72
5320,1,0,1,1,0,0,3,1352,17.01
5321,1,0,1,1,2,0,5,8690,54.42
5322,1,1,2,1,3,0,8,15186,83.84
5323,1,4,0,1,0,0,6,11521,68.36
5324,1,1,1,1,0,0,4,4966,36.77
5325,1,1,2,1,2,0,7,13868,78.23
5326,1,0,1,1,0,0,3,1352,17.01
5327,1,0,1,1,3,0,6,11521,68.36
5328,3,4,2,1,0,0,10,16522,90.12
5329,1,2,0,1,0,0,4,4966,36.77
5330,1,3,0,1,2,0,7,13868,78.23
5331,1,4,2,2,0,0,9,15950,87.44
5332,1,4,0,1,0,0,6,11521,68.36
5333,1,1,3,1,1,0,7,13868,78.23
5334,1,1,1,1,0,0,4,4966,36.77
5335,1,2,0,1,3,0,7,13868,78.23
5336,1,3,1,1,1,0,7,13868,78.23
5337,1,0,1,1,0,0,3,1352,17.01
5338,1,0,4,2,1,0,8,15186,83.84
5339,1,1,1,1,0,2,6,11521,68.36
5340,1,0,1,1,2,0,5,8690,54.42
5341,1,0,0,1,0,0,2,32,3.72
5342,1,0,1,1,0,0,3,1352,17.01
5343,1,0,1,1,0,0,3,1352,17.01
5344,1,2,0,1,0,0,4,4966,36.77
5345,1,1,0,1,0,0,3,1352,17.01
5346,1,0,1,1,0,0,3,1352,17.01
5347,1,1,0,1,0,0,3,1352,17.01
5348,1,0,3,1,0,0,5,8690,54.42
5349,1,1,3,1,0,0,6,11521,68.36
5350,1,0,3,1,0,0,5,8690,54.42
5351,1,1,2,1,0,0,5,8690,54.42
5352,1,2,0,1,0,0,4,4966,36.77
5353,1,0,1,1,0,0,3,1352,17.01
5354,1,5,3,2,0,0,11,16947,91.91
5355,1,1,1,1,0,0,4,4966,36.77
5356,1,0,4,2,1,0,8,15186,83.84
5357,1,1,1,1,0,0,4,4966,36.77
5358,1,0,0,1,0,0,2,32,3.72
5359,1,1,1,1,0,2,6,11521,68.36
5360,1,0,4,2,3,0,10,16522,90.12
5361,1,4,0,1,0,0,6,11521,68.36
5362,1,0,1,1,0,0,3,1352,17.01
5363,1,3,0,1,0,0,5,8690,54.42
5364,1,4,0,1,0,0,6,11521,68.36
5365,1,0,1,1,0,0,3,1352,17.01
5366,1,1,0,1,0,0,3,1352,17.01
5367,1,0,0,1,3,0,5,8690,54.42
5368,1,1,1,1,2,0,6,11521,68.36
5369,1,1,0,1,0,0,3,1352,17.01
5370,1,0,0,1,0,0,2,32,3.72
5371,1,0,0,1,0,2,4,4966,36.77
5372,1,4,0,1,0,0,6,11521,68.36
5373,1,0,2,1,0,0,4,4966,36.77
5374,1,1,0,1,0,0,3,1352,17.01
5375,1,0,0,1,3,0,5,8690,54.42
5376,1,2,3,1,1,0,8,15186,83.84
5378,1,1,1,1,0,0,4,4966,36.77
5379,1,0,0,1,3,0,5,8690,54.42
5380,1,1,0,1,0,0,3,1352,17.01
5381,1,1,1,1,0,0,4,4966,36.77
5382,1,3,0,1,0,0,5,8690,54.42
5383,1,2,0,1,0,0,4,4966,36.77
5384,1,1,0,1,2,0,5,8690,54.42
5385,1,0,2,1,2,4,10,16522,90.12
5386,1,0,2,1,0,6,10,16522,90.12
5387,1,3,0,1,1,0,6,11521,68.36
5388,1,3,0,1,0,0,5,8690,54.42
5389,1,2,1,1,0,0,5,8690,54.42
5391,1,4,0,1,0,0,6,11521,68.36
5392,1,3,0,1,0,0,5,8690,54.42
5394,1,0,3,1,0,0,5,8690,54.42
5395,1,0,4,2,0,0,7,13868,78.23
5396,1,0,1,1,0,0,3,1352,17.01
5397,1,2,1,1,0,0,5,8690,54.42
5398,1,0,0,1,0,8,10,16522,90.12
5399,1,1,0,1,0,0,3,1352,17.01
5400,1,4,1,1,0,0,7,13868,78.23
5401,1,0,1,1,3,0,6,11521,68.36
5402,1,0,3,1,0,10,15,17888,96.85
5403,1,0,2,2,0,2,7,13868,78.23
5404,1,3,1,1,0,0,6,11521,68.36
5405,1,1,0,1,0,0,3,1352,17.01
5406,1,2,0,1,1,0,5,8690,54.42
5407,1,2,1,1,0,0,5,8690,54.42
5408,1,4,0,1,0,0,6,11521,68.36
5409,1,0,1,1,3,2,8,15186,83.84
5410,1,0,0,1,0,2,4,4966,36.77
5411,1,4,0,1,0,0,6,11521,68.36
5412,1,2,0,1,3,0,7,13868,78.23
5413,1,0,1,1,0,0,3,1352,17.01
5414,3,0,5,4,4,0,16,18081,97.67
5415,1,1,0,1,0,4,7,13868,78.23
5416,1,4,0,1,0,0,6,11521,68.36
5417,1,1,0,1,0,0,3,1352,17.01
5419,1,4,0,1,0,0,6,11521,68.36
5420,1,5,0,1,0,0,7,13868,78.23
5421,1,0,3,1,1,0,6,11521,68.36
5422,1,4,0,1,0,0,6,11521,68.36
5423,3,0,4,2,5,0,14,17699,95.82
5424,1,4,0,1,0,0,6,11521,68.36
5425,1,0,1,1,0,0,3,1352,17.01
5426,3,0,5,2,3,0,13,17456,94.66
5427,1,0,4,2,0,0,7,13868,78.23
5428,1,2,0,1,0,0,4,4966,36.77
5429,1,4,2,1,0,0,8,15186,83.84
5430,1,3,0,1,0,0,5,8690,54.42
5432,1,0,2,1,0,0,4,4966,36.77
5433,1,0,1,1,0,6,9,15950,87.44
5434,1,2,1,1,2,0,7,13868,78.23
5435,1,2,2,1,0,0,6,11521,68.36
5436,3,1,3,2,5,0,14,17699,95.82
5437,1,3,2,1,0,0,7,13868,78.23
5438,1,2,0,1,2,0,6,11521,68.36
5439,1,4,0,1,0,0,6,11521,68.36
5440,1,0,0,1,0,0,2,32,3.72
5441,1,0,2,1,2,0,6,11521,68.36
5442,3,3,3,2,0,0,11,16947,91.91
5443,1,1,0,1,0,0,3,1352,17.01
5444,1,0,5,2,0,0,8,15186,83.84
5445,1,2,1,1,0,0,5,8690,54.42
5446,1,0,2,1,0,0,4,4966,36.77
5447,3,5,1,4,5,0,18,18287,98.68
5448,1,3,0,1,3,0,8,15186,83.84
5449,3,0,4,1,5,8,21,18462,99.52
5450,1,0,0,1,0,0,2,32,3.72
5451,1,0,2,1,0,0,4,4966,36.77
5452,1,1,1,1,0,0,4,4966,36.77
5453,1,0,0,1,0,0,2,32,3.72
5454,1,0,0,1,0,0,2,32,3.72
5455,1,0,2,1,2,0,6,11521,68.36
5456,1,0,1,1,1,0,4,4966,36.77
5457,1,2,1,1,0,0,5,8690,54.42
5458,3,0,5,1,5,0,14,17699,95.82
5459,1,1,1,1,4,0,8,15186,83.84
5460,1,1,1,1,1,0,5,8690,54.42
5461,1,4,0,1,0,0,6,11521,68.36
5462,4,0,5,2,4,4,19,18362,99.04
5463,1,0,0,1,3,0,5,8690,54.42
5464,1,2,0,1,0,0,4,4966,36.77
5465,1,4,0,1,0,0,6,11521,68.36
5466,1,2,1,1,2,0,7,13868,78.23
5467,3,0,4,2,1,0,10,16522,90.12
5468,1,0,1,1,0,0,3,1352,17.01
5469,1,0,2,1,1,0,5,8690,54.42
5470,1,0,3,1,0,0,5,8690,54.42
5471,1,4,1,1,1,0,8,15186,83.84
5472,1,1,2,1,0,0,5,8690,54.42
5473,1,0,4,2,2,0,9,15950,87.44
5474,3,1,4,2,2,0,12,17186,93.28
5475,1,4,0,1,0,0,6,11521,68.36
5476,1,4,0,1,0,0,6,11521,68.36
5477,1,1,0,1,0,0,3,1352,17.01
5478,1,2,0,1,0,0,4,4966,36.77
5479,1,1,1,1,0,0,4,4966,36.77
5480,1,1,2,1,0,0,5,8690,54.42
5481,1,3,0,1,0,0,5,8690,54.42
5482,1,2,1,1,0,0,5,8690,54.42
5483,1,4,0,1,0,0,6,11521,68.36
5484,1,1,3,1,0,0,6,11521,68.36
5486,1,0,4,2,0,0,7,13868,78.23
5487,1,0,1,1,1,0,4,4966,36.77
5488,1,0,3,1,0,8,13,17456,94.66
5489,1,0,1,1,0,0,3,1352,17.01
5490,1,0,1,1,2,0,5,8690,54.42
5491,1,0,1,1,0,0,3,1352,17.01
5492,1,1,1,1,2,0,6,11521,68.36
5493,1,1,1,1,0,0,4,4966,36.77
5494,4,0,5,2,5,0,16,18081,97.67
5495,1,0,0,1,0,0,2,32,3.72
5497,1,1,3,2,0,6,13,17456,94.66
5498,1,0,0,1,0,0,2,32,3.72
5499,1,1,0,1,0,0,3,1352,17.01
5500,1,2,2,1,0,0,6,11521,68.36
5501,1,2,2,1,4,0,10,16522,90.12
5502,1,0,2,1,0,6,10,16522,90.12
5503,1,2,3,1,1,0,8,15186,83.84
5504,1,0,3,2,4,0,10,16522,90.12
5505,1,4,0,1,0,0,6,11521,68.36
5506,1,0,1,1,0,0,3,1352,17.01
5507,3,0,5,2,4,6,20,18419,99.31
5508,3,0,5,2,3,0,13,17456,94.66
5509,1,3,3,2,2,0,11,16947,91.91
5510,1,0,2,1,0,0,4,4966,36.77
5511,1,0,1,1,0,0,3,1352,17.01
5512,3,0,5,2,5,0,15,17888,96.85
5513,1,2,0,1,0,0,4,4966,36.77
5514,1,0,1,1,2,0,5,8690,54.42
5515,1,0,0,1,0,0,2,32,3.72
5516,1,0,1,1,0,0,3,1352,17.01
5518,1,2,0,1,0,6,10,16522,90.12
5519,1,0,1,1,0,0,3,1352,17.01
5520,1,4,0,1,0,0,6,11521,68.36
5521,1,0,1,1,0,0,3,1352,17.01
5522,1,1,0,1,0,0,3,1352,17.01
5523,1,0,1,1,0,0,3,1352,17.01
5524,1,2,0,1,0,0,4,4966,36.77
5525,1,1,1,1,0,0,4,4966,36.77
5526,1,0,2,1,3,0,7,13868,78.23
5527,3,0,5,1,5,0,14,17699,95.82
5528,3,0,5,2,3,0,13,17456,94.66
5529,1,0,1,1,3,0,6,11521,68.36
5530,1,3,0,1,1,0,6,11521,68.36
5531,1,1,1,1,1,0,5,8690,54.42
5532,1,3,1,1,1,0,7,13868,78.23
5533,1,0,2,1,0,0,4,4966,36.77
5534,1,4,1,1,0,0,7,13868,78.23
5535,3,0,3,1,4,0,11,16947,91.91
5536,1,2,3,2,2,0,10,16522,90.12
5537,1,2,2,1,0,0,6,11521,68.36
5538,3,1,5,2,4,6,21,18462,99.52
5539,1,0,2,1,0,0,4,4966,36.77
5540,1,1,0,1,0,0,3,1352,17.01
5541,1,0,4,1,2,0,8,15186,83.84
5542,1,0,1,1,0,0,3,1352,17.01
5543,1,1,1,1,0,0,4,4966,36.77
5544,1,3,0,1,0,0,5,8690,54.42
5546,1,2,0,1,0,0,4,4966,36.77
5547,1,3,0,1,1,0,6,11521,68.36
5548,1,1,0,1,2,0,5,8690,54.42
5549,1,1,2,1,0,0,5,8690,54.42
5550,1,1,0,1,0,0,3,1352,17.01
5551,1,2,0,1,0,0,4,4966,36.77
5552,1,0,2,1,0,0,4,4966,36.77
5553,1,0,0,1,0,0,2,32,3.72
5554,1,0,4,2,0,0,7,13868,78.23
5555,1,0,0,1,3,0,5,8690,54.42
5556,1,2,0,1,0,0,4,4966,36.77
5557,1,0,2,1,1,0,5,8690,54.42
5558,1,4,0,1,0,0,6,11521,68.36
5559,1,2,1,1,0,0,5,8690,54.42
5560,1,0,2,1,0,0,4,4966,36.77
5561,1,0,3,1,0,0,5,8690,54.42
5562,1,2,1,1,0,0,5,8690,54.42
5564,1,1,2,1,0,0,5,8690,54.42
5565,1,1,0,1,1,0,4,4966,36.77
5566,3,0,5,2,4,0,14,17699,95.82
5567,1,0,0,1,0,0,2,32,3.72
5568,1,1,2,1,0,0,5,8690,54.42
5569,3,0,5,2,5,0,15,17888,96.85
5570,1,1,1,1,0,4,8,15186,83.84
5571,1,4,0,1,0,0,6,11521,68.36
5572,1,1,1,1,0,0,4,4966,36.77
5573,1,0,0,1,0,0,2,32,3.72
5574,1,3,0,1,0,0,5,8690,54.42
5575,1,0,2,1,2,0,6,11521,68.36
5576,1,0,4,2,4,0,11,16947,91.91
5577,1,0,2,1,1,0,5,8690,54.42
5578,3,0,3,2,5,0,13,17456,94.66
5579,1,1,1,1,0,0,4,4966,36.77
5580,1,2,1,1,3,0,8,15186,83.84
5581,1,0,1,1,2,0,5,8690,54.42
5582,1,0,2,1,0,0,4,4966,36.77
5583,1,0,5,2,1,0,9,15950,87.44
5584,1,2,1,1,2,0,7,13868,78.23
5585,1,0,0,0,0,0,1,1,0.08
5586,1,0,0,1,0,0,2,32,3.72
5587,1,1,1,1,0,0,4,4966,36.77
5588,1,0,2,1,1,0,5,8690,54.42
5589,1,4,0,1,2,0,8,15186,83.84
5590,3,0,5,1,5,6,20,18419,99.31
5591,1,4,0,1,0,0,6,11521,68.36
5592,1,0,2,1,0,0,4,4966,36.77
5593,3,0,5,2,4,0,14,17699,95.82
5594,1,0,1,1,3,0,6,11521,68.36
5595,1,1,0,1,0,0,3,1352,17.01
5596,1,0,2,1,3,0,7,13868,78.23
5597,1,0,1,1,2,0,5,8690,54.42
5598,1,0,1,1,0,0,3,1352,17.01
5599,1,2,1,1,1,0,6,11521,68.36
5600,1,1,0,1,0,0,3,1352,17.01
5601,1,0,3,1,2,6,13,17456,94.66
5602,1,1,0,1,0,0,3,1352,17.01
5603,3,0,2,2,5,0,12,17186,93.28
5604,1,1,1,1,0,0,4,4966,36.77
5605,3,0,5,1,3,6,18,18287,98.68
5606,1,0,0,1,2,0,4,4966,36.77
5607,1,1,1,1,0,0,4,4966,36.77
5608,1,0,4,2,0,0,7,13868,78.23
5609,1,0,4,3,2,0,10,16522,90.12
5610,1,0,1,1,0,0,3,1352,17.01
5611,1,2,0,1,0,0,4,4966,36.77
5612,1,0,0,1,0,0,2,32,3.72
5613,1,3,4,1,0,0,9,15950,87.44
5614,1,2,1,1,0,0,5,8690,54.42
5615,1,0,1,1,2,0,5,8690,54.42
5617,1,1,0,1,0,0,3,1352,17.01
5618,1,2,0,1,0,0,4,4966,36.77
5619,1,4,0,1,0,0,6,11521,68.36
5620,1,0,4,1,1,2,9,15950,87.44
5621,1,0,1,1,2,0,5,8690,54.42
5622,1,1,0,1,0,0,3,1352,17.01
5623,1,0,0,1,1,0,3,1352,17.01
5624,1,2,1,1,0,0,5,8690,54.42
5625,1,1,0,1,0,0,3,1352,17.01
5626,1,1,3,1,1,0,7,13868,78.23
5627,1,0,0,1,0,0,2,32,3.72
5628,1,1,1,1,0,0,4,4966,36.77
5629,1,2,1,1,0,0,5,8690,54.42
5630,1,2,0,1,1,0,5,8690,54.42
5631,1,1,0,1,4,2,9,15950,87.44
5632,1,2,0,1,0,0,4,4966,36.77
5633,1,0,1,1,0,0,3,1352,17.01
5634,1,1,0,1,0,0,3,1352,17.01
5635,1,4,0,1,0,0,6,11521,68.36
5636,1,0,2,1,0,0,4,4966,36.77
5637,3,0,2,1,4,6,16,18081,97.67
5638,3,4,4,2,5,0,18,18287,98.68
5640,1,3,0,1,0,0,5,8690,54.42
5641,1,0,0,1,0,6,8,15186,83.84
5642,1,3,3,2,3,0,12,17186,93.28
5643,1,1,0,1,0,0,3,1352,17.01
5644,1,0,1,1,0,0,3,1352,17.01
5645,1,3,2,2,0,0,8,15186,83.84
5646,1,1,0,1,0,0,3,1352,17.01
5647,1,1,0,1,0,0,3,1352,17.01
5648,1,3,0,1,0,0,5,8690,54.42
5649,1,1,1,1,0,0,4,4966,36.77
5650,1,1,1,1,0,0,4,4966,36.77
5651,1,0,1,1,3,0,6,11521,68.36
5652,1,0,1,1,1,0,4,4966,36.77
5653,1,4,0,1,0,0,6,11521,68.36
5654,1,0,4,1,0,0,6,11521,68.36
5655,1,0,1,1,0,0,3,1352,17.01
5656,4,0,4,2,3,0,13,17456,94.66
5657,1,3,0,1,3,0,8,15186,83.84
5658,1,1,1,1,1,0,5,8690,54.42
5659,1,0,4,1,0,0,6,11521,68.36
5660,1,0,0,1,0,0,2,32,3.72
5661,1,0,3,1,2,0,7,13868,78.23
5662,1,4,0,1,0,0,6,11521,68.36
5663,1,4,0,1,0,0,6,11521,68.36
5664,1,1,0,1,0,0,3,1352,17.01
5665,3,1,5,1,2,0,12,17186,93.28
5666,1,1,1,1,0,0,4,4966,36.77
5667,1,4,0,1,0,0,6,11521,68.36
5668,1,4,0,1,0,0,6,11521,68.36
5669,3,0,5,2,5,0,15,17888,96.85
5670,1,2,1,1,0,0,5,8690,54.42
5671,1,1,0,1,2,0,5,8690,54.42
5672,1,4,0,1,0,0,6,11521,68.36
5673,1,0,2,1,0,4,8,15186,83.84
5674,1,0,1,1,0,0,3,1352,17.01
5675,1,3,1,1,2,0,8,15186,83.84
5676,1,0,0,1,0,0,2,32,3.72
5677,1,2,1,1,0,0,5,8690,54.42
5678,1,0,2,1,0,6,10,16522,90.12
5679,3,2,5,2,3,0,15,17888,96.85
5680,3,0,5,2,5,0,15,17888,96.85
5681,3,0,5,2,5,0,15,17888,96.85
5682,1,1,0,1,0,6,9,15950,87.44
5683,1,0,2,1,0,0,4,4966,36.77
5684,3,0,5,2,3,0,13,17456,94.66
5685,1,2,1,1,1,0,6,11521,68.36
5686,1,1,0,1,0,0,3,1352,17.01
5687,1,4,0,1,2,0,8,15186,83.84
5688,1,3,0,1,1,0,6,11521,68.36
5689,1,0,0,1,0,0,2,32,3.72
5690,1,1,5,1,0,0,8,15186,83.84
5691,1,3,1,1,0,0,6,11521,68.36
5692,1,0,1,1,0,4,7,13868,78.23
5693,1,0,1,1,0,0,3,1352,17.01
5694,1,1,1,1,1,0,5,8690,54.42
5695,1,1,0,1,0,0,3,1352,17.01
5696,1,1,3,2,0,0,7,13868,78.23
5697,1,0,3,2,0,0,6,11521,68.36
5698,1,0,0,1,2,0,4,4966,36.77
5699,1,2,3,1,1,0,8,15186,83.84
5700,1,1,2,1,2,0,7,13868,78.23
5701,1,1,2,1,0,0,5,8690,54.42
5702,1,5,0,1,0,0,7,13868,78.23
5703,1,1,0,1,0,0,3,1352,17.01
5704,1,0,1,1,0,0,3,1352,17.01
5705,1,0,0,1,0,6,8,15186,83.84
5706,1,1,4,2,3,0,11,16947,91.91
5707,1,1,1,1,0,0,4,4966,36.77
5708,1,0,2,1,2,0,6,11521,68.36
5709,1,0,2,1,0,0,4,4966,36.77
5710,1,0,1,1,0,0,3,1352,17.01
5711,1,0,1,1,0,0,3,1352,17.01
5712,1,0,1,1,1,0,4,4966,36.77
5713,1,1,1,1,0,0,4,4966,36.77
5714,1,4,1,1,0,0,7,13868,78.23
5715,1,1,1,1,0,0,4,4966,36.77
5717,3,0,5,2,3,4,17,18193,98.23
5718,1,1,0,1,0,0,3,1352,17.01
5719,1,1,2,1,0,0,5,8690,54.42
5720,3,1,5,1,3,0,13,17456,94.66
5721,1,1,0,1,0,0,3,1352,17.01
5722,1,4,1,1,2,0,9,15950,87.44
5723,1,0,4,2,0,0,7,13868,78.23
5724,1,0,0,1,0,0,2,32,3.72
5725,1,4,1,1,0,0,7,13868,78.23
5726,3,0,5,2,3,0,13,17456,94.66
5727,1,0,3,1,0,6,11,16947,91.91
5728,1,1,1,1,1,0,5,8690,54.42
5729,1,0,1,1,2,0,5,8690,54.42
5730,1,3,0,1,0,0,5,8690,54.42
5731,1,0,0,1,0,0,2,32,3.72
5732,4,0,3,1,3,6,17,18193,98.23
5733,1,2,0,1,1,0,5,8690,54.42
5734,1,0,1,1,2,0,5,8690,54.42
5735,1,0,1,1,0,0,3,1352,17.01
5736,1,3,1,1,1,0,7,13868,78.23
5737,3,0,5,2,3,6,19,18362,99.04
5738,1,0,0,1,2,0,4,4966,36.77
5739,1,1,3,1,0,0,6,11521,68.36
5740,1,0,2,1,1,0,5,8690,54.42
5741,1,0,1,1,0,0,3,1352,17.01
5742,1,4,1,1,0,0,7,13868,78.23
5743,1,0,1,1,0,0,3,1352,17.01
5744,1,0,0,1,0,0,2,32,3.72
5745,1,1,2,1,0,0,5,8690,54.42
5746,1,1,0,1,0,0,3,1352,17.01
5747,1,1,0,1,2,0,5,8690,54.42
5748,1,1,2,1,3,0,8,15186,83.84
5749,1,2,0,1,0,0,4,4966,36.77
5750,1,0,0,1,0,0,2,32,3.72
5751,1,0,3,1,2,0,7,13868,78.23
5752,1,1,1,1,1,0,5,8690,54.42
5753,1,0,0,1,0,0,2,32,3.72
5754,1,1,0,1,1,0,4,4966,36.77
5755,1,1,1,1,1,0,5,8690,54.42
5756,1,0,2,1,0,0,4,4966,36.77
5757,1,2,1,1,0,0,5,8690,54.42
5758,1,2,3,2,0,0,8,15186,83.84
5759,1,4,2,2,0,0,9,15950,87.44
5760,1,2,0,1,0,0,4,4966,36.77
5761,1,2,0,1,0,0,4,4966,36.77
5762,1,1,0,1,0,0,3,1352,17.01
5763,1,2,0,1,1,0,5,8690,54.42
5764,1,1,0,1,0,0,3,1352,17.01
5765,1,3,1,1,0,0,6,11521,68.36
5766,1,3,1,1,0,0,6,11521,68.36
5767,1,2,1,1,0,0,5,8690,54.42
5768,1,0,0,1,2,0,4,4966,36.77
5769,1,0,0,1,0,0,2,32,3.72
5770,1,4,0,1,2,0,8,15186,83.84
5771,1,4,0,1,2,0,8,15186,83.84
5772,1,4,0,1,0,0,6,11521,68.36
5773,1,4,0,1,0,0,6,11521,68.36
5774,1,4,0,1,1,0,7,13868,78.23
5775,1,0,1,1,0,0,3,1352,17.01
5776,1,0,2,2,3,0,8,15186,83.84
5777,1,0,0,1,0,0,2,32,3.72
5778,1,0,1,1,0,0,3,1352,17.01
5779,1,0,1,1,1,0,4,4966,36.77
5780,1,0,2,1,2,0,6,11521,68.36
5781,1,1,2,1,0,6,11,16947,91.91
5782,1,0,0,1,0,0,2,32,3.72
5783,1,3,1,1,0,0,6,11521,68.36
5784,3,0,5,1,5,0,14,17699,95.82
5786,1,4,0,1,0,0,6,11521,68.36
5787,1,0,1,1,3,0,6,11521,68.36
5788,1,2,0,1,0,0,4,4966,36.77
5789,1,2,0,1,3,0,7,13868,78.23
5790,1,0,1,1,1,0,4,4966,36.77
5791,1,0,1,1,0,0,3,1352,17.01
5792,1,4,0,1,0,0,6,11521,68.36
5793,1,0,2,1,0,0,4,4966,36.77
5794,1,1,1,1,0,0,4,4966,36.77
5795,1,0,3,1,0,0,5,8690,54.42
5796,1,1,0,1,0,0,3,1352,17.01
5797,1,1,0,1,0,0,3,1352,17.01
5798,1,2,0,1,0,0,4,4966,36.77
5799,1,2,0,1,0,0,4,4966,36.77
5800,1,3,0,1,0,0,5,8690,54.42
5801,1,1,1,1,0,0,4,4966,36.77
5802,1,0,2,1,2,0,6,11521,68.36
5803,1,2,1,1,0,0,5,8690,54.42
5804,1,3,0,1,0,0,5,8690,54.42
5805,1,0,0,1,0,0,2,32,3.72
5806,1,1,0,1,0,8,11,16947,91.91
5807,1,0,0,1,0,0,2,32,3.72
5808,1,0,5,2,4,0,12,17186,93.28
5809,1,1,1,1,2,0,6,11521,68.36
5810,1,0,0,1,0,0,2,32,3.72
5811,1,0,0,1,2,0,4,4966,36.77
5812,1,0,0,1,0,0,2,32,3.72
5813,1,0,3,2,3,0,9,15950,87.44
5814,1,1,0,1,0,0,3,1352,17.01
5815,1,0,0,1,0,0,2,32,3.72
5816,1,2,1,1,0,0,5,8690,54.42
5817,1,3,1,1,0,0,6,11521,68.36
5818,1,2,1,1,0,0,5,8690,54.42
5819,1,1,2,1,0,0,5,8690,54.42
5820,1,2,0,1,0,0,4,4966,36.77
5821,1,3,0,1,0,0,5,8690,54.42
5822,1,0,1,1,0,0,3,1352,17.01
5823,1,3,0,1,2,0,7,13868,78.23
5824,1,0,0,1,0,0,2,32,3.72
5825,3,0,5,1,5,6,20,18419,99.31
5826,1,4,0,1,0,0,6,11521,68.36
5827,1,0,1,1,0,6,9,15950,87.44
5828,1,4,0,1,0,0,6,11521,68.36
5829,1,3,2,1,0,0,7,13868,78.23
5830,1,1,2,1,0,0,5,8690,54.42
5831,1,1,1,1,0,0,4,4966,36.77
5832,1,2,0,1,1,0,5,8690,54.42
5833,1,0,3,1,0,0,5,8690,54.42
5834,1,3,1,1,0,0,6,11521,68.36
5835,1,2,2,1,0,0,6,11521,68.36
5836,1,0,0,1,0,0,2,32,3.72
5837,1,3,0,1,0,0,5,8690,54.42
5839,3,0,3,1,1,0,8,15186,83.84
5840,1,4,3,3,4,0,15,17888,96.85
5841,1,0,0,1,2,0,4,4966,36.77
5842,1,1,0,1,0,0,3,1352,17.01
5843,1,0,1,1,0,6,9,15950,87.44
5844,1,2,0,1,0,0,4,4966,36.77
5845,1,3,0,1,0,0,5,8690,54.42
5846,1,1,1,1,0,0,4,4966,36.77
5847,1,1,1,1,0,0,4,4966,36.77
5848,1,1,1,1,0,0,4,4966,36.77
5849,1,0,3,1,1,0,6,11521,68.36
5850,1,4,0,1,3,0,9,15950,87.44
5851,1,0,2,1,1,0,5,8690,54.42
5852,3,0,5,1,5,0,14,17699,95.82
5853,1,2,1,1,2,0,7,13868,78.23
5854,1,4,2,1,0,0,8,15186,83.84
5855,1,0,2,1,0,0,4,4966,36.77
5856,1,0,1,1,0,6,9,15950,87.44
5857,1,4,0,1,0,0,6,11521,68.36
5858,1,1,1,1,0,0,4,4966,36.77
5859,1,2,4,1,2,0,10,16522,90.12
5860,3,0,5,2,3,0,13,17456,94.66
5861,1,0,3,1,1,4,10,16522,90.12
5862,1,3,1,1,0,0,6,11521,68.36
5863,1,0,4,1,0,0,6,11521,68.36
5864,1,2,0,1,0,0,4,4966,36.77
5865,1,4,1,1,0,0,7,13868,78.23
5866,1,4,0,1,0,0,6,11521,68.36
5867,1,2,4,1,2,0,10,16522,90.12
5868,1,0,2,1,4,0,8,15186,83.84
5869,1,2,1,1,0,0,5,8690,54.42
5870,1,0,2,1,2,0,6,11521,68.36
5871,1,0,1,1,0,0,3,1352,17.01
5872,1,2,1,1,0,0,5,8690,54.42
5873,1,1,3,1,0,0,6,11521,68.36
5874,1,2,0,1,0,0,4,4966,36.77
5875,1,1,0,1,0,0,3,1352,17.01
5876,1,2,1,1,0,0,5,8690,54.42
5877,1,1,0,1,0,0,3,1352,17.01
5878,3,2,2,1,4,0,12,17186,93.28
5879,1,3,0,1,0,0,5,8690,54.42
5880,1,0,2,1,1,6,11,16947,91.91
5881,1,0,2,1,0,0,4,4966,36.77
5882,1,0,1,1,0,0,3,1352,17.01
5883,3,1,5,2,3,6,20,18419,99.31
5884,1,0,2,1,3,0,7,13868,78.23
5885,1,0,2,1,2,0,6,11521,68.36
5886,1,2,0,1,1,0,5,8690,54.42
5888,1,4,2,1,0,0,8,15186,83.84
5889,1,4,0,1,3,0,9,15950,87.44
5890,1,0,1,1,2,0,5,8690,54.42
5891,1,0,1,1,0,0,3,1352,17.01
5892,1,0,1,1,0,0,3,1352,17.01
5893,1,4,0,1,0,0,6,11521,68.36
5894,1,0,0,1,0,0,2,32,3.72
5895,1,4,0,1,0,0,6,11521,68.36
5896,1,1,2,1,0,0,5,8690,54.42
5897,1,2,0,1,0,0,4,4966,36.77
5898,1,0,0,1,0,0,2,32,3.72
5899,1,3,0,1,0,0,5,8690,54.42
5900,1,0,4,1,1,0,7,13868,78.23
5901,1,0,0,1,0,0,2,32,3.72
5902,1,1,1,1,0,0,4,4966,36.77
5903,1,4,0,1,0,0,6,11521,68.36
5904,1,1,1,1,0,0,4,4966,36.77
5905,1,4,2,1,0,0,8,15186,83.84
5906,1,0,2,1,0,0,4,4966,36.77
5907,1,2,0,1,0,0,4,4966,36.77
5908,1,1,1,1,0,6,10,16522,90.12
5909,1,2,0,1,1,0,5,8690,54.42
5912,1,2,1,1,0,0,5,8690,54.42
5913,1,4,0,1,0,0,6,11521,68.36
5914,1,0,1,1,0,0,3,1352,17.01
5915,1,0,1,1,0,0,3,1352,17.01
5916,1,2,0,1,0,0,4,4966,36.77
5917,1,0,0,1,0,0,2,32,3.72
5918,1,0,0,1,0,0,2,32,3.72
5919,1,4,1,1,0,0,7,13868,78.23
5920,2,0,5,1,1,0,9,15950,87.44
5921,1,0,1,1,0,0,3,1352,17.01
5923,1,4,1,1,0,0,7,13868,78.23
5924,1,4,0,1,0,0,6,11521,68.36
5925,1,0,1,1,0,0,3,1352,17.01
5926,1,4,0,1,0,0,6,11521,68.36
5927,1,4,0,1,0,0,6,11521,68.36
5928,1,1,0,1,0,0,3,1352,17.01
5929,1,0,2,1,0,0,4,4966,36.77
5930,1,2,0,1,0,0,4,4966,36.77
5931,1,3,3,1,0,0,8,15186,83.84
5932,1,3,2,1,0,0,7,13868,78.23
5933,3,0,4,2,3,0,12,17186,93.28
5934,3,0,2,2,5,0,12,17186,93.28
5937,3,0,5,2,3,0,13,17456,94.66
5938,4,0,5,2,5,0,16,18081,97.67
5939,3,0,5,2,3,0,13,17456,94.66
5940,1,0,3,3,3,0,10,16522,90.12
5941,3,0,5,2,3,0,13,17456,94.66
5942,1,0,1,1,1,0,4,4966,36.77
5944,1,1,0,1,2,0,5,8690,54.42
5945,1,2,1,1,0,0,5,8690,54.42
5946,1,0,0,1,0,0,2,32,3.72
5947,1,1,0,1,0,0,3,1352,17.01
5948,1,0,0,1,0,0,2,32,3.72
5949,1,0,0,1,0,0,2,32,3.72
5950,1,0,1,1,0,0,3,1352,17.01
5951,1,1,0,1,0,0,3,1352,17.01
5952,1,1,0,1,0,0,3,1352,17.01
5953,1,1,0,1,0,0,3,1352,17.01
5954,1,1,1,1,0,0,4,4966,36.77
5955,1,1,1,1,0,0,4,4966,36.77
5956,1,1,1,1,0,0,4,4966,36.77
5957,1,1,1,1,0,0,4,4966,36.77
5958,1,0,0,1,0,0,2,32,3.72
5959,1,0,1,1,0,0,3,1352,17.01
5960,1,1,3,1,0,0,6,11521,68.36
5961,3,0,5,1,1,6,16,18081,97.67
5962,1,2,0,1,0,0,4,4966,36.77
5963,1,2,0,1,1,0,5,8690,54.42
5964,1,1,0,1,3,0,6,11521,68.36
5965,1,2,0,1,3,0,7,13868,78.23
5966,1,3,0,1,3,0,8,15186,83.84
5967,1,4,2,1,0,0,8,15186,83.84
5968,1,0,2,1,1,0,5,8690,54.42
5969,1,0,2,1,1,0,5,8690,54.42
5970,1,0,1,1,2,0,5,8690,54.42
5971,1,1,1,1,1,0,5,8690,54.42
5972,1,0,1,1,0,0,3,1352,17.01
5973,1,0,1,1,1,0,4,4966,36.77
5974,1,0,2,1,0,0,4,4966,36.77
5975,1,0,0,1,1,0,3,1352,17.01
5977,1,0,1,1,0,0,3,1352,17.01
5978,1,2,3,1,0,0,7,13868,78.23
5979,1,0,1,1,0,0,3,1352,17.01
5980,1,1,0,1,0,0,3,1352,17.01
5981,1,3,0,1,0,0,5,8690,54.42
5983,1,1,0,1,0,0,3,1352,17.01
5984,1,1,0,1,0,0,3,1352,17.01
5985,1,0,1,1,3,0,6,11521,68.36
5986,1,0,1,1,0,0,3,1352,17.01
5987,1,0,2,1,2,0,6,11521,68.36
5988,1,2,1,1,0,0,5,8690,54.42
5989,1,1,1,1,1,0,5,8690,54.42
5990,1,3,0,1,0,0,5,8690,54.42
5991,1,2,0,1,1,0,5,8690,54.42
5992,1,2,0,1,2,0,6,11521,68.36
5993,3,2,4,3,3,0,15,17888,96.85
5994,1,2,1,1,0,0,5,8690,54.42
5995,1,1,1,1,0,0,4,4966,36.77
5996,1,0,2,2,1,0,6,11521,68.36
5997,3,0,5,1,3,0,12,17186,93.28
5998,1,0,3,1,0,0,5,8690,54.42
5999,1,4,0,1,3,0,9,15950,87.44
6000,1,0,0,1,2,0,4,4966,36.77
6001,1,0,0,1,0,0,2,32,3.72
6002,1,0,0,1,0,0,2,32,3.72
6003,3,0,5,2,5,2,17,18193,98.23
6004,1,1,2,1,0,0,5,8690,54.42
6005,1,0,1,1,0,0,3,1352,17.01
6006,1,3,0,1,0,0,5,8690,54.42
6007,1,3,1,1,1,0,7,13868,78.23
6008,1,0,0,1,0,0,2,32,3.72
6009,1,0,4,1,1,0,7,13868,78.23
6010,1,0,3,1,1,0,6,11521,68.36
6011,1,0,1,1,0,0,3,1352,17.01
6012,1,4,0,1,0,0,6,11521,68.36
6013,1,0,0,1,0,0,2,32,3.72
6014,1,0,0,1,1,0,3,1352,17.01
6015,1,2,1,1,1,0,6,11521,68.36
6016,1,4,0,1,0,0,6,11521,68.36
6017,1,1,1,1,0,0,4,4966,36.77
6018,1,2,1,1,0,0,5,8690,54.42
6019,1,1,1,1,1,0,5,8690,54.42
6020,1,4,0,1,0,0,6,11521,68.36
6021,1,4,0,1,0,0,6,11521,68.36
6022,1,2,1,1,1,0,6,11521,68.36
6023,1,1,0,1,1,0,4,4966,36.77
6024,1,2,1,1,1,0,6,11521,68.36
6025,1,0,0,1,0,0,2,32,3.72
6026,1,0,2,1,1,0,5,8690,54.42
6027,1,4,0,1,0,0,6,11521,68.36
6028,1,4,0,1,0,0,6,11521,68.36
6029,1,4,0,1,0,0,6,11521,68.36
6030,1,0,0,1,0,0,2,32,3.72
6031,1,1,1,1,0,2,6,11521,68.36
6032,1,2,1,1,0,0,5,8690,54.42
6033,1,0,1,1,1,0,4,4966,36.77
6034,1,0,0,1,1,0,3,1352,17.01
6035,1,1,2,1,0,0,5,8690,54.42
6036,1,0,2,1,4,0,8,15186,83.84
6037,1,0,0,1,3,0,5,8690,54.42
6038,1,0,0,1,0,0,2,32,3.72
6039,1,0,0,1,0,0,2,32,3.72
6040,1,0,0,1,0,0,2,32,3.72
6041,1,0,1,1,2,0,5,8690,54.42
6042,1,4,1,1,0,0,7,13868,78.23
6043,1,1,0,1,1,0,4,4966,36.77
6044,1,1,0,1,0,0,3,1352,17.01
6045,1,0,0,1,0,0,2,32,3.72
6046,1,3,1,1,0,0,6,11521,68.36
6047,1,3,1,1,0,0,6,11521,68.36
6048,1,0,2,1,0,0,4,4966,36.77
6049,1,1,0,1,1,0,4,4966,36.77
6050,3,0,5,2,3,0,13,17456,94.66
6051,3,0,5,1,5,0,14,17699,95.82
6052,1,1,1,1,1,0,5,8690,54.42
6053,1,0,0,1,3,0,5,8690,54.42
6054,1,0,0,1,3,0,5,8690,54.42
6055,1,0,2,1,0,6,10,16522,90.12
6056,1,0,2,1,0,6,10,16522,90.12
6057,3,1,5,4,5,2,20,18419,99.31
6058,1,1,2,1,0,2,7,13868,78.23
6059,1,4,0,1,0,0,6,11521,68.36
6060,1,4,0,1,0,0,6,11521,68.36
6061,1,0,3,1,0,0,5,8690,54.42
6062,1,1,0,1,0,0,3,1352,17.01
6063,1,1,0,1,0,0,3,1352,17.01
6064,1,1,1,1,0,0,4,4966,36.77
6065,1,1,0,1,0,0,3,1352,17.01
6066,1,1,0,1,0,0,3,1352,17.01
6067,1,0,0,1,0,0,2,32,3.72
6068,1,0,2,1,0,0,4,4966,36.77
6070,4,0,4,1,1,6,16,18081,97.67
6071,1,1,1,1,0,0,4,4966,36.77
6072,3,0,5,2,3,0,13,17456,94.66
6073,1,0,5,1,4,0,11,16947,91.91
6074,1,5,0,1,0,0,7,13868,78.23
6075,1,0,2,1,2,0,6,11521,68.36
6076,1,0,0,1,0,0,2,32,3.72
6077,1,1,2,1,3,0,8,15186,83.84
6078,1,4,0,1,0,0,6,11521,68.36
6079,1,4,0,1,0,0,6,11521,68.36
6080,1,2,0,1,0,0,4,4966,36.77
6081,1,2,0,1,0,0,4,4966,36.77
6082,1,0,1,1,0,0,3,1352,17.01
6083,1,0,0,1,0,0,2,32,3.72
6084,1,0,0,1,0,0,2,32,3.72
6085,1,3,0,1,0,0,5,8690,54.42
6086,1,0,2,1,0,0,4,4966,36.77
6087,1,0,0,1,0,0,2,32,3.72
6088,1,0,0,1,0,0,2,32,3.72
6089,1,0,0,1,0,0,2,32,3.72
6090,1,0,4,2,0,6,13,17456,94.66
6091,1,1,2,1,0,0,5,8690,54.42
6092,1,0,2,1,0,0,4,4966,36.77
6093,1,0,1,1,1,0,4,4966,36.77
6094,1,0,1,1,0,0,3,1352,17.01
6095,1,0,1,1,0,0,3,1352,17.01
6096,1,0,1,1,0,0,3,1352,17.01
6097,1,0,1,1,0,0,3,1352,17.01
6098,1,0,0,1,0,0,2,32,3.72
6099,1,3,0,1,0,0,5,8690,54.42
6100,1,2,0,1,0,0,4,4966,36.77
6101,1,0,1,1,0,0,3,1352,17.01
6102,1,3,1,1,0,0,6,11521,68.36
6103,1,2,1,1,0,0,5,8690,54.42
6104,1,2,0,1,0,0,4,4966,36.77
6105,1,1,0,1,0,0,3,1352,17.01
6106,1,0,0,1,0,0,2,32,3.72
6107,1,0,0,1,0,0,2,32,3.72
6108,1,2,4,2,0,0,9,15950,87.44
6109,1,2,2,2,0,0,7,13868,78.23
6110,1,0,1,1,2,0,5,8690,54.42
6111,1,0,0,1,0,0,2,32,3.72
6112,1,0,0,1,0,0,2,32,3.72
6113,1,1,0,1,2,0,5,8690,54.42
6114,1,1,0,1,1,0,4,4966,36.77
6115,1,1,0,1,0,0,3,1352,17.01
6116,1,2,0,1,0,0,4,4966,36.77
6117,1,3,0,1,0,0,5,8690,54.42
6118,1,0,2,1,2,0,6,11521,68.36
6119,1,0,2,1,0,0,4,4966,36.77
6120,1,0,2,1,1,0,5,8690,54.42
6121,1,0,1,1,0,0,3,1352,17.01
6122,1,0,0,1,0,0,2,32,3.72
6123,1,0,1,1,0,0,3,1352,17.01
6124,1,0,0,1,0,0,2,32,3.72
6125,1,1,1,1,0,0,4,4966,36.77
6126,1,0,1,1,0,0,3,1352,17.01
6127,1,1,0,1,0,0,3,1352,17.01
6128,1,0,1,1,0,0,3,1352,17.01
6129,1,4,0,1,1,0,7,13868,78.23
6130,1,4,0,1,0,0,6,11521,68.36
6131,1,0,3,1,1,0,6,11521,68.36
6132,1,0,1,1,0,0,3,1352,17.01
6133,1,0,1,1,0,0,3,1352,17.01
6134,1,2,0,1,0,0,4,4966,36.77
6135,1,2,0,1,0,0,4,4966,36.77
6136,1,1,0,1,0,0,3,1352,17.01
6137,1,1,0,1,0,0,3,1352,17.01
6138,1,0,0,1,0,0,2,32,3.72
6139,1,0,0,1,0,0,2,32,3.72
6140,1,4,0,1,0,0,6,11521,68.36
6141,1,0,1,1,0,0,3,1352,17.01
6142,1,0,1,1,0,0,3,1352,17.01
6143,1,4,0,1,0,0,6,11521,68.36
6144,1,3,5,2,2,0,13,17456,94.66
6145,1,3,3,1,0,0,8,15186,83.84
6146,1,4,1,1,0,0,7,13868,78.23
6147,1,3,1,1,0,0,6,11521,68.36
6148,1,3,1,1,1,0,7,13868,78.23
6149,1,3,1,1,1,0,7,13868,78.23
6150,1,4,0,1,1,0,7,13868,78.23
6151,1,4,0,1,0,0,6,11521,68.36
6152,1,0,3,2,3,0,9,15950,87.44
6153,1,1,0,1,2,0,5,8690,54.42
6154,1,0,0,1,1,0,3,1352,17.01
6155,1,1,0,1,0,0,3,1352,17.01
6156,1,1,1,1,0,0,4,4966,36.77
6157,1,1,0,1,1,0,4,4966,36.77
6158,1,3,0,1,0,0,5,8690,54.42
6159,1,3,0,1,0,0,5,8690,54.42
6160,1,3,0,1,0,0,5,8690,54.42
6161,3,0,5,1,3,0,12,17186,93.28
6162,1,0,1,1,0,0,3,1352,17.01
6163,1,0,1,1,0,0,3,1352,17.01
6164,1,4,0,1,0,0,6,11521,68.36
6165,1,2,1,1,0,0,5,8690,54.42
6166,1,2,1,1,0,0,5,8690,54.42
6167,1,3,1,1,0,0,6,11521,68.36
6168,1,2,1,1,0,0,5,8690,54.42
6169,1,0,0,1,3,0,5,8690,54.42
6170,1,0,0,1,0,0,2,32,3.72
6171,1,0,1,1,2,0,5,8690,54.42
6172,1,1,0,1,0,0,3,1352,17.01
6173,1,1,0,1,0,0,3,1352,17.01
6175,1,0,0,1,0,0,2,32,3.72
6176,1,0,0,1,0,0,2,32,3.72
6177,1,1,0,1,0,0,3,1352,17.01
6178,1,2,0,1,0,0,4,4966,36.77
6179,1,0,0,1,0,0,2,32,3.72
6180,1,1,0,1,1,0,4,4966,36.77
6181,1,0,2,1,0,0,4,4966,36.77
6182,1,2,1,1,0,0,5,8690,54.42
6183,1,3,0,1,0,0,5,8690,54.42
6184,1,0,0,1,0,0,2,32,3.72
6185,1,0,0,1,0,0,2,32,3.72
6186,1,1,0,1,0,0,3,1352,17.01
6187,1,1,0,1,0,0,3,1352,17.01
6189,1,0,0,1,0,0,2,32,3.72
6190,1,1,0,1,0,0,3,1352,17.01
6191,1,0,1,1,0,0,3,1352,17.01
6192,1,0,2,1,0,0,4,4966,36.77
6193,1,0,1,1,0,0,3,1352,17.01
6194,1,0,0,1,0,0,2,32,3.72
6195,1,0,3,1,3,0,8,15186,83.84
6196,1,1,1,1,0,0,4,4966,36.77
6197,1,1,1,1,0,0,4,4966,36.77
6198,1,2,0,1,0,0,4,4966,36.77
6199,1,2,0,1,0,0,4,4966,36.77
6200,1,3,0,1,0,0,5,8690,54.42
6201,1,2,2,2,0,0,7,13868,78.23
6202,1,2,0,1,0,0,4,4966,36.77
6203,1,3,0,1,2,0,7,13868,78.23
6204,1,2,1,1,0,0,5,8690,54.42
6205,1,0,2,1,1,0,5,8690,54.42
6206,1,0,2,1,0,0,4,4966,36.77
6207,4,0,5,3,5,0,17,18193,98.23
6208,2,0,4,2,5,0,13,17456,94.66
6209,1,0,2,1,0,0,4,4966,36.77
6210,1,1,1,1,0,0,4,4966,36.77
6211,1,1,1,1,2,0,6,11521,68.36
6212,3,0,4,1,5,0,13,17456,94.66
6213,1,3,0,1,0,0,5,8690,54.42
6214,1,3,0,1,0,0,5,8690,54.42
6215,1,3,0,1,0,0,5,8690,54.42
6216,1,0,1,1,0,6,9,15950,87.44
6217,1,2,2,1,1,0,7,13868,78.23
6218,1,1,1,1,0,0,4,4966,36.77
6220,4,0,5,2,5,6,22,18498,99.73
6221,1,0,1,1,1,0,4,4966,36.77
6222,1,0,1,1,0,0,3,1352,17.01
6223,1,0,0,1,0,0,2,32,3.72
6224,1,1,0,1,0,0,3,1352,17.01
6225,1,0,0,1,0,0,2,32,3.72
6226,1,1,0,1,0,0,3,1352,17.01
6227,1,0,0,1,0,0,2,32,3.72
6228,1,0,1,1,0,0,3,1352,17.01
6229,1,0,1,1,0,0,3,1352,17.01
6230,1,0,1,1,0,0,3,1352,17.01
6231,1,0,1,1,0,0,3,1352,17.01
6232,1,0,1,1,0,0,3,1352,17.01
6233,1,0,1,1,0,0,3,1352,17.01
6235,1,0,1,1,0,0,3,1352,17.01
6236,1,0,0,1,0,0,2,32,3.72
6237,1,2,1,1,0,0,5,8690,54.42
6238,1,2,0,1,0,0,4,4966,36.77
6239,1,0,4,1,0,0,6,11521,68.36
6240,1,1,1,1,3,0,7,13868,78.23
6241,1,1,1,1,0,0,4,4966,36.77
6242,1,0,1,1,1,0,4,4966,36.77
6244,1,2,0,1,3,0,7,13868,78.23
6245,1,1,1,1,0,0,4,4966,36.77
6246,1,0,1,1,0,0,3,1352,17.01
6247,1,0,1,1,0,0,3,1352,17.01
6248,1,1,1,1,0,0,4,4966,36.77
6249,4,0,5,4,5,0,18,18287,98.68
6250,3,4,3,4,5,0,19,18362,99.04
6252,3,0,5,2,3,0,13,17456,94.66
6253,3,2,4,2,5,0,16,18081,97.67
6254,3,0,5,1,5,0,14,17699,95.82
6255,3,0,4,1,5,0,13,17456,94.66
6260,3,0,4,2,4,0,13,17456,94.66
6261,1,0,0,1,0,0,2,32,3.72
6262,1,1,0,1,0,0,3,1352,17.01
6263,3,0,4,4,3,0,14,17699,95.82
6265,1,0,1,1,0,0,3,1352,17.01
6266,3,4,5,4,5,0,21,18462,99.52
6267,1,0,1,1,0,0,3,1352,17.01
6268,1,0,1,1,1,0,4,4966,36.77
6269,1,0,1,1,0,0,3,1352,17.01
6270,1,1,0,1,0,0,3,1352,17.01
6271,1,0,0,1,0,0,2,32,3.72
6272,1,0,1,1,0,0,3,1352,17.01
6273,1,0,0,1,0,0,2,32,3.72
6274,1,0,1,1,0,0,3,1352,17.01
6275,1,0,1,1,0,0,3,1352,17.01
6276,1,0,1,1,0,0,3,1352,17.01
6277,1,1,1,1,0,0,4,4966,36.77
6278,1,1,0,1,0,0,3,1352,17.01
6279,1,4,0,1,0,0,6,11521,68.36
6280,4,0,5,2,5,0,16,18081,97.67
6281,1,4,1,1,0,0,7,13868,78.23
6282,1,0,1,1,0,0,3,1352,17.01
6283,1,0,1,1,0,0,3,1352,17.01
6284,1,3,0,1,0,0,5,8690,54.42
6285,1,1,0,1,0,0,3,1352,17.01
6286,1,1,1,1,2,0,6,11521,68.36
6287,1,4,0,1,2,0,8,15186,83.84
6288,1,0,5,1,0,0,7,13868,78.23
6289,1,2,1,1,0,0,5,8690,54.42
6290,1,3,2,1,1,0,8,15186,83.84
6291,1,4,0,1,0,0,6,11521,68.36
6292,3,0,5,4,5,0,17,18193,98.23
6293,1,0,1,1,0,0,3,1352,17.01
6295,1,0,1,1,0,0,3,1352,17.01
6298,1,4,1,1,1,0,8,15186,83.84
6299,1,3,1,1,1,0,7,13868,78.23
6301,3,0,5,1,5,0,14,17699,95.82
6302,1,0,1,1,0,0,3,1352,17.01
6303,1,0,0,1,0,2,4,4966,36.77
6305,3,0,5,1,3,0,12,17186,93.28
6306,1,0,1,1,0,0,3,1352,17.01
6307,1,3,1,1,0,0,6,11521,68.36
6308,1,3,3,2,0,0,9,15950,87.44
6309,1,2,1,1,0,0,5,8690,54.42
6310,1,0,1,1,0,0,3,1352,17.01
6311,3,0,5,2,2,0,12,17186,93.28
6313,1,0,1,1,4,0,7,13868,78.23
6314,1,3,3,1,0,0,8,15186,83.84
6315,1,0,5,2,0,0,8,15186,83.84
6316,1,0,2,1,3,0,7,13868,78.23
6317,1,0,2,1,2,0,6,11521,68.36
6318,1,0,0,2,1,0,4,4966,36.77
6319,3,0,5,4,3,0,15,17888,96.85
6321,1,4,2,1,0,0,8,15186,83.84
6322,1,1,1,1,0,0,4,4966,36.77
6323,1,0,0,1,0,0,2,32,3.72
6324,1,1,1,1,0,6,10,16522,90.12
6325,1,0,1,1,1,0,4,4966,36.77
6326,1,1,0,1,0,0,3,1352,17.01
6327,1,2,0,1,0,0,4,4966,36.77
6328,1,0,0,1,0,0,2,32,3.72
6329,1,2,2,1,0,0,6,11521,68.36
6330,1,1,1,1,0,0,4,4966,36.77
6331,4,0,5,2,5,8,24,18547,99.89
6332,3,0,5,2,2,0,12,17186,93.28
6334,1,2,1,1,1,0,6,11521,68.36
6335,1,0,3,1,0,0,5,8690,54.42
6336,1,2,0,1,2,0,6,11521,68.36
6337,1,0,0,1,0,0,2,32,3.72
6338,1,4,0,1,0,0,6,11521,68.36
6339,1,2,0,1,0,0,4,4966,36.77
6340,1,1,0,1,0,0,3,1352,17.01
6341,1,1,0,1,0,0,3,1352,17.01
6342,1,0,0,1,0,0,2,32,3.72
6343,1,0,0,1,0,0,2,32,3.72
6344,1,4,3,1,0,0,9,15950,87.44
6345,1,1,1,1,0,0,4,4966,36.77
6346,1,3,0,1,0,0,5,8690,54.42
6347,1,1,0,1,0,0,3,1352,17.01
6348,1,3,0,1,0,0,5,8690,54.42
6350,1,1,1,1,0,0,4,4966,36.77
6351,1,0,5,2,1,0,9,15950,87.44
6352,3,2,3,1,2,0,11,16947,91.91
6353,1,1,2,1,1,0,6,11521,68.36
6354,1,1,0,1,0,0,3,1352,17.01
6355,1,4,0,1,0,0,6,11521,68.36
6356,1,0,1,1,0,0,3,1352,17.01
6357,1,1,0,1,0,0,3,1352,17.01
6358,1,4,2,1,0,0,8,15186,83.84
6359,4,0,5,2,1,0,12,17186,93.28
6360,1,5,0,1,0,0,7,13868,78.23
6361,1,5,0,1,0,0,7,13868,78.23
6362,1,5,0,1,0,0,7,13868,78.23
6363,1,1,3,1,0,0,6,11521,68.36
6364,1,4,0,1,0,0,6,11521,68.36
6365,1,5,0,1,0,0,7,13868,78.23
6366,1,5,0,1,0,0,7,13868,78.23
6367,1,5,0,1,0,0,7,13868,78.23
6368,1,5,0,1,0,0,7,13868,78.23
6369,1,1,2,1,0,0,5,8690,54.42
6370,1,5,0,1,0,0,7,13868,78.23
6371,1,5,0,1,0,0,7,13868,78.23
6372,1,5,0,1,0,0,7,13868,78.23
6373,1,4,0,1,0,0,6,11521,68.36
6374,1,4,0,1,0,0,6,11521,68.36
6375,1,5,0,1,0,0,7,13868,78.23
6376,1,3,2,1,0,6,13,17456,94.66
6377,1,0,1,2,1,0,5,8690,54.42
6378,1,0,2,1,0,0,4,4966,36.77
6379,3,0,3,1,2,0,9,15950,87.44
6380,3,0,4,1,1,0,9,15950,87.44
6381,3,0,3,1,3,0,10,16522,90.12
6382,3,0,3,1,1,0,8,15186,83.84
6383,3,0,5,1,1,0,10,16522,90.12
6384,3,0,3,1,2,8,17,18193,98.23
6385,3,0,3,1,3,8,18,18287,98.68
6386,3,0,4,1,2,4,14,17699,95.82
6387,3,1,3,1,1,4,13,17456,94.66
6388,3,0,3,1,1,0,8,15186,83.84
6389,3,0,3,1,1,0,8,15186,83.84
6390,3,0,3,1,3,0,10,16522,90.12
6391,3,0,3,1,1,0,8,15186,83.84
6392,3,0,3,1,1,0,8,15186,83.84
6393,3,0,2,1,3,0,9,15950,87.44
6394,3,1,3,1,1,0,9,15950,87.44
6395,3,0,2,1,1,0,7,13868,78.23
6396,3,0,5,2,3,0,13,17456,94.66
6397,3,0,5,2,3,0,13,17456,94.66
6398,3,1,5,2,3,0,14,17699,95.82
6399,3,0,5,2,5,0,15,17888,96.85
6400,1,0,2,1,0,0,4,4966,36.77
6401,1,3,0,1,0,0,5,8690,54.42
6402,1,4,0,1,0,0,6,11521,68.36
6403,1,4,1,1,2,0,9,15950,87.44
6404,3,2,5,4,5,0,19,18362,99.04
6405,1,0,2,1,3,0,7,13868,78.23
6406,1,3,3,1,0,0,8,15186,83.84
6407,1,2,0,1,0,0,4,4966,36.77
6408,1,3,1,1,0,0,6,11521,68.36
6409,1,1,1,1,0,0,4,4966,36.77
6410,1,0,2,2,1,0,6,11521,68.36
6411,1,4,0,1,0,0,6,11521,68.36
6412,3,0,5,1,3,0,12,17186,93.28
6413,1,0,2,1,1,0,5,8690,54.42
6414,1,1,1,1,0,0,4,4966,36.77
6415,1,4,2,1,0,0,8,15186,83.84
6416,1,0,1,1,0,0,3,1352,17.01
6417,1,0,1,1,1,0,4,4966,36.77
6418,1,1,4,1,0,0,7,13868,78.23
6419,1,3,1,1,0,0,6,11521,68.36
6420,1,1,1,1,0,0,4,4966,36.77
6421,1,1,1,1,0,0,4,4966,36.77
6422,1,0,1,1,0,0,3,1352,17.01
6423,1,1,0,1,0,0,3,1352,17.01
6424,1,0,1,1,0,0,3,1352,17.01
6425,1,0,2,1,0,0,4,4966,36.77
6426,1,0,2,1,1,0,5,8690,54.42
6427,1,0,1,2,0,0,4,4966,36.77
6429,1,1,1,1,0,0,4,4966,36.77
6430,1,2,1,1,2,0,7,13868,78.23
6435,1,1,1,1,0,4,8,15186,83.84
6436,1,2,0,1,0,0,4,4966,36.77
6438,1,5,4,2,0,0,12,17186,93.28
6439,3,0,4,3,5,0,15,17888,96.85
6440,1,1,0,1,0,0,3,1352,17.01
6441,1,5,0,1,0,0,7,13868,78.23
6442,1,5,1,1,0,0,8,15186,83.84
6443,1,0,1,1,0,4,7,13868,78.23
6444,1,0,5,3,0,0,9,15950,87.44
6445,1,4,1,1,0,0,7,13868,78.23
6447,1,2,0,1,0,0,4,4966,36.77
6448,1,3,0,1,0,0,5,8690,54.42
6449,1,2,0,1,0,0,4,4966,36.77
6450,1,3,0,1,0,0,5,8690,54.42
6451,1,3,0,1,0,0,5,8690,54.42
6452,1,1,1,1,0,0,4,4966,36.77
6453,1,1,1,1,0,0,4,4966,36.77
6454,1,2,0,1,0,0,4,4966,36.77
6455,1,2,0,1,0,0,4,4966,36.77
6456,1,3,0,1,0,0,5,8690,54.42
6457,1,1,0,1,2,0,5,8690,54.42
6458,1,1,0,1,1,0,4,4966,36.77
6460,1,0,2,1,0,0,4,4966,36.77
6461,1,1,0,1,0,0,3,1352,17.01
6464,1,3,0,1,0,0,5,8690,54.42
6465,1,4,1,1,0,0,7,13868,78.23
6466,1,1,1,1,0,0,4,4966,36.77
6467,1,1,2,1,1,0,6,11521,68.36
6468,1,1,1,1,0,0,4,4966,36.77
6469,1,0,1,1,2,10,15,17888,96.85
6470,1,2,3,1,0,0,7,13868,78.23
6471,4,0,5,2,5,0,16,18081,97.67
6473,1,0,0,1,0,0,2,32,3.72
6474,1,0,1,1,0,0,3,1352,17.01
6475,3,0,5,2,4,0,14,17699,95.82
6476,1,0,0,1,0,0,2,32,3.72
6477,1,0,1,1,0,0,3,1352,17.01
6478,1,2,0,1,0,0,4,4966,36.77
6479,1,1,1,1,0,0,4,4966,36.77
6480,1,1,0,1,0,0,3,1352,17.01
6481,1,4,0,1,0,0,6,11521,68.36
6482,1,1,1,1,0,0,4,4966,36.77
6483,1,0,1,1,0,0,3,1352,17.01
6484,1,0,0,1,0,0,2,32,3.72
6485,1,2,0,1,0,0,4,4966,36.77
6486,1,0,0,1,0,0,2,32,3.72
6487,1,0,0,1,0,0,2,32,3.72
6488,1,1,0,1,0,0,3,1352,17.01
6489,1,2,1,1,0,0,5,8690,54.42
6490,1,0,3,2,1,0,7,13868,78.23
6491,1,0,2,1,0,0,4,4966,36.77
6493,1,0,1,1,0,0,3,1352,17.01
6494,1,1,1,1,0,0,4,4966,36.77
6495,1,2,1,1,0,0,5,8690,54.42
6496,1,0,1,1,1,0,4,4966,36.77
6497,1,1,0,1,3,0,6,11521,68.36
6498,3,0,5,4,3,0,15,17888,96.85
6499,1,0,2,1,0,0,4,4966,36.77
6500,1,4,1,1,1,0,8,15186,83.84
6501,1,1,0,1,3,0,6,11521,68.36
6502,1,0,1,1,0,0,3,1352,17.01
6503,1,0,3,2,1,0,7,13868,78.23
6504,1,3,0,1,0,0,5,8690,54.42
6505,1,0,0,1,0,0,2,32,3.72
6506,1,0,1,1,0,4,7,13868,78.23
6507,3,4,5,3,4,0,19,18362,99.04
6508,1,0,1,1,0,0,3,1352,17.01
6509,1,0,4,1,0,0,6,11521,68.36
6510,1,0,0,1,0,0,2,32,3.72
6511,4,0,5,1,5,0,15,17888,96.85
6512,3,4,5,3,4,0,19,18362,99.04
6513,1,0,0,1,0,0,2,32,3.72
6514,1,0,2,1,0,0,4,4966,36.77
6515,4,0,4,2,5,0,15,17888,96.85
6516,1,0,1,1,0,0,3,1352,17.01
6517,1,4,0,1,0,0,6,11521,68.36
6518,1,3,5,1,3,0,13,17456,94.66
6519,1,2,1,1,2,0,7,13868,78.23
6520,1,4,3,2,0,0,10,16522,90.12
6521,1,1,3,1,0,0,6,11521,68.36
6522,1,3,0,1,0,0,5,8690,54.42
6523,1,2,0,1,3,0,7,13868,78.23
6524,1,1,0,1,0,0,3,1352,17.01
6525,1,0,0,1,0,0,2,32,3.72
6526,1,2,1,1,0,0,5,8690,54.42
6527,1,0,3,1,1,0,6,11521,68.36
6528,1,3,0,1,0,0,5,8690,54.42
6529,1,0,1,1,0,0,3,1352,17.01
6530,3,0,5,3,4,0,15,17888,96.85
6531,2,0,5,2,3,0,12,17186,93.28
6532,3,0,5,1,5,0,14,17699,95.82
6534,3,0,5,1,2,0,11,16947,91.91
6535,4,0,5,2,4,0,15,17888,96.85
6536,4,0,5,2,5,10,26,18556,99.96
6537,3,0,5,1,4,0,13,17456,94.66
6538,1,0,4,1,0,0,6,11521,68.36
6539,3,0,5,1,4,0,13,17456,94.66
6540,3,0,3,1,3,10,20,18419,99.31
6541,1,0,3,1,0,0,5,8690,54.42
6542,3,0,5,1,3,6,18,18287,98.68
6543,3,0,4,1,5,6,19,18362,99.04
6545,1,2,0,1,0,0,4,4966,36.77
6546,1,4,0,1,0,0,6,11521,68.36
6547,1,1,0,1,0,0,3,1352,17.01
6548,1,4,0,1,0,0,6,11521,68.36
6549,1,3,0,1,0,0,5,8690,54.42
6550,1,4,0,1,0,0,6,11521,68.36
6551,1,0,0,1,0,0,2,32,3.72
6552,1,4,0,1,1,0,7,13868,78.23
6553,1,3,0,1,0,0,5,8690,54.42
6554,1,4,1,1,0,0,7,13868,78.23
6555,1,3,0,1,0,0,5,8690,54.42
6556,1,4,1,1,0,0,7,13868,78.23
6557,1,0,0,1,0,0,2,32,3.72
6558,1,3,1,1,0,0,6,11521,68.36
6559,1,2,0,1,0,0,4,4966,36.77
6560,1,0,1,1,0,0,3,1352,17.01
6561,1,2,2,1,0,0,6,11521,68.36
6562,1,1,0,1,0,0,3,1352,17.01
6563,1,0,3,1,0,0,5,8690,54.42
6564,1,3,1,1,0,0,6,11521,68.36
6565,1,3,0,1,0,0,5,8690,54.42
6566,1,1,2,1,0,0,5,8690,54.42
6567,1,0,0,1,0,0,2,32,3.72
6568,1,1,0,1,0,0,3,1352,17.01
6569,1,0,1,1,0,0,3,1352,17.01
6570,1,1,2,1,0,0,5,8690,54.42
6571,1,3,0,1,0,0,5,8690,54.42
6572,1,2,1,1,0,0,5,8690,54.42
6573,1,0,1,1,0,0,3,1352,17.01
6574,1,1,2,1,0,0,5,8690,54.42
6575,1,2,0,1,0,0,4,4966,36.77
6576,1,0,0,1,0,0,2,32,3.72
6577,1,0,3,1,1,0,6,11521,68.36
6578,1,1,0,1,0,0,3,1352,17.01
6579,1,4,0,1,0,0,6,11521,68.36
6580,1,3,0,1,0,0,5,8690,54.42
6581,1,3,1,1,0,0,6,11521,68.36
6582,1,0,1,1,0,0,3,1352,17.01
6583,1,1,1,1,0,0,4,4966,36.77
6584,1,0,2,1,0,0,4,4966,36.77
6585,1,0,1,1,2,0,5,8690,54.42
6586,1,1,1,1,0,0,4,4966,36.77
6587,1,1,1,1,0,0,4,4966,36.77
6588,1,2,0,1,0,0,4,4966,36.77
6589,1,2,0,1,0,0,4,4966,36.77
6590,1,0,2,2,0,0,5,8690,54.42
6591,1,0,1,1,0,0,3,1352,17.01
6592,1,0,0,1,0,0,2,32,3.72
6593,1,2,1,1,0,0,5,8690,54.42
6594,1,4,2,1,0,0,8,15186,83.84
6595,1,3,2,1,0,0,7,13868,78.23
6596,1,2,2,1,0,0,6,11521,68.36
6597,1,0,1,1,0,0,3,1352,17.01
6598,1,2,0,1,0,0,4,4966,36.77
6599,1,1,0,1,0,0,3,1352,17.01
6600,3,0,4,1,2,0,10,16522,90.12
6601,3,0,3,1,1,0,8,15186,83.84
6602,1,0,2,2,1,0,6,11521,68.36
6603,1,0,1,2,1,0,5,8690,54.42
6604,1,0,1,2,1,0,5,8690,54.42
6605,1,0,2,2,1,0,6,11521,68.36
6606,1,0,1,2,1,0,5,8690,54.42
6607,1,0,1,2,1,0,5,8690,54.42
6608,1,1,0,1,0,0,3,1352,17.01
6610,1,0,1,1,0,10,13,17456,94.66
6611,3,0,5,2,3,0,13,17456,94.66
6612,1,0,5,2,1,0,9,15950,87.44
6613,3,0,4,1,3,4,15,17888,96.85
6614,1,0,4,2,1,0,8,15186,83.84
6615,1,0,1,0,2,6,10,16522,90.12
6616,1,0,2,0,1,0,4,4966,36.77
6617,3,0,5,5,4,0,17,18193,98.23
6618,1,0,2,1,1,4,9,15950,87.44
6619,1,0,1,1,0,6,9,15950,87.44
6620,1,1,1,1,1,0,5,8690,54.42
6621,1,1,2,1,1,0,6,11521,68.36
6622,1,0,2,1,1,4,9,15950,87.44
6623,4,0,5,1,5,0,15,17888,96.85
6624,1,1,1,1,0,0,4,4966,36.77
6625,3,5,5,3,5,0,21,18462,99.52
6626,1,0,2,2,2,0,7,13868,78.23
6627,1,3,0,1,0,0,5,8690,54.42
6628,1,0,0,1,0,0,2,32,3.72
6629,1,4,1,1,0,0,7,13868,78.23
6630,1,3,1,1,0,0,6,11521,68.36
6631,1,4,1,1,0,0,7,13868,78.23
6632,1,4,0,1,0,0,6,11521,68.36
6633,1,4,1,1,2,0,9,15950,87.44
6634,1,4,0,1,2,0,8,15186,83.84
6635,1,4,1,1,0,0,7,13868,78.23
6636,1,2,0,1,0,0,4,4966,36.77
6637,1,2,0,1,0,0,4,4966,36.77
6638,1,4,1,1,0,0,7,13868,78.23
6639,1,4,0,1,0,0,6,11521,68.36
6640,1,4,0,1,2,0,8,15186,83.84
6641,1,4,0,1,0,0,6,11521,68.36
6642,1,4,0,1,0,0,6,11521,68.36
6643,1,4,0,1,0,0,6,11521,68.36
6644,1,0,0,1,0,0,2,32,3.72
6645,1,1,0,1,1,0,4,4966,36.77
6646,1,0,2,1,3,0,7,13868,78.23
6647,1,2,0,1,0,0,4,4966,36.77
6648,1,2,0,1,0,0,4,4966,36.77
6649,1,1,2,2,0,0,6,11521,68.36
6650,1,2,0,1,2,0,6,11521,68.36
6651,1,2,0,1,2,0,6,11521,68.36
6652,1,1,0,1,0,0,3,1352,17.01
6653,1,1,0,1,0,0,3,1352,17.01
6654,1,3,0,1,0,0,5,8690,54.42
6655,1,2,0,1,0,0,4,4966,36.77
6656,1,2,0,1,0,0,4,4966,36.77
6657,1,5,1,1,0,0,8,15186,83.84
6658,1,5,3,2,0,0,11,16947,91.91
6659,1,5,1,1,0,0,8,15186,83.84
6660,1,0,0,1,0,0,2,32,3.72
6661,1,4,0,1,0,0,6,11521,68.36
6663,1,4,0,1,0,0,6,11521,68.36
6664,1,4,1,1,0,0,7,13868,78.23
6665,1,4,0,1,0,0,6,11521,68.36
6666,1,4,0,1,0,0,6,11521,68.36
6667,1,1,0,1,0,0,3,1352,17.01
6668,1,0,2,1,0,0,4,4966,36.77
6670,3,0,5,1,1,0,10,16522,90.12
6671,1,1,1,1,0,0,4,4966,36.77
6672,1,4,1,1,0,0,7,13868,78.23
6673,1,4,0,1,0,0,6,11521,68.36
6674,1,1,0,1,0,0,3,1352,17.01
6675,1,0,1,1,0,0,3,1352,17.01
6676,1,1,0,1,0,0,3,1352,17.01
6677,3,0,4,2,3,2,14,17699,95.82
6678,1,0,0,1,0,0,2,32,3.72
6679,1,1,2,1,0,0,5,8690,54.42
6680,1,1,3,3,1,0,9,15950,87.44
6681,1,0,2,1,0,6,10,16522,90.12
6682,1,0,2,1,0,0,4,4966,36.77
6683,1,0,2,1,0,0,4,4966,36.77
6684,1,5,0,1,0,0,7,13868,78.23
6685,1,3,0,1,0,0,5,8690,54.42
6686,1,1,0,1,0,0,3,1352,17.01
6687,1,4,0,1,0,0,6,11521,68.36
6688,1,4,0,1,0,0,6,11521,68.36
6689,1,4,0,1,0,0,6,11521,68.36
6690,1,0,1,1,0,0,3,1352,17.01
6692,1,1,1,1,0,0,4,4966,36.77
6693,1,3,1,1,1,0,7,13868,78.23
6694,1,3,1,1,0,0,6,11521,68.36
6695,1,1,2,1,2,0,7,13868,78.23
6696,1,1,2,1,2,0,7,13868,78.23
6697,1,3,0,1,0,0,5,8690,54.42
6698,1,3,3,2,0,0,9,15950,87.44
6699,1,1,1,1,0,0,4,4966,36.77
6700,1,0,1,1,0,0,3,1352,17.01
6701,1,1,1,1,1,0,5,8690,54.42
6702,1,2,1,1,0,0,5,8690,54.42
6703,1,2,2,1,0,0,6,11521,68.36
6704,1,3,1,1,0,0,6,11521,68.36
6705,3,0,3,1,2,10,19,18362,99.04
6706,1,2,1,1,0,0,5,8690,54.42
6707,4,0,5,2,5,10,26,18556,99.96
6708,1,0,2,1,2,10,16,18081,97.67
6709,1,1,1,1,0,4,8,15186,83.84
6710,1,0,3,1,0,6,11,16947,91.91
6713,1,1,2,1,0,0,5,8690,54.42
6714,1,3,1,1,1,0,7,13868,78.23
6715,1,3,1,2,0,0,7,13868,78.23
6716,1,2,1,2,0,0,6,11521,68.36
6717,1,3,0,1,0,0,5,8690,54.42
6718,1,0,1,1,0,0,3,1352,17.01
6719,1,4,0,1,0,0,6,11521,68.36
6720,1,3,1,1,1,0,7,13868,78.23
6721,3,0,5,2,3,0,13,17456,94.66
6722,1,1,0,1,0,0,3,1352,17.01
6723,1,3,1,2,0,0,7,13868,78.23
6724,1,2,1,1,0,0,5,8690,54.42
6727,1,4,0,1,0,0,6,11521,68.36
6728,1,1,2,1,0,0,5,8690,54.42
6730,1,0,2,1,1,0,5,8690,54.42
6731,1,1,0,1,0,0,3,1352,17.01
6732,1,3,1,2,0,0,7,13868,78.23
6735,1,0,0,1,0,0,2,32,3.72
6736,1,0,2,1,3,0,7,13868,78.23
6737,1,1,1,1,0,0,4,4966,36.77
6738,1,2,0,1,0,0,4,4966,36.77
6739,1,0,0,1,0,0,2,32,3.72
6740,1,4,0,1,0,0,6,11521,68.36
6741,1,2,0,1,0,0,4,4966,36.77
6742,1,0,0,1,0,0,2,32,3.72
6743,1,1,0,1,0,0,3,1352,17.01
6744,1,1,0,1,0,0,3,1352,17.01
6745,1,2,0,1,0,0,4,4966,36.77
6746,1,2,0,1,0,0,4,4966,36.77
6747,1,2,0,2,0,0,5,8690,54.42
6748,1,3,0,1,0,0,5,8690,54.42
6749,1,4,0,1,0,0,6,11521,68.36
6750,1,1,0,1,0,0,3,1352,17.01
6751,1,1,0,1,0,0,3,1352,17.01
6752,1,0,2,1,2,8,14,17699,95.82
6753,1,2,0,1,0,0,4,4966,36.77
6755,1,4,0,1,2,0,8,15186,83.84
6756,1,1,0,1,0,0,3,1352,17.01
6757,1,0,0,1,0,0,2,32,3.72
6758,1,4,2,2,0,0,9,15950,87.44
6759,1,0,0,1,0,0,2,32,3.72
6760,3,0,5,2,3,0,13,17456,94.66
6761,1,3,1,1,0,0,6,11521,68.36
6762,1,1,1,1,0,0,4,4966,36.77
6763,1,3,0,1,0,0,5,8690,54.42
6764,4,0,5,2,5,6,22,18498,99.73
6765,3,0,4,2,3,10,22,18498,99.73
6766,1,0,1,1,1,0,4,4966,36.77
6767,1,2,0,1,0,0,4,4966,36.77
6768,1,2,2,1,0,0,6,11521,68.36
6769,3,3,5,3,3,0,17,18193,98.23
6771,1,0,3,1,1,10,16,18081,97.67
6772,4,0,5,2,5,10,26,18556,99.96
6773,1,3,0,1,0,0,5,8690,54.42
6774,1,0,2,1,2,2,8,15186,83.84
6775,1,4,1,2,0,0,8,15186,83.84
6776,3,0,4,3,3,0,13,17456,94.66
6777,1,1,0,1,0,0,3,1352,17.01
6778,1,0,2,2,4,0,9,15950,87.44
6779,1,0,0,1,0,0,2,32,3.72
6780,1,2,0,1,0,0,4,4966,36.77
6781,1,0,3,1,0,6,11,16947,91.91
6782,1,2,2,1,0,0,6,11521,68.36
6783,1,1,1,1,0,0,4,4966,36.77
6784,1,2,1,1,0,0,5,8690,54.42
6785,1,2,0,1,0,0,4,4966,36.77
6786,1,1,0,1,0,0,3,1352,17.01
6787,1,4,1,2,0,0,8,15186,83.84
6788,1,1,3,1,0,0,6,11521,68.36
6789,1,3,1,1,0,0,6,11521,68.36
6790,1,1,0,1,0,0,3,1352,17.01
6791,1,1,0,1,0,0,3,1352,17.01
6792,1,1,0,1,0,0,3,1352,17.01
6793,1,0,2,2,2,0,7,13868,78.23
6795,1,3,2,1,0,0,7,13868,78.23
6797,1,5,1,1,0,0,8,15186,83.84
6798,1,1,0,1,0,0,3,1352,17.01
6799,1,4,0,1,0,0,6,11521,68.36
6800,1,2,2,1,1,0,7,13868,78.23
6801,1,2,2,2,0,0,7,13868,78.23
6804,1,1,1,1,0,0,4,4966,36.77
6806,1,1,0,1,0,0,3,1352,17.01
6807,1,1,1,1,0,0,4,4966,36.77
6808,1,0,2,1,4,0,8,15186,83.84
6809,1,0,3,1,0,0,5,8690,54.42
6810,1,1,2,1,0,0,5,8690,54.42
6811,1,0,0,1,0,0,2,32,3.72
6812,1,0,2,2,2,0,7,13868,78.23
6813,1,4,1,1,1,0,8,15186,83.84
6814,1,2,0,1,1,0,5,8690,54.42
6815,1,4,0,1,0,0,6,11521,68.36
6816,1,4,0,1,0,0,6,11521,68.36
6817,1,4,0,1,0,0,6,11521,68.36
6819,1,1,1,1,0,0,4,4966,36.77
6820,1,4,0,1,0,0,6,11521,68.36
6821,1,4,1,1,0,0,7,13868,78.23
6822,1,4,0,1,3,0,9,15950,87.44
20000,1,4,0,1,0,0,6,11521,68.36
20001,1,4,0,1,3,0,9,15950,87.44
20002,1,4,0,1,0,0,6,11521,68.36
20003,1,0,2,1,0,0,4,4966,36.77
20004,1,3,1,1,0,0,6,11521,68.36
20005,1,0,1,1,0,0,3,1352,17.01
20006,1,2,1,1,0,0,5,8690,54.42
20007,1,0,2,1,0,0,4,4966,36.77
20008,1,1,1,1,0,0,4,4966,36.77
20009,1,0,0,1,0,0,2,32,3.72
20010,1,1,1,1,0,0,4,4966,36.77
20011,1,0,1,1,0,0,3,1352,17.01
20012,1,0,3,2,3,8,17,18193,98.23
20013,1,3,0,1,0,0,5,8690,54.42
20014,1,5,0,1,0,0,7,13868,78.23
20015,1,4,0,1,0,0,6,11521,68.36
20016,1,4,0,1,0,0,6,11521,68.36
20017,1,4,0,1,0,0,6,11521,68.36
20018,1,4,0,1,0,0,6,11521,68.36
20019,1,3,0,1,0,0,5,8690,54.42
20020,1,2,0,1,0,0,4,4966,36.77
20021,1,2,4,2,0,0,9,15950,87.44
20022,1,1,0,1,0,0,3,1352,17.01
20023,1,0,0,1,0,0,2,32,3.72
20024,1,0,2,1,0,0,4,4966,36.77
20025,1,0,1,1,0,0,3,1352,17.01
20026,1,2,1,1,0,0,5,8690,54.42
20027,1,2,0,1,0,0,4,4966,36.77
20028,1,1,1,1,0,0,4,4966,36.77
20029,1,1,0,1,0,0,3,1352,17.01
20030,1,3,0,1,0,0,5,8690,54.42
20031,1,4,0,1,0,0,6,11521,68.36
20032,1,0,0,1,0,0,2,32,3.72
20033,1,0,0,1,0,6,8,15186,83.84
20034,1,0,1,1,0,0,3,1352,17.01
20035,1,0,1,1,0,0,3,1352,17.01
20036,1,0,4,1,0,0,6,11521,68.36
20037,1,0,4,1,0,0,6,11521,68.36
20038,1,0,0,0,0,0,1,1,0.08
20039,1,0,2,1,0,0,4,4966,36.77
20040,1,1,1,1,0,0,4,4966,36.77
20041,1,0,1,1,0,0,3,1352,17.01
20042,1,0,1,1,0,0,3,1352,17.01
20043,1,1,1,1,0,0,4,4966,36.77
20044,1,0,1,1,0,0,3,1352,17.01
20045,1,1,0,1,0,0,3,1352,17.01
20046,1,3,0,1,0,0,5,8690,54.42
20047,1,1,0,1,0,0,3,1352,17.01
20048,1,0,0,1,0,0,2,32,3.72
20049,1,0,0,1,0,0,2,32,3.72
20050,1,0,0,1,0,0,2,32,3.72
20051,1,1,0,1,0,0,3,1352,17.01
20052,1,4,1,1,0,0,7,13868,78.23
20053,1,0,2,1,0,0,4,4966,36.77
20054,1,0,2,1,0,10,14,17699,95.82
20055,1,2,2,1,0,0,6,11521,68.36
20056,3,1,5,1,2,0,12,17186,93.28
20057,1,3,0,1,0,0,5,8690,54.42
20058,1,1,1,1,0,0,4,4966,36.77
20059,1,0,1,1,0,0,3,1352,17.01
20060,1,0,1,1,0,0,3,1352,17.01
20061,1,1,4,1,0,0,7,13868,78.23
20062,1,0,1,1,0,6,9,15950,87.44
20063,1,0,3,1,0,0,5,8690,54.42
20064,1,1,1,1,0,0,4,4966,36.77
20065,1,3,2,1,0,0,7,13868,78.23
20066,1,2,0,1,0,0,4,4966,36.77
20067,1,2,0,1,0,0,4,4966,36.77
20068,1,0,1,1,0,0,3,1352,17.01
20069,1,0,1,1,0,0,3,1352,17.01
20070,1,0,0,1,0,0,2,32,3.72
20071,1,2,0,1,0,0,4,4966,36.77
20072,1,0,3,1,1,4,10,16522,90.12
20073,1,1,1,1,0,0,4,4966,36.77
20074,1,0,1,1,0,0,3,1352,17.01
20075,1,5,0,1,0,0,7,13868,78.23
20076,1,2,1,1,0,0,5,8690,54.42
20077,1,2,2,1,0,0,6,11521,68.36
20078,1,4,0,1,0,0,6,11521,68.36
20079,1,4,1,1,0,0,7,13868,78.23
20080,1,0,1,1,0,0,3,1352,17.01
20081,1,0,1,1,0,0,3,1352,17.01
20082,1,0,1,1,0,0,3,1352,17.01
20083,1,0,1,1,0,0,3,1352,17.01
20084,1,2,2,1,2,0,8,15186,83.84
20085,1,1,1,1,0,0,4,4966,36.77
20086,1,1,1,1,0,0,4,4966,36.77
20087,1,0,1,1,0,0,3,1352,17.01
20088,1,0,0,1,0,0,2,32,3.72
20089,1,0,3,2,0,0,6,11521,68.36
20090,1,0,1,1,0,0,3,1352,17.01
20091,1,4,1,1,0,0,7,13868,78.23
20092,1,0,3,1,3,0,8,15186,83.84
20093,1,0,3,2,3,0,9,15950,87.44
20094,1,1,1,1,0,0,4,4966,36.77
20095,1,1,2,1,0,0,5,8690,54.42
20096,1,0,3,1,3,0,8,15186,83.84
20097,1,1,1,1,0,0,4,4966,36.77
20098,1,1,1,1,0,0,4,4966,36.77
20099,1,1,1,1,0,0,4,4966,36.77
20100,1,3,0,1,0,0,5,8690,54.42
20101,1,2,0,1,0,0,4,4966,36.77
20103,3,0,3,1,3,6,16,18081,97.67
20104,1,1,1,1,0,0,4,4966,36.77
20105,1,3,0,2,0,0,6,11521,68.36
20106,3,1,3,1,2,0,10,16522,90.12
20107,1,4,1,1,0,0,7,13868,78.23
20108,1,0,2,1,1,0,5,8690,54.42
20109,1,2,0,1,0,0,4,4966,36.77
20110,1,0,2,1,1,0,5,8690,54.42
20111,1,0,3,2,3,0,9,15950,87.44
20112,1,1,1,1,0,0,4,4966,36.77
20113,1,2,1,1,0,0,5,8690,54.42
20114,1,1,0,1,0,0,3,1352,17.01
20115,1,0,1,1,0,2,5,8690,54.42
20116,1,1,4,1,0,0,7,13868,78.23
20117,1,2,3,1,0,0,7,13868,78.23
20118,1,0,2,0,1,0,4,4966,36.77
20119,1,4,0,1,0,0,6,11521,68.36
20120,1,1,1,1,0,0,4,4966,36.77
20121,1,0,1,1,0,0,3,1352,17.01
20122,1,0,0,1,0,0,2,32,3.72
20123,1,5,0,1,0,0,7,13868,78.23
20124,1,2,1,1,0,0,5,8690,54.42
20125,1,0,1,1,0,0,3,1352,17.01
20126,1,1,1,1,0,0,4,4966,36.77
20127,1,0,2,1,0,0,4,4966,36.77
20128,3,0,3,2,4,0,12,17186,93.28
20129,1,0,1,1,1,0,4,4966,36.77
20130,1,0,0,1,0,0,2,32,3.72
20131,1,0,1,0,0,0,2,32,3.72
20132,1,0,1,1,0,0,3,1352,17.01
20133,1,1,0,1,0,0,3,1352,17.01
20134,1,0,1,1,0,0,3,1352,17.01
20135,1,1,0,1,0,0,3,1352,17.01
20136,1,4,2,1,0,0,8,15186,83.84
20137,1,4,2,1,0,0,8,15186,83.84
20138,1,2,2,1,0,0,6,11521,68.36
20139,1,1,0,1,0,0,3,1352,17.01
20140,1,0,3,1,0,0,5,8690,54.42
20141,1,0,0,1,0,0,2,32,3.72
20142,1,3,0,1,0,0,5,8690,54.42
20143,1,0,2,1,0,0,4,4966,36.77
20144,1,0,3,1,0,0,5,8690,54.42
20145,1,4,0,1,0,0,6,11521,68.36
20146,1,0,1,1,0,0,3,1352,17.01
20147,1,0,0,1,0,0,2,32,3.72
20148,1,3,1,1,0,0,6,11521,68.36
20149,1,0,1,1,0,0,3,1352,17.01
20150,1,1,1,1,0,0,4,4966,36.77
20151,1,2,1,1,0,0,5,8690,54.42
20152,1,1,0,1,0,0,3,1352,17.01
20153,1,0,0,1,0,0,2,32,3.72
20154,1,1,3,1,0,0,6,11521,68.36
20155,1,0,0,1,0,0,2,32,3.72
20156,1,3,1,1,0,0,6,11521,68.36
20157,1,1,1,1,0,0,4,4966,36.77
20158,1,2,1,1,0,0,5,8690,54.42
20159,1,0,4,1,0,0,6,11521,68.36
20160,1,3,2,1,0,0,7,13868,78.23
20161,1,2,2,1,0,0,6,11521,68.36
20162,1,4,2,1,0,0,8,15186,83.84
20163,1,1,0,1,0,0,3,1352,17.01
20164,1,0,1,1,0,0,3,1352,17.01
20165,1,0,0,1,0,0,2,32,3.72
20166,1,0,0,1,0,0,2,32,3.72
20167,1,0,4,2,0,0,7,13868,78.23
20168,1,0,1,1,0,0,3,1352,17.01
20169,1,2,1,1,0,0,5,8690,54.42
20170,1,0,0,1,0,0,2,32,3.72
20171,1,4,0,1,0,0,6,11521,68.36
20172,1,1,2,1,0,0,5,8690,54.42
20173,1,1,1,1,0,6,10,16522,90.12
20174,1,0,1,1,0,0,3,1352,17.01
20175,1,4,0,1,0,0,6,11521,68.36
20176,1,2,1,1,0,0,5,8690,54.42
20177,1,0,3,1,2,0,7,13868,78.23
20178,3,0,4,1,3,6,17,18193,98.23
20179,1,1,1,1,0,0,4,4966,36.77
20180,1,1,1,1,0,0,4,4966,36.77
20181,1,1,0,1,0,0,3,1352,17.01
20182,1,0,1,1,0,0,3,1352,17.01
20183,1,0,1,1,0,0,3,1352,17.01
20184,1,0,0,1,0,0,2,32,3.72
20185,1,1,4,2,0,0,8,15186,83.84
20186,1,0,1,1,0,0,3,1352,17.01
20187,1,1,1,1,0,0,4,4966,36.77
20188,1,0,2,1,1,0,5,8690,54.42
20189,1,0,3,1,2,0,7,13868,78.23
20190,1,0,3,1,0,0,5,8690,54.42
20191,1,0,2,1,0,0,4,4966,36.77
20192,1,0,1,1,0,6,9,15950,87.44
20193,1,0,2,1,0,0,4,4966,36.77
20194,1,2,2,1,0,0,6,11521,68.36
20195,1,0,4,1,0,0,6,11521,68.36
20196,1,4,0,1,0,0,6,11521,68.36
20197,1,0,0,1,0,6,8,15186,83.84
20198,1,2,0,1,0,0,4,4966,36.77
20199,1,1,1,1,0,0,4,4966,36.77
20200,1,0,3,1,1,0,6,11521,68.36
20201,1,0,1,1,0,0,3,1352,17.01
20202,1,1,0,0,0,0,2,32,3.72
20203,1,0,2,1,0,0,4,4966,36.77
20204,1,0,2,1,0,0,4,4966,36.77
20205,1,0,1,1,0,0,3,1352,17.01
20206,1,1,3,1,0,0,6,11521,68.36
20207,1,0,1,1,0,0,3,1352,17.01
20208,1,4,1,1,0,0,7,13868,78.23
20209,1,0,1,1,0,0,3,1352,17.01
20210,1,0,1,1,0,0,3,1352,17.01
20211,1,2,0,1,0,0,4,4966,36.77
20212,1,0,1,1,0,6,9,15950,87.44
20213,1,2,1,1,0,0,5,8690,54.42
20214,1,1,2,1,0,0,5,8690,54.42
20215,1,0,0,1,0,0,2,32,3.72
20216,1,0,2,1,0,0,4,4966,36.77
20217,1,1,1,1,0,0,4,4966,36.77
20218,1,1,1,1,0,0,4,4966,36.77
20219,1,0,1,1,0,0,3,1352,17.01
20220,1,1,1,1,0,0,4,4966,36.77
20221,1,0,0,1,0,0,2,32,3.72
20222,1,0,1,1,0,0,3,1352,17.01
20223,1,0,2,1,0,0,4,4966,36.77
20224,1,2,2,1,0,0,6,11521,68.36
20225,1,0,1,1,0,0,3,1352,17.01
20226,1,1,2,1,0,0,5,8690,54.42
20227,1,2,1,1,0,0,5,8690,54.42
20228,1,2,1,1,0,0,5,8690,54.42
20229,1,4,0,1,0,0,6,11521,68.36
20230,1,4,0,1,0,0,6,11521,68.36
20231,1,1,0,1,1,0,4,4966,36.77
20232,1,2,0,1,0,0,4,4966,36.77
20233,1,0,1,1,0,0,3,1352,17.01
20234,1,3,3,2,0,0,9,15950,87.44
20235,1,1,3,2,0,0,7,13868,78.23
20236,1,2,1,1,1,0,6,11521,68.36
20237,1,1,2,1,1,0,6,11521,68.36
20238,1,0,2,1,0,0,4,4966,36.77
20239,1,0,0,0,0,0,1,1,0.08
20240,1,3,0,1,2,0,7,13868,78.23
20241,1,0,5,1,0,0,7,13868,78.23
20242,1,0,1,1,0,0,3,1352,17.01
20243,1,1,0,1,0,0,3,1352,17.01
20244,1,1,1,1,0,0,4,4966,36.77
20245,1,3,0,1,0,0,5,8690,54.42
20246,1,1,1,1,0,0,4,4966,36.77
20247,1,0,0,1,0,0,2,32,3.72
20248,1,2,1,1,0,0,5,8690,54.42
20249,1,2,0,1,0,0,4,4966,36.77
20250,1,0,1,1,1,0,4,4966,36.77
20251,1,1,2,1,0,6,11,16947,91.91
20252,1,2,2,1,1,0,7,13868,78.23
20253,1,0,3,1,1,0,6,11521,68.36
20254,1,0,2,1,1,0,5,8690,54.42
20255,1,0,1,1,0,0,3,1352,17.01
20256,1,1,1,1,0,0,4,4966,36.77
20257,1,0,0,1,0,0,2,32,3.72
20258,1,1,2,1,0,0,5,8690,54.42
20259,1,1,1,1,0,0,4,4966,36.77
20260,1,3,1,1,0,0,6,11521,68.36
20261,1,1,0,1,0,0,3,1352,17.01
20262,1,2,0,1,0,0,4,4966,36.77
20263,1,0,4,2,1,0,8,15186,83.84
20264,1,2,0,1,0,0,4,4966,36.77
20265,1,1,3,1,0,0,6,11521,68.36
20266,1,3,2,1,0,0,7,13868,78.23
20267,1,1,0,1,0,0,3,1352,17.01
20268,1,2,0,1,0,0,4,4966,36.77
20269,1,1,1,1,0,0,4,4966,36.77
20270,1,2,0,0,0,0,3,1352,17.01
20271,1,0,0,1,0,0,2,32,3.72
20272,1,4,1,1,0,0,7,13868,78.23
20273,1,3,0,1,0,0,5,8690,54.42
20274,1,0,1,1,0,0,3,1352,17.01
20275,1,0,1,1,0,0,3,1352,17.01
20276,1,2,0,1,0,0,4,4966,36.77
20277,1,1,1,1,1,0,5,8690,54.42
20278,1,0,1,1,0,0,3,1352,17.01
20279,1,0,2,1,0,0,4,4966,36.77
20280,1,0,2,1,0,0,4,4966,36.77
20281,1,0,1,1,0,0,3,1352,17.01
20282,1,1,1,1,0,0,4,4966,36.77
20283,1,3,1,1,0,0,6,11521,68.36
20284,1,0,1,1,0,0,3,1352,17.01
20285,1,3,0,1,0,0,5,8690,54.42
20286,1,0,1,1,0,0,3,1352,17.01
20287,1,2,1,1,0,0,5,8690,54.42
20288,1,3,1,1,0,0,6,11521,68.36
20289,1,1,0,1,0,0,3,1352,17.01
20290,1,2,1,1,0,6,11,16947,91.91
20291,1,5,0,1,0,0,7,13868,78.23
20292,1,0,3,1,0,0,5,8690,54.42
20293,1,3,1,1,0,0,6,11521,68.36
20294,1,0,2,1,0,0,4,4966,36.77
20295,1,0,1,1,0,0,3,1352,17.01
20296,1,1,1,1,0,0,4,4966,36.77
20297,1,0,1,1,0,0,3,1352,17.01
20298,1,0,0,1,0,0,2,32,3.72
20299,1,2,1,1,0,0,5,8690,54.42
20300,1,1,1,1,0,0,4,4966,36.77
20301,1,4,0,1,0,0,6,11521,68.36
20302,1,0,2,1,0,0,4,4966,36.77
20303,1,0,0,1,0,0,2,32,3.72
20304,1,4,0,1,0,0,6,11521,68.36
20305,1,4,0,1,0,0,6,11521,68.36
20306,1,1,1,1,0,0,4,4966,36.77
20307,1,3,0,1,0,0,5,8690,54.42
20308,1,1,2,1,0,0,5,8690,54.42
20309,3,0,5,1,3,10,22,18498,99.73
20310,1,0,0,1,0,0,2,32,3.72
20311,1,3,0,1,0,0,5,8690,54.42
20312,1,1,1,1,0,0,4,4966,36.77
20313,1,3,0,1,0,0,5,8690,54.42
20314,1,4,1,1,0,0,7,13868,78.23
20315,1,1,0,1,0,0,3,1352,17.01
20316,1,0,1,1,0,0,3,1352,17.01
20317,1,2,1,1,0,0,5,8690,54.42
20318,1,0,1,1,0,2,5,8690,54.42
20319,1,0,1,1,0,0,3,1352,17.01
20320,1,1,0,1,0,0,3,1352,17.01
20321,1,0,0,1,0,0,2,32,3.72
20322,1,0,0,1,0,6,8,15186,83.84
20323,1,0,2,1,1,0,5,8690,54.42
20324,1,3,2,1,0,0,7,13868,78.23
20325,1,0,1,1,0,0,3,1352,17.01
20326,1,0,1,1,0,0,3,1352,17.01
20327,1,0,0,1,0,0,2,32,3.72
20328,1,2,4,1,0,0,8,15186,83.84
20329,1,0,3,1,0,0,5,8690,54.42
20330,1,4,1,1,0,0,7,13868,78.23
20331,1,1,1,1,0,0,4,4966,36.77
20332,1,1,0,1,0,0,3,1352,17.01
20333,1,1,0,1,0,0,3,1352,17.01
20334,1,2,0,1,0,0,4,4966,36.77
20335,1,2,0,1,0,0,4,4966,36.77
20336,1,1,0,1,0,0,3,1352,17.01
20337,1,2,1,1,0,0,5,8690,54.42
20338,1,1,0,1,0,0,3,1352,17.01
20339,1,3,0,1,0,0,5,8690,54.42
20340,1,1,4,2,0,6,14,17699,95.82
20341,1,0,1,1,0,4,7,13868,78.23
20342,1,0,0,1,0,0,2,32,3.72
20343,1,2,0,1,0,0,4,4966,36.77
20344,1,4,2,1,0,0,8,15186,83.84
20345,1,0,1,1,0,0,3,1352,17.01
20346,1,0,2,1,0,0,4,4966,36.77
20347,1,1,0,1,0,0,3,1352,17.01
20348,1,1,1,1,0,0,4,4966,36.77
20349,1,0,3,1,0,2,7,13868,78.23
20350,1,0,3,1,0,0,5,8690,54.42
20351,1,1,2,1,0,0,5,8690,54.42
20352,1,1,1,1,0,0,4,4966,36.77
20353,1,0,0,1,0,0,2,32,3.72
20354,1,2,1,1,1,0,6,11521,68.36
20355,1,0,2,1,0,0,4,4966,36.77
20356,1,2,1,1,0,0,5,8690,54.42
20357,1,0,3,1,0,0,5,8690,54.42
20358,1,0,2,1,0,0,4,4966,36.77
20359,1,2,0,1,0,0,4,4966,36.77
20360,1,0,1,1,0,0,3,1352,17.01
20361,1,1,0,1,0,0,3,1352,17.01
20362,1,1,0,1,0,0,3,1352,17.01
20363,1,1,4,1,0,6,13,17456,94.66
20364,1,1,4,2,1,0,9,15950,87.44
20365,1,3,1,1,0,0,6,11521,68.36
20366,1,0,1,1,0,0,3,1352,17.01
20367,1,0,0,1,0,0,2,32,3.72
20368,1,0,1,1,0,0,3,1352,17.01
20369,1,1,0,1,0,0,3,1352,17.01
20370,1,2,0,1,0,0,4,4966,36.77
20371,1,0,2,2,1,0,6,11521,68.36
20372,1,0,4,2,1,0,8,15186,83.84
20373,1,3,1,1,0,0,6,11521,68.36
20374,1,0,1,1,0,0,3,1352,17.01
20375,1,1,0,1,0,0,3,1352,17.01
20376,1,0,1,1,0,0,3,1352,17.01
20377,1,1,0,1,0,0,3,1352,17.01
20378,1,0,1,1,0,6,9,15950,87.44
20379,1,1,0,1,0,0,3,1352,17.01
20380,1,0,0,1,0,0,2,32,3.72
20381,1,0,4,1,1,0,7,13868,78.23
20382,1,4,0,1,0,0,6,11521,68.36
20383,1,0,1,1,0,0,3,1352,17.01
20384,1,3,1,1,0,0,6,11521,68.36
20385,1,1,1,1,0,0,4,4966,36.77
20386,1,4,0,1,0,0,6,11521,68.36
20387,1,1,1,1,0,0,4,4966,36.77
20388,1,0,1,1,0,0,3,1352,17.01
20389,1,3,0,1,0,0,5,8690,54.42
20390,1,2,1,1,0,0,5,8690,54.42
20391,1,3,1,1,0,0,6,11521,68.36
20392,1,3,1,1,0,0,6,11521,68.36
20393,1,0,1,1,0,0,3,1352,17.01
20394,3,1,4,1,1,0,10,16522,90.12
20395,1,1,1,1,0,0,4,4966,36.77
20396,1,0,0,1,0,0,2,32,3.72
20397,1,4,0,1,0,0,6,11521,68.36
20398,1,0,1,1,0,0,3,1352,17.01
20399,1,2,1,1,0,0,5,8690,54.42
20400,1,2,0,1,0,0,4,4966,36.77
20401,1,0,3,1,1,0,6,11521,68.36
20402,1,0,2,1,0,0,4,4966,36.77
20403,1,2,2,1,0,0,6,11521,68.36
20404,1,1,0,1,0,0,3,1352,17.01
20405,1,1,1,1,0,0,4,4966,36.77
20406,1,0,0,1,0,0,2,32,3.72
20407,1,1,1,1,0,0,4,4966,36.77
20408,1,1,1,1,0,0,4,4966,36.77
20409,1,0,1,1,0,0,3,1352,17.01
20410,1,0,1,1,0,0,3,1352,17.01
20411,1,2,1,1,0,0,5,8690,54.42
20412,1,2,0,1,0,0,4,4966,36.77
20413,1,2,0,1,0,0,4,4966,36.77
20414,1,2,1,1,0,0,5,8690,54.42
20415,1,0,1,1,0,0,3,1352,17.01
20416,1,3,1,1,0,0,6,11521,68.36
20417,1,0,0,1,0,0,2,32,3.72
20418,1,3,1,1,0,0,6,11521,68.36
20419,1,0,2,1,0,0,4,4966,36.77
20420,1,0,2,1,1,0,5,8690,54.42
20421,1,3,1,1,0,0,6,11521,68.36
20422,1,4,1,1,0,0,7,13868,78.23
20423,1,3,1,1,0,0,6,11521,68.36
20424,1,4,1,1,0,0,7,13868,78.23
20425,1,5,0,1,0,0,7,13868,78.23
20426,1,2,0,1,0,0,4,4966,36.77
20427,1,4,0,1,0,0,6,11521,68.36
20428,1,0,2,1,0,0,4,4966,36.77
20429,1,3,1,1,0,0,6,11521,68.36
20430,1,1,1,1,0,0,4,4966,36.77
20431,1,3,0,1,0,0,5,8690,54.42
20432,1,1,0,1,0,0,3,1352,17.01
20433,1,2,2,1,0,0,6,11521,68.36
20434,1,4,1,1,0,0,7,13868,78.23
20435,1,0,1,1,2,0,5,8690,54.42
20436,1,1,0,1,0,0,3,1352,17.01
20437,1,1,0,1,0,0,3,1352,17.01
20438,1,2,0,1,0,0,4,4966,36.77
20439,1,0,0,1,0,0,2,32,3.72
20440,1,0,1,1,0,0,3,1352,17.01
20441,1,1,1,1,0,0,4,4966,36.77
20442,1,3,1,1,0,0,6,11521,68.36
20443,1,1,0,1,0,0,3,1352,17.01
20444,1,2,0,1,0,0,4,4966,36.77
20445,1,2,0,1,0,0,4,4966,36.77
20446,1,0,1,1,0,0,3,1352,17.01
20447,1,1,1,1,0,0,4,4966,36.77
20448,1,1,1,1,0,0,4,4966,36.77
20449,1,0,1,1,0,0,3,1352,17.01
20450,1,2,1,1,0,6,11,16947,91.91
20451,1,5,1,1,0,0,8,15186,83.84
20452,1,0,1,1,0,0,3,1352,17.01
20453,1,2,1,1,0,0,5,8690,54.42
20454,1,1,1,1,1,0,5,8690,54.42
20455,1,4,0,1,0,0,6,11521,68.36
20456,1,0,0,1,0,0,2,32,3.72
20457,1,4,0,1,0,0,6,11521,68.36
20458,1,1,1,1,0,0,4,4966,36.77
20459,1,2,1,1,0,0,5,8690,54.42
20460,1,0,2,1,0,0,4,4966,36.77
20461,1,1,1,1,0,0,4,4966,36.77
20462,1,4,1,1,0,0,7,13868,78.23
20463,1,3,0,1,0,0,5,8690,54.42
20464,1,2,1,1,1,0,6,11521,68.36
20465,1,0,2,1,0,0,4,4966,36.77
20466,1,3,2,1,0,0,7,13868,78.23
20467,1,4,0,1,0,0,6,11521,68.36
20468,1,0,1,1,0,0,3,1352,17.01
20469,1,0,1,1,0,0,3,1352,17.01
20470,1,0,1,1,0,0,3,1352,17.01
20471,1,2,1,1,0,0,5,8690,54.42
20472,1,1,1,1,0,0,4,4966,36.77
20473,1,0,1,1,0,0,3,1352,17.01
20474,1,1,3,1,0,0,6,11521,68.36
20475,1,1,0,1,0,0,3,1352,17.01
20476,1,0,0,1,0,0,2,32,3.72
20477,1,1,2,1,0,0,5,8690,54.42
20478,1,2,1,1,0,0,5,8690,54.42
20479,1,2,1,1,0,0,5,8690,54.42
20480,1,3,1,1,0,0,6,11521,68.36
20481,1,1,1,1,0,0,4,4966,36.77
20482,1,1,2,1,0,0,5,8690,54.42
20483,1,0,2,1,1,0,5,8690,54.42
20484,1,1,0,1,0,0,3,1352,17.01
20486,1,4,4,1,0,0,10,16522,90.12
20487,1,3,0,1,0,0,5,8690,54.42
20488,1,2,1,1,0,0,5,8690,54.42
20489,1,3,1,1,0,0,6,11521,68.36
20490,1,3,0,1,0,0,5,8690,54.42
20491,1,0,1,1,0,0,3,1352,17.01
20492,1,1,1,1,0,0,4,4966,36.77
20493,1,1,2,1,0,0,5,8690,54.42
20494,1,0,3,1,1,0,6,11521,68.36
20495,1,3,1,1,0,0,6,11521,68.36
20496,1,0,2,1,0,8,12,17186,93.28
20497,1,2,0,1,0,0,4,4966,36.77
20498,1,0,1,1,0,0,3,1352,17.01
20499,1,0,3,1,0,0,5,8690,54.42
20500,1,1,0,1,0,0,3,1352,17.01
20501,1,1,2,1,0,0,5,8690,54.42
20502,1,3,1,1,0,0,6,11521,68.36
20503,4,0,5,2,5,0,16,18081,97.67
20504,1,0,2,1,0,0,4,4966,36.77
20505,1,2,1,1,0,0,5,8690,54.42
20506,1,0,1,1,0,0,3,1352,17.01
20507,1,0,3,2,1,0,7,13868,78.23
20508,1,3,2,1,0,0,7,13868,78.23
20509,1,1,2,1,0,6,11,16947,91.91
20510,1,0,0,1,1,6,9,15950,87.44
20511,1,4,1,1,0,0,7,13868,78.23
20512,1,0,0,1,0,0,2,32,3.72
20513,1,2,1,1,0,0,5,8690,54.42
20514,1,2,0,1,0,0,4,4966,36.77
20515,1,0,1,1,0,0,3,1352,17.01
20516,1,4,0,1,0,0,6,11521,68.36
20517,1,4,0,1,0,0,6,11521,68.36
20518,1,1,0,1,0,0,3,1352,17.01
20519,1,0,1,1,0,0,3,1352,17.01
20520,1,3,1,1,0,6,12,17186,93.28
20521,1,1,0,1,0,0,3,1352,17.01
20522,1,0,1,1,0,0,3,1352,17.01
20523,1,2,1,1,0,0,5,8690,54.42
20524,1,1,2,1,0,0,5,8690,54.42
20525,1,0,2,1,0,0,4,4966,36.77
20526,1,2,1,1,0,0,5,8690,54.42
20527,1,0,1,1,0,0,3,1352,17.01
20528,1,0,0,1,0,0,2,32,3.72
20529,1,4,0,1,0,0,6,11521,68.36
20530,1,1,1,1,0,0,4,4966,36.77
20531,1,1,1,1,0,0,4,4966,36.77
20532,1,4,0,1,0,0,6,11521,68.36
20533,1,2,1,1,0,0,5,8690,54.42
20534,1,0,0,1,0,4,6,11521,68.36
20535,1,0,1,1,0,0,3,1352,17.01
20536,1,2,1,1,0,0,5,8690,54.42
20537,1,0,2,1,0,0,4,4966,36.77
20538,1,0,2,1,1,0,5,8690,54.42
20539,1,0,1,1,0,0,3,1352,17.01
20540,1,1,0,1,0,0,3,1352,17.01
20541,1,1,1,1,0,0,4,4966,36.77
20542,1,0,1,1,0,0,3,1352,17.01
20543,1,1,0,1,0,0,3,1352,17.01
20544,1,3,0,1,0,0,5,8690,54.42
20545,1,0,2,1,0,6,10,16522,90.12
20546,1,2,1,1,0,0,5,8690,54.42
20547,1,0,4,1,0,0,6,11521,68.36
20548,1,5,1,1,0,0,8,15186,83.84
20549,1,3,1,1,0,0,6,11521,68.36
20550,1,0,2,1,1,0,5,8690,54.42
20551,1,0,1,1,0,0,3,1352,17.01
20552,1,0,2,1,0,6,10,16522,90.12
20553,1,4,0,1,0,0,6,11521,68.36
20554,1,3,0,1,0,0,5,8690,54.42
20555,1,2,1,1,0,0,5,8690,54.42
20556,1,1,1,1,0,0,4,4966,36.77
20557,1,1,1,1,0,0,4,4966,36.77
20558,3,0,5,1,3,4,16,18081,97.67
20559,1,3,0,1,0,0,5,8690,54.42
20560,1,0,2,1,0,0,4,4966,36.77
20561,1,0,0,0,0,0,1,1,0.08
20562,1,2,0,1,0,0,4,4966,36.77
20563,1,0,1,1,0,0,3,1352,17.01
20564,1,2,2,1,0,0,6,11521,68.36
20565,1,1,0,1,0,0,3,1352,17.01
20566,1,0,3,1,0,0,5,8690,54.42
20567,1,1,1,1,0,0,4,4966,36.77
20568,1,0,2,1,0,0,4,4966,36.77
20569,1,0,1,1,0,0,3,1352,17.01
20570,1,0,2,1,0,0,4,4966,36.77
20571,1,1,3,1,1,0,7,13868,78.23
20572,1,1,4,2,0,0,8,15186,83.84
20574,1,2,1,1,0,0,5,8690,54.42
20575,1,4,0,1,0,0,6,11521,68.36
20576,1,1,1,1,0,0,4,4966,36.77
20577,1,2,0,1,0,0,4,4966,36.77
20578,1,0,1,1,0,6,9,15950,87.44
20579,1,1,1,1,0,0,4,4966,36.77
20580,1,3,3,1,0,0,8,15186,83.84
20581,1,0,2,1,0,0,4,4966,36.77
20582,1,3,2,1,0,0,7,13868,78.23
20583,1,0,4,1,0,0,6,11521,68.36
20584,1,0,1,1,0,0,3,1352,17.01
20585,1,1,1,1,0,0,4,4966,36.77
20586,1,2,1,1,0,0,5,8690,54.42
20587,1,3,0,1,0,0,5,8690,54.42
20588,1,3,0,1,0,0,5,8690,54.42
20589,1,1,1,1,0,0,4,4966,36.77
20590,1,1,1,1,0,0,4,4966,36.77
20591,1,1,4,1,0,0,7,13868,78.23
20592,1,1,2,1,0,4,9,15950,87.44
20593,1,1,2,1,0,0,5,8690,54.42
20594,1,1,1,1,0,0,4,4966,36.77
20595,1,0,0,1,0,0,2,32,3.72
20596,1,4,1,1,0,0,7,13868,78.23
20597,1,4,0,1,0,0,6,11521,68.36
20598,1,2,1,1,0,0,5,8690,54.42
20599,1,0,3,2,1,0,7,13868,78.23
20600,1,1,0,1,0,0,3,1352,17.01
20601,1,0,1,1,0,0,3,1352,17.01
20602,1,3,0,1,0,0,5,8690,54.42
20603,1,0,1,1,0,0,3,1352,17.01
20604,1,1,1,1,0,0,4,4966,36.77
20605,1,2,1,1,0,0,5,8690,54.42
20606,1,4,2,1,0,0,8,15186,83.84
20607,1,2,1,1,0,0,5,8690,54.42
20608,1,0,4,1,1,0,7,13868,78.23
20609,1,2,0,1,0,0,4,4966,36.77
20610,1,5,0,1,0,0,7,13868,78.23
20611,1,0,3,1,1,0,6,11521,68.36
20612,1,0,1,1,0,0,3,1352,17.01
20613,3,0,4,1,2,8,18,18287,98.68
20615,1,0,0,1,0,0,2,32,3.72
20616,1,0,0,1,0,0,2,32,3.72
20617,1,0,1,1,0,0,3,1352,17.01
20618,1,0,1,1,0,0,3,1352,17.01
20619,1,0,3,1,0,0,5,8690,54.42
20620,1,1,1,1,0,0,4,4966,36.77
20621,1,1,2,1,0,0,5,8690,54.42
20622,1,0,0,1,0,0,2,32,3.72
20623,1,2,2,1,0,0,6,11521,68.36
20624,1,0,0,1,0,0,2,32,3.72
20625,1,2,0,1,0,0,4,4966,36.77
20626,1,4,2,1,0,0,8,15186,83.84
20627,1,0,1,1,0,0,3,1352,17.01
20628,1,1,2,1,0,0,5,8690,54.42
20629,1,1,1,1,0,6,10,16522,90.12
20630,1,0,2,1,0,0,4,4966,36.77
20631,1,0,0,1,0,2,4,4966,36.77
20632,1,1,1,1,0,0,4,4966,36.77
20633,1,2,0,1,0,0,4,4966,36.77
20634,1,2,2,1,0,0,6,11521,68.36
20635,1,1,1,1,0,0,4,4966,36.77
20636,1,0,2,1,0,0,4,4966,36.77
20637,1,0,1,1,0,0,3,1352,17.01
20639,1,3,0,1,0,0,5,8690,54.42
20640,1,2,0,1,0,0,4,4966,36.77
20641,1,0,1,1,0,0,3,1352,17.01
20642,1,1,1,1,0,0,4,4966,36.77
20643,1,0,1,1,0,0,3,1352,17.01
20644,1,2,0,1,0,0,4,4966,36.77
20645,1,0,0,1,0,0,2,32,3.72
20646,1,0,3,1,0,0,5,8690,54.42
20647,1,1,0,1,0,0,3,1352,17.01
20648,1,0,3,1,0,0,5,8690,54.42
20649,1,0,1,1,0,0,3,1352,17.01
20650,1,1,1,1,0,0,4,4966,36.77
20651,1,2,0,1,0,0,4,4966,36.77
20652,1,1,0,1,0,0,3,1352,17.01
20653,1,0,1,1,0,0,3,1352,17.01
20654,1,1,1,1,0,0,4,4966,36.77
20655,1,0,2,1,1,10,15,17888,96.85
20656,1,0,3,1,1,0,6,11521,68.36
20657,1,5,0,1,0,0,7,13868,78.23
20658,1,4,0,1,0,0,6,11521,68.36
20659,1,0,2,1,0,0,4,4966,36.77
20660,1,0,2,1,0,0,4,4966,36.77
20661,1,4,1,1,0,0,7,13868,78.23
20662,1,2,0,1,0,0,4,4966,36.77
20663,1,4,0,1,0,0,6,11521,68.36
20664,1,4,1,1,0,0,7,13868,78.23
20665,1,1,0,1,0,0,3,1352,17.01
20666,1,1,2,1,0,0,5,8690,54.42
20667,1,0,4,2,1,0,8,15186,83.84
20668,1,2,1,1,0,0,5,8690,54.42
20669,1,1,0,1,0,0,3,1352,17.01
20670,1,1,2,1,0,0,5,8690,54.42
20671,1,2,2,1,0,0,6,11521,68.36
20672,1,2,1,1,0,0,5,8690,54.42
20673,1,0,0,1,0,0,2,32,3.72
20674,1,0,2,1,0,0,4,4966,36.77
20675,1,1,1,1,0,0,4,4966,36.77
20676,1,0,1,1,0,0,3,1352,17.01
20677,1,3,1,1,0,0,6,11521,68.36
20678,1,3,1,1,0,0,6,11521,68.36
20679,1,4,1,1,0,0,7,13868,78.23
20680,1,0,2,1,0,0,4,4966,36.77
20681,1,0,2,1,0,0,4,4966,36.77
20682,1,1,3,1,0,0,6,11521,68.36
20683,1,0,3,1,0,0,5,8690,54.42
20684,1,2,1,1,0,0,5,8690,54.42
20685,1,0,0,1,0,0,2,32,3.72
20686,1,3,0,1,0,0,5,8690,54.42
20687,1,4,1,1,0,0,7,13868,78.23
20688,1,3,0,2,0,0,6,11521,68.36
20689,2,0,4,2,0,0,8,15186,83.84
20690,4,4,5,2,5,0,20,18419,99.31
20691,1,1,2,1,0,0,5,8690,54.42
20692,1,4,0,1,0,0,6,11521,68.36
20693,1,1,0,1,0,0,3,1352,17.01
20694,1,2,1,1,0,0,5,8690,54.42
20695,1,5,0,1,0,0,7,13868,78.23
20696,1,1,2,1,0,0,5,8690,54.42
20697,1,3,2,1,0,0,7,13868,78.23
20698,1,0,1,1,0,0,3,1352,17.01
20699,1,1,0,1,0,0,3,1352,17.01
20700,1,0,0,1,0,0,2,32,3.72
20701,1,2,0,1,0,0,4,4966,36.77
20702,1,1,1,1,0,0,4,4966,36.77
20703,1,1,0,1,0,0,3,1352,17.01
20704,1,1,0,1,0,0,3,1352,17.01
20705,1,0,1,1,0,0,3,1352,17.01
20706,1,0,1,1,0,0,3,1352,17.01
20707,1,0,2,1,1,6,11,16947,91.91
20708,1,0,2,1,0,0,4,4966,36.77
20709,1,0,0,1,0,6,8,15186,83.84
20710,1,2,3,1,0,0,7,13868,78.23
20711,1,1,2,1,1,0,6,11521,68.36
20712,1,1,1,1,0,0,4,4966,36.77
20713,1,2,1,1,0,0,5,8690,54.42
20714,1,0,1,1,0,0,3,1352,17.01
20715,1,4,1,1,0,0,7,13868,78.23
20716,1,1,2,1,0,6,11,16947,91.91
20717,1,4,2,1,0,0,8,15186,83.84
20718,1,0,2,1,0,0,4,4966,36.77
20719,1,0,1,1,0,6,9,15950,87.44
20720,1,1,1,1,0,0,4,4966,36.77
20721,1,1,0,1,0,0,3,1352,17.01
20722,1,1,4,1,0,0,7,13868,78.23
20723,1,1,1,1,0,6,10,16522,90.12
20724,1,0,0,1,0,0,2,32,3.72
20725,1,0,0,1,0,0,2,32,3.72
20726,1,4,0,1,0,0,6,11521,68.36
20727,1,0,2,1,1,0,5,8690,54.42
20728,1,4,1,1,0,0,7,13868,78.23
20729,1,3,0,1,0,0,5,8690,54.42
20730,1,0,1,1,0,0,3,1352,17.01
20731,1,2,0,1,0,0,4,4966,36.77
20732,1,2,0,2,0,0,5,8690,54.42
20733,1,0,1,1,0,0,3,1352,17.01
20734,1,1,0,1,1,0,4,4966,36.77
20735,1,1,1,1,0,0,4,4966,36.77
20736,1,0,1,1,0,0,3,1352,17.01
20737,1,1,2,1,0,0,5,8690,54.42
20738,1,0,0,1,0,0,2,32,3.72
20739,1,0,0,1,0,0,2,32,3.72
20740,1,3,0,1,0,0,5,8690,54.42
20741,1,1,5,2,0,0,9,15950,87.44
20742,1,0,2,1,2,0,6,11521,68.36
20743,1,0,2,1,1,0,5,8690,54.42
20744,1,3,0,1,0,0,5,8690,54.42
20745,1,1,1,1,0,0,4,4966,36.77
20746,1,0,2,1,0,0,4,4966,36.77
20747,1,1,2,1,0,0,5,8690,54.42
20748,1,0,2,1,0,0,4,4966,36.77
20749,1,0,2,1,0,0,4,4966,36.77
20750,1,0,2,1,0,0,4,4966,36.77
20751,1,1,2,1,0,0,5,8690,54.42
20752,1,0,2,1,0,4,8,15186,83.84
20753,1,0,0,1,0,0,2,32,3.72
20754,1,1,1,1,0,0,4,4966,36.77
20755,1,0,2,1,0,0,4,4966,36.77
20756,1,0,2,1,0,0,4,4966,36.77
20757,1,1,2,1,0,0,5,8690,54.42
20758,1,1,1,1,0,0,4,4966,36.77
20759,1,2,1,1,0,0,5,8690,54.42
20760,1,0,3,1,0,0,5,8690,54.42
20761,1,1,2,1,0,0,5,8690,54.42
20762,1,0,1,1,0,0,3,1352,17.01
20763,1,0,1,1,2,0,5,8690,54.42
20764,1,1,0,1,0,0,3,1352,17.01
20765,1,3,2,2,0,0,8,15186,83.84
20766,1,4,0,1,0,0,6,11521,68.36
20767,1,0,1,1,4,0,7,13868,78.23
20768,1,3,2,1,1,0,8,15186,83.84
20769,1,3,0,1,0,0,5,8690,54.42
20770,1,3,1,1,0,0,6,11521,68.36
20771,1,2,1,1,0,0,5,8690,54.42
20772,1,1,1,1,0,0,4,4966,36.77
20773,1,1,1,1,0,0,4,4966,36.77
20774,1,3,1,1,0,0,6,11521,68.36
20775,1,3,0,1,0,0,5,8690,54.42
20776,1,4,0,1,0,0,6,11521,68.36
20777,1,1,2,1,0,0,5,8690,54.42
20778,1,0,0,1,0,0,2,32,3.72
20779,1,1,0,1,0,0,3,1352,17.01
20780,1,0,0,1,0,0,2,32,3.72
20781,1,0,2,1,0,0,4,4966,36.77
20782,1,4,0,1,0,0,6,11521,68.36
20783,1,3,0,1,0,0,5,8690,54.42
20784,1,0,1,1,1,0,4,4966,36.77
20785,1,2,1,1,0,0,5,8690,54.42
20786,1,0,1,1,0,0,3,1352,17.01
20787,1,0,0,1,0,0,2,32,3.72
20788,1,1,1,1,0,0,4,4966,36.77
20789,1,3,0,1,0,0,5,8690,54.42
20790,1,0,2,1,1,0,5,8690,54.42
20791,1,1,1,1,0,0,4,4966,36.77
20792,1,1,0,1,0,0,3,1352,17.01
20793,1,1,1,1,0,0,4,4966,36.77
20794,1,1,1,1,0,0,4,4966,36.77
20795,1,0,2,1,0,0,4,4966,36.77
20796,1,4,0,1,0,0,6,11521,68.36
20797,1,4,0,1,0,0,6,11521,68.36
20798,1,1,1,1,0,0,4,4966,36.77
20799,1,0,1,1,0,0,3,1352,17.01
20800,1,0,1,1,0,2,5,8690,54.42
20801,1,2,2,1,0,0,6,11521,68.36
20802,1,4,0,1,0,0,6,11521,68.36
20803,1,4,0,1,0,0,6,11521,68.36
20805,1,3,1,1,0,0,6,11521,68.36
20806,1,0,3,1,0,0,5,8690,54.42
20807,1,0,1,1,0,0,3,1352,17.01
20808,1,0,3,2,1,0,7,13868,78.23
20809,1,0,1,1,0,0,3,1352,17.01
20810,1,0,1,1,1,0,4,4966,36.77
20811,1,2,1,1,0,0,5,8690,54.42
20812,1,1,2,1,1,0,6,11521,68.36
20813,1,0,1,1,0,0,3,1352,17.01
20814,1,0,5,2,3,6,17,18193,98.23
20815,1,1,3,1,0,6,12,17186,93.28
20816,1,0,1,1,0,6,9,15950,87.44
20817,1,1,0,1,0,0,3,1352,17.01
20818,1,4,0,1,0,0,6,11521,68.36
20819,1,1,2,1,0,0,5,8690,54.42
20820,1,2,2,1,0,0,6,11521,68.36
20821,1,2,0,1,0,0,4,4966,36.77
20822,1,0,4,2,0,6,13,17456,94.66
20823,1,1,0,1,0,0,3,1352,17.01
20824,1,1,1,1,0,0,4,4966,36.77
20825,1,0,1,1,0,0,3,1352,17.01
20826,1,0,1,1,0,0,3,1352,17.01
20827,1,0,1,1,0,0,3,1352,17.01
20828,1,0,1,1,0,0,3,1352,17.01
20829,1,0,1,1,0,0,3,1352,17.01
20830,1,1,1,1,0,0,4,4966,36.77
20831,1,1,1,1,0,0,4,4966,36.77
20832,1,1,1,1,0,6,10,16522,90.12
20833,1,0,2,1,0,4,8,15186,83.84
20834,1,0,3,1,0,0,5,8690,54.42
20835,1,1,1,1,0,0,4,4966,36.77
20836,1,0,0,1,0,6,8,15186,83.84
20837,1,3,2,2,0,0,8,15186,83.84
20838,1,4,0,1,0,0,6,11521,68.36
20839,1,0,1,1,0,6,9,15950,87.44
20840,1,0,1,1,0,6,9,15950,87.44
20841,1,0,1,1,0,0,3,1352,17.01
20842,1,0,1,1,0,0,3,1352,17.01
20843,1,0,1,1,0,0,3,1352,17.01
20844,1,0,4,1,3,0,9,15950,87.44
20845,1,0,1,1,0,0,3,1352,17.01
20846,1,1,2,1,3,0,8,15186,83.84
20847,1,0,2,1,0,0,4,4966,36.77
20848,1,0,3,1,5,0,10,16522,90.12
20849,1,4,0,1,0,0,6,11521,68.36
20850,1,4,0,1,0,0,6,11521,68.36
20851,1,0,1,1,0,0,3,1352,17.01
20852,1,0,1,1,0,0,3,1352,17.01
20853,1,0,1,1,0,0,3,1352,17.01
20854,1,0,0,1,0,0,2,32,3.72
20855,1,0,2,1,0,0,4,4966,36.77
20856,1,3,1,1,0,0,6,11521,68.36
20857,1,2,1,1,0,0,5,8690,54.42
20858,1,0,2,1,0,10,14,17699,95.82
20859,1,0,4,1,2,0,8,15186,83.84
20860,1,4,0,1,0,0,6,11521,68.36
20861,1,2,1,1,0,0,5,8690,54.42
20862,1,3,0,1,0,0,5,8690,54.42
20863,1,0,1,1,2,0,5,8690,54.42
20864,1,0,3,1,0,0,5,8690,54.42
20865,1,2,1,1,0,0,5,8690,54.42
20866,1,4,0,1,0,0,6,11521,68.36
20867,3,0,5,1,3,4,16,18081,97.67
20868,1,2,1,1,0,6,11,16947,91.91
20869,1,4,0,0,0,0,5,8690,54.42
20870,1,5,0,1,0,0,7,13868,78.23
20871,1,1,0,1,0,0,3,1352,17.01
20872,1,0,1,1,0,0,3,1352,17.01
20873,1,2,0,1,0,0,4,4966,36.77
20874,1,2,1,1,0,0,5,8690,54.42
20875,1,0,0,1,0,0,2,32,3.72
20876,1,1,0,1,0,0,3,1352,17.01
20877,1,0,3,1,0,0,5,8690,54.42
20878,1,0,2,1,1,6,11,16947,91.91
20879,1,0,3,1,2,0,7,13868,78.23
20880,1,1,2,1,0,6,11,16947,91.91
20881,1,1,2,1,0,4,9,15950,87.44
20882,1,0,2,1,1,0,5,8690,54.42
20883,1,1,2,1,0,0,5,8690,54.42
20884,1,0,2,1,0,0,4,4966,36.77
20885,1,1,1,1,0,0,4,4966,36.77
20886,1,1,1,1,0,0,4,4966,36.77
20887,1,1,1,1,0,0,4,4966,36.77
20888,1,0,1,1,0,0,3,1352,17.01
20889,1,1,1,1,0,0,4,4966,36.77
20890,1,4,1,2,0,0,8,15186,83.84
20891,1,4,1,1,0,0,7,13868,78.23
20892,1,4,1,1,0,0,7,13868,78.23
20893,1,2,0,1,0,0,4,4966,36.77
20894,1,1,0,1,0,0,3,1352,17.01
20895,1,1,0,1,0,0,3,1352,17.01
20896,1,1,1,1,0,0,4,4966,36.77
20897,1,0,3,1,3,0,8,15186,83.84
20898,1,0,3,1,3,0,8,15186,83.84
20899,1,0,3,1,2,0,7,13868,78.23
20900,1,1,2,1,1,0,6,11521,68.36
20901,1,0,2,1,0,0,4,4966,36.77
20902,1,4,0,1,0,0,6,11521,68.36
20903,1,0,1,1,0,0,3,1352,17.01
20904,1,0,2,1,0,0,4,4966,36.77
20905,1,0,1,1,0,0,3,1352,17.01
20906,1,2,0,1,0,0,4,4966,36.77
20907,1,4,0,1,0,0,6,11521,68.36
20908,1,3,0,1,0,0,5,8690,54.42
20909,1,3,0,1,0,0,5,8690,54.42
20910,1,0,5,2,0,0,8,15186,83.84
20911,1,0,1,1,0,0,3,1352,17.01
20912,1,2,1,1,0,0,5,8690,54.42
20913,1,0,1,1,0,0,3,1352,17.01
20914,1,0,2,1,0,0,4,4966,36.77
20915,1,1,1,1,0,0,4,4966,36.77
20916,1,3,2,1,0,0,7,13868,78.23
20917,1,1,2,1,0,0,5,8690,54.42
20918,1,1,0,1,0,0,3,1352,17.01
20919,1,4,0,1,0,0,6,11521,68.36
20920,1,4,0,1,0,0,6,11521,68.36
20921,1,4,0,1,0,0,6,11521,68.36
20922,1,1,0,1,0,0,3,1352,17.01
20923,1,1,0,1,0,0,3,1352,17.01
20924,1,4,0,1,0,0,6,11521,68.36
20925,1,0,1,1,0,0,3,1352,17.01
20926,1,0,1,1,0,0,3,1352,17.01
20927,1,3,0,1,0,0,5,8690,54.42
20928,1,3,0,1,0,0,5,8690,54.42
20929,1,2,0,1,0,0,4,4966,36.77
20930,1,0,1,0,1,0,3,1352,17.01
20931,1,0,1,1,0,0,3,1352,17.01
20932,1,0,1,1,0,0,3,1352,17.01
20933,1,1,1,1,0,0,4,4966,36.77
20934,1,3,0,1,0,0,5,8690,54.42
20935,1,0,3,1,1,8,14,17699,95.82
20936,1,0,2,1,0,6,10,16522,90.12
20937,1,4,0,1,0,0,6,11521,68.36
20938,1,1,0,1,0,0,3,1352,17.01
20939,1,2,0,1,0,0,4,4966,36.77
20940,1,3,0,1,0,0,5,8690,54.42
20941,1,3,0,1,0,0,5,8690,54.42
20942,1,3,0,1,0,0,5,8690,54.42
20943,1,3,0,1,0,0,5,8690,54.42
20944,1,1,0,1,0,0,3,1352,17.01
20945,1,0,1,1,0,0,3,1352,17.01
20946,1,0,1,1,0,0,3,1352,17.01
20947,1,4,0,1,2,0,8,15186,83.84
20948,1,1,1,1,0,0,4,4966,36.77
20949,1,0,1,1,0,0,3,1352,17.01
20950,1,0,2,1,0,0,4,4966,36.77
20951,1,2,2,1,0,0,6,11521,68.36
20952,1,0,1,1,0,0,3,1352,17.01
20953,1,0,0,1,0,0,2,32,3.72
20954,1,1,0,1,0,0,3,1352,17.01
20955,1,0,2,1,0,0,4,4966,36.77
20956,1,2,1,1,1,0,6,11521,68.36
20957,1,0,3,1,0,0,5,8690,54.42
20958,1,4,0,1,0,0,6,11521,68.36
20959,1,0,1,1,0,0,3,1352,17.01
20960,1,1,1,1,0,0,4,4966,36.77
20961,1,0,1,1,0,0,3,1352,17.01
20962,1,3,0,1,0,0,5,8690,54.42
20963,1,0,1,0,0,0,2,32,3.72
20964,1,3,2,1,0,0,7,13868,78.23
20965,1,0,3,1,1,0,6,11521,68.36
20966,1,4,1,1,0,0,7,13868,78.23
20968,1,0,0,1,0,0,2,32,3.72
20969,1,0,0,1,0,0,2,32,3.72
20970,1,2,0,1,0,0,4,4966,36.77
20972,1,2,0,1,0,0,4,4966,36.77
20973,1,2,1,1,0,0,5,8690,54.42
20974,1,0,2,1,0,0,4,4966,36.77
20976,1,3,0,1,0,0,5,8690,54.42
20977,1,0,1,1,0,0,3,1352,17.01
20978,1,0,1,0,0,0,2,32,3.72
20979,1,0,4,1,3,0,9,15950,87.44
20980,1,0,3,1,0,0,5,8690,54.42
20981,1,1,0,1,0,0,3,1352,17.01
20982,1,0,1,1,0,0,3,1352,17.01
20983,1,0,1,1,0,0,3,1352,17.01
20984,1,3,0,1,0,0,5,8690,54.42
20985,1,0,2,1,0,0,4,4966,36.77
20986,1,0,2,1,0,0,4,4966,36.77
20987,1,1,1,1,0,0,4,4966,36.77
20988,1,4,1,1,0,0,7,13868,78.23
20989,1,4,0,1,0,0,6,11521,68.36
20990,1,4,0,1,0,0,6,11521,68.36
20991,1,1,0,1,0,8,11,16947,91.91
20992,1,1,2,1,0,0,5,8690,54.42
20993,1,2,1,1,0,0,5,8690,54.42
20994,1,0,4,1,3,6,15,17888,96.85
20995,1,3,1,1,0,0,6,11521,68.36
20996,1,0,0,1,0,0,2,32,3.72
20997,1,0,0,1,0,0,2,32,3.72
20998,1,3,1,1,0,0,6,11521,68.36
20999,1,2,1,1,0,0,5,8690,54.42
21000,1,1,3,1,0,0,6,11521,68.36
21001,1,0,1,1,0,0,3,1352,17.01
21002,1,0,0,1,0,6,8,15186,83.84
21003,1,0,3,1,0,0,5,8690,54.42
21004,1,0,0,1,0,10,12,17186,93.28
21005,1,0,3,1,0,0,5,8690,54.42
21006,1,0,2,1,0,0,4,4966,36.77
21007,1,4,2,1,1,0,9,15950,87.44
21008,1,3,2,1,0,0,7,13868,78.23
21009,1,0,1,1,0,0,3,1352,17.01
21010,1,0,3,2,0,0,6,11521,68.36
21011,1,3,2,1,0,0,7,13868,78.23
21012,1,0,1,1,0,0,3,1352,17.01
21013,1,1,2,1,0,0,5,8690,54.42
21014,1,0,0,1,0,10,12,17186,93.28
21015,1,0,0,1,0,8,10,16522,90.12
21016,1,0,1,1,0,0,3,1352,17.01
21017,1,0,3,1,1,0,6,11521,68.36
21018,1,1,1,1,0,0,4,4966,36.77
21020,1,2,3,1,1,0,8,15186,83.84
21021,1,2,3,1,0,0,7,13868,78.23
21022,1,0,2,1,1,0,5,8690,54.42
21023,1,0,3,1,1,0,6,11521,68.36
21024,1,2,1,1,0,0,5,8690,54.42
21025,1,1,3,1,0,0,6,11521,68.36
21026,1,2,0,1,0,0,4,4966,36.77
21027,1,2,0,1,0,0,4,4966,36.77
21028,1,2,0,1,0,0,4,4966,36.77
21029,1,0,5,2,1,0,9,15950,87.44
21030,1,3,0,1,0,0,5,8690,54.42
21031,1,0,1,1,0,0,3,1352,17.01
21032,1,4,0,1,0,0,6,11521,68.36
21034,1,1,0,1,0,0,3,1352,17.01
21035,1,0,2,1,0,0,4,4966,36.77
21036,1,0,0,1,0,0,2,32,3.72
21037,1,0,0,1,0,0,2,32,3.72
21038,1,0,1,1,0,0,3,1352,17.01
21039,1,2,4,2,0,0,9,15950,87.44
21040,1,3,0,1,0,0,5,8690,54.42
21041,1,1,1,1,0,4,8,15186,83.84
21042,1,0,0,1,0,0,2,32,3.72
21043,3,0,5,1,3,4,16,18081,97.67
21044,1,2,0,1,0,0,4,4966,36.77
21045,1,0,1,1,0,0,3,1352,17.01
21046,1,0,2,1,1,6,11,16947,91.91
21047,1,3,2,1,0,0,7,13868,78.23
21048,1,0,2,1,0,0,4,4966,36.77
21049,1,2,1,1,0,0,5,8690,54.42
21050,1,0,1,1,0,0,3,1352,17.01
21051,1,0,1,1,0,0,3,1352,17.01
21052,1,0,1,1,0,0,3,1352,17.01
21053,1,0,1,1,0,0,3,1352,17.01
21054,1,0,1,1,0,0,3,1352,17.01
21055,1,0,1,1,0,0,3,1352,17.01
21056,1,0,1,1,0,0,3,1352,17.01
21057,1,4,0,1,0,0,6,11521,68.36
21058,1,2,1,1,0,0,5,8690,54.42
21059,1,0,2,1,1,0,5,8690,54.42
21060,1,0,3,1,0,4,9,15950,87.44
21061,1,2,1,1,0,0,5,8690,54.42
21062,1,0,1,1,0,0,3,1352,17.01
21063,1,0,3,1,0,0,5,8690,54.42
21064,1,1,2,1,0,0,5,8690,54.42
21065,1,0,4,2,0,0,7,13868,78.23
21066,1,1,0,1,0,0,3,1352,17.01
21067,1,4,0,1,0,0,6,11521,68.36
21068,1,2,1,1,0,0,5,8690,54.42
21069,1,0,3,1,1,4,10,16522,90.12
21070,1,1,0,1,3,0,6,11521,68.36
21071,1,0,0,1,0,0,2,32,3.72
21072,1,0,4,2,0,6,13,17456,94.66
21073,1,0,0,1,0,10,12,17186,93.28
21074,1,3,0,1,0,0,5,8690,54.42
21075,1,0,1,1,0,6,9,15950,87.44
21077,1,0,1,1,0,6,9,15950,87.44
21078,1,0,2,1,0,6,10,16522,90.12
21079,1,1,2,1,0,0,5,8690,54.42
21080,1,1,3,2,0,0,7,13868,78.23
21081,1,1,3,2,2,0,9,15950,87.44
21082,1,0,3,1,3,0,8,15186,83.84
21083,1,1,1,1,0,0,4,4966,36.77
21084,1,0,2,1,1,0,5,8690,54.42
21085,1,0,0,1,0,0,2,32,3.72
21086,1,0,3,1,1,0,6,11521,68.36
21087,1,0,2,1,1,0,5,8690,54.42
21088,1,1,0,1,0,4,7,13868,78.23
21089,1,0,1,1,0,0,3,1352,17.01
21090,1,4,0,1,0,0,6,11521,68.36
21091,1,3,1,1,1,0,7,13868,78.23
21092,1,0,1,1,0,2,5,8690,54.42
21093,1,0,2,1,1,10,15,17888,96.85
21094,1,0,3,1,1,0,6,11521,68.36
21095,1,0,1,1,0,6,9,15950,87.44
21096,1,3,1,1,0,0,6,11521,68.36
21097,1,0,3,1,1,4,10,16522,90.12
21098,1,3,1,1,0,0,6,11521,68.36
21099,1,3,2,1,0,0,7,13868,78.23
21100,1,2,2,1,0,0,6,11521,68.36
21101,1,0,4,1,0,0,6,11521,68.36
21102,1,1,4,1,0,0,7,13868,78.23
21103,1,0,3,1,2,10,17,18193,98.23
21104,1,1,1,1,0,0,4,4966,36.77
21106,1,4,1,1,0,0,7,13868,78.23
21107,1,3,0,1,0,0,5,8690,54.42
21108,1,0,1,1,0,0,3,1352,17.01
21109,1,1,0,1,0,0,3,1352,17.01
21110,1,0,1,1,0,0,3,1352,17.01
21111,1,5,0,1,0,0,7,13868,78.23
21112,1,2,0,1,0,0,4,4966,36.77
21113,3,0,4,1,2,0,10,16522,90.12
21114,1,2,0,1,0,0,4,4966,36.77
21115,1,2,1,1,0,0,5,8690,54.42
21116,1,2,1,1,0,0,5,8690,54.42
21117,1,2,1,1,0,0,5,8690,54.42
21118,1,2,1,1,0,0,5,8690,54.42
21119,1,0,0,1,0,0,2,32,3.72
21120,1,0,2,1,0,0,4,4966,36.77
21121,1,0,2,1,0,0,4,4966,36.77
21122,1,2,0,1,0,0,4,4966,36.77
21123,1,2,0,1,0,0,4,4966,36.77
21124,1,1,0,1,0,0,3,1352,17.01
21125,1,2,0,1,0,0,4,4966,36.77
21126,1,2,0,1,0,0,4,4966,36.77
21127,1,1,0,1,0,0,3,1352,17.01
21128,1,0,1,1,0,0,3,1352,17.01
21129,1,1,1,1,0,0,4,4966,36.77
21130,1,1,1,1,0,0,4,4966,36.77
21131,1,4,0,1,0,0,6,11521,68.36
21132,1,0,2,1,0,0,4,4966,36.77
21133,1,0,1,1,0,0,3,1352,17.01
21134,1,0,0,1,0,0,2,32,3.72
21135,1,0,2,1,1,0,5,8690,54.42
21136,1,0,2,1,0,0,4,4966,36.77
21137,1,1,3,1,2,0,8,15186,83.84
21138,1,1,1,1,0,0,4,4966,36.77
21139,1,0,3,1,1,0,6,11521,68.36
21140,1,5,2,2,0,0,10,16522,90.12
21141,1,3,0,1,0,0,5,8690,54.42
21142,1,2,0,1,0,0,4,4966,36.77
21143,1,3,1,1,0,0,6,11521,68.36
21144,1,2,0,1,0,0,4,4966,36.77
21145,1,0,1,1,0,0,3,1352,17.01
21146,1,0,0,1,0,0,2,32,3.72
21147,1,0,2,1,1,0,5,8690,54.42
21148,1,0,0,1,0,0,2,32,3.72
21149,1,2,1,1,0,0,5,8690,54.42
21150,1,0,2,1,0,0,4,4966,36.77
21151,1,0,1,1,0,0,3,1352,17.01
21152,1,0,2,1,0,6,10,16522,90.12
21153,1,4,1,1,0,0,7,13868,78.23
21154,1,0,2,1,0,4,8,15186,83.84
21155,1,0,0,1,0,0,2,32,3.72
21156,1,0,0,1,0,0,2,32,3.72
21157,1,0,4,1,3,0,9,15950,87.44
21158,1,0,3,1,0,0,5,8690,54.42
21159,1,0,3,1,0,0,5,8690,54.42
21160,1,0,1,1,0,6,9,15950,87.44
21161,1,1,0,1,0,0,3,1352,17.01
21162,1,1,3,2,0,0,7,13868,78.23
21163,1,2,3,2,0,0,8,15186,83.84
21164,1,2,0,1,0,0,4,4966,36.77
21165,1,4,0,1,0,0,6,11521,68.36
21166,1,1,1,1,0,0,4,4966,36.77
21167,1,3,1,1,0,0,6,11521,68.36
21168,1,1,2,1,0,0,5,8690,54.42
21169,1,0,2,1,1,0,5,8690,54.42
21170,1,2,2,1,0,0,6,11521,68.36
21172,1,4,1,1,0,0,7,13868,78.23
21173,1,0,2,1,0,0,4,4966,36.77
21174,1,0,3,1,0,0,5,8690,54.42
21175,1,0,1,1,1,0,4,4966,36.77
21176,1,1,1,1,0,0,4,4966,36.77
21177,1,0,1,1,0,0,3,1352,17.01
21178,1,1,0,1,0,0,3,1352,17.01
21179,1,2,0,1,0,0,4,4966,36.77
21180,1,0,0,1,0,0,2,32,3.72
21181,1,0,0,1,0,0,2,32,3.72
21182,1,2,1,1,0,0,5,8690,54.42
21183,1,2,4,2,0,0,9,15950,87.44
21184,1,0,4,1,1,0,7,13868,78.23
21185,1,1,1,1,0,0,4,4966,36.77
21186,1,1,1,1,0,0,4,4966,36.77
21187,1,5,1,1,0,0,8,15186,83.84
21188,1,0,0,1,0,0,2,32,3.72
21189,1,2,2,1,0,0,6,11521,68.36
21190,1,0,2,1,0,0,4,4966,36.77
21191,1,1,1,1,0,0,4,4966,36.77
21192,1,4,1,1,0,0,7,13868,78.23
21193,1,4,2,1,0,0,8,15186,83.84
21194,1,4,1,1,0,0,7,13868,78.23
21195,1,0,1,1,0,0,3,1352,17.01
21196,1,0,1,1,0,0,3,1352,17.01
21197,1,0,2,1,0,0,4,4966,36.77
21198,1,0,2,1,0,0,4,4966,36.77
21199,1,0,0,1,0,0,2,32,3.72
21200,1,0,2,1,0,6,10,16522,90.12
21201,1,1,2,1,0,0,5,8690,54.42
21202,1,2,2,1,0,0,6,11521,68.36
21203,1,0,1,1,0,6,9,15950,87.44
21205,1,0,4,2,0,0,7,13868,78.23
21206,1,0,1,1,0,4,7,13868,78.23
21207,1,0,1,1,0,6,9,15950,87.44
21208,1,1,0,1,0,0,3,1352,17.01
21209,1,0,0,1,0,0,2,32,3.72
21210,1,1,0,1,0,0,3,1352,17.01
21211,3,0,5,1,3,10,22,18498,99.73
21212,1,0,4,2,0,0,7,13868,78.23
21213,1,0,0,1,0,0,2,32,3.72
21214,1,2,0,1,0,0,4,4966,36.77
21215,1,0,1,1,0,6,9,15950,87.44
21216,1,0,2,1,0,2,6,11521,68.36
21217,1,3,0,1,0,0,5,8690,54.42
21218,1,1,1,1,0,0,4,4966,36.77
21219,1,0,2,1,1,0,5,8690,54.42
21220,1,1,1,1,0,0,4,4966,36.77
21221,1,1,1,1,0,0,4,4966,36.77
21222,1,1,0,1,0,0,3,1352,17.01
21223,1,4,0,1,0,0,6,11521,68.36
21224,1,3,1,1,0,0,6,11521,68.36
21225,1,0,2,1,0,0,4,4966,36.77
21226,1,3,0,1,0,0,5,8690,54.42
21227,1,2,3,1,0,0,7,13868,78.23
21228,1,2,0,1,0,0,4,4966,36.77
21229,1,0,1,1,0,0,3,1352,17.01
21230,1,0,4,1,2,6,14,17699,95.82
21231,1,0,1,1,0,6,9,15950,87.44
21232,1,1,3,1,0,0,6,11521,68.36
21233,1,0,3,1,0,0,5,8690,54.42
21235,1,0,0,0,0,0,1,1,0.08
21236,1,0,1,1,0,0,3,1352,17.01
21237,1,0,1,1,0,0,3,1352,17.01
21238,1,0,1,1,0,0,3,1352,17.01
21239,1,0,2,1,0,0,4,4966,36.77
21240,1,4,0,1,0,0,6,11521,68.36
21241,1,4,0,1,0,0,6,11521,68.36
21242,1,4,0,1,0,0,6,11521,68.36
21243,1,1,2,1,0,0,5,8690,54.42
21244,1,0,2,1,0,0,4,4966,36.77
21245,1,0,1,1,0,4,7,13868,78.23
21246,1,4,2,1,0,0,8,15186,83.84
21247,1,3,0,1,0,0,5,8690,54.42
21248,1,1,1,1,0,0,4,4966,36.77
21249,1,0,1,1,0,4,7,13868,78.23
21250,1,0,2,1,0,4,8,15186,83.84
21251,1,2,2,2,0,0,7,13868,78.23
21252,1,0,1,1,0,0,3,1352,17.01
21253,1,1,0,1,0,0,3,1352,17.01
21254,1,3,1,1,0,0,6,11521,68.36
21255,1,4,1,1,0,0,7,13868,78.23
21256,3,0,4,1,4,0,12,17186,93.28
21257,3,0,4,1,0,0,8,15186,83.84
21258,1,4,1,1,0,0,7,13868,78.23
21259,1,4,1,1,0,0,7,13868,78.23
21260,1,0,2,1,4,0,8,15186,83.84
21261,1,0,3,1,2,0,7,13868,78.23
21262,1,0,3,1,2,0,7,13868,78.23
21263,1,0,0,1,0,0,2,32,3.72
21265,1,0,3,1,0,0,5,8690,54.42
21266,1,0,0,1,0,0,2,32,3.72
21267,1,1,1,1,0,0,4,4966,36.77
21268,1,0,2,1,0,4,8,15186,83.84
21269,1,0,1,1,0,0,3,1352,17.01
21270,1,0,1,1,0,0,3,1352,17.01
21271,1,0,1,1,0,0,3,1352,17.01
21272,1,2,3,1,0,0,7,13868,78.23
21273,1,0,2,2,2,0,7,13868,78.23
21274,1,1,2,1,0,0,5,8690,54.42
21275,1,5,4,2,0,0,12,17186,93.28
21276,1,0,4,1,3,6,15,17888,96.85
21277,1,0,3,2,3,0,9,15950,87.44
21278,1,0,0,1,0,10,12,17186,93.28
21279,1,0,2,1,0,0,4,4966,36.77
21280,1,2,1,1,0,0,5,8690,54.42
21281,1,0,3,1,0,0,5,8690,54.42
21282,1,4,3,1,0,0,9,15950,87.44
21283,1,0,2,1,1,0,5,8690,54.42
21284,1,2,1,1,0,0,5,8690,54.42
21285,1,0,3,1,0,0,5,8690,54.42
21286,1,3,1,1,0,0,6,11521,68.36
21287,1,2,2,1,0,0,6,11521,68.36
21288,1,0,1,1,0,0,3,1352,17.01
21289,1,0,2,1,0,0,4,4966,36.77
21290,1,0,2,1,0,6,10,16522,90.12
21291,1,3,3,1,0,0,8,15186,83.84
21292,1,2,2,1,0,0,6,11521,68.36
21293,1,4,4,1,0,0,10,16522,90.12
21294,1,0,0,1,0,0,2,32,3.72
21295,1,0,1,1,0,0,3,1352,17.01
21296,1,0,2,1,1,0,5,8690,54.42
21297,1,0,1,1,0,0,3,1352,17.01
21298,1,0,2,1,0,6,10,16522,90.12
21299,1,0,2,1,0,4,8,15186,83.84
21300,1,1,2,1,0,0,5,8690,54.42
21301,1,0,1,1,0,0,3,1352,17.01
21302,1,1,1,1,0,0,4,4966,36.77
21303,1,1,2,1,0,0,5,8690,54.42
21304,1,1,2,1,0,0,5,8690,54.42
21305,1,1,2,1,0,0,5,8690,54.42
21306,1,0,2,1,0,0,4,4966,36.77
21307,1,3,2,1,0,0,7,13868,78.23
21308,1,0,1,1,0,0,3,1352,17.01
21309,1,0,3,2,1,0,7,13868,78.23
21310,1,1,1,1,0,0,4,4966,36.77
21311,1,0,1,1,0,0,3,1352,17.01
21312,1,2,1,1,0,0,5,8690,54.42
21313,1,0,0,1,0,0,2,32,3.72
21314,1,2,0,1,0,0,4,4966,36.77
21315,1,0,1,1,0,0,3,1352,17.01
21316,1,0,3,1,3,0,8,15186,83.84
21317,1,3,2,1,0,0,7,13868,78.23
21318,1,0,2,1,1,0,5,8690,54.42
21319,1,1,1,1,0,0,4,4966,36.77
21320,1,0,0,1,0,0,2,32,3.72
21321,1,3,1,1,0,0,6,11521,68.36
21322,1,0,0,1,0,0,2,32,3.72
21324,1,2,2,1,0,0,6,11521,68.36
21325,1,3,2,1,1,0,8,15186,83.84
21326,1,2,2,1,0,0,6,11521,68.36
21327,1,0,3,1,0,0,5,8690,54.42
21328,1,3,2,1,0,0,7,13868,78.23
21329,1,0,3,1,0,0,5,8690,54.42
21330,1,4,2,1,0,0,8,15186,83.84
21331,1,0,2,1,1,0,5,8690,54.42
21332,1,0,2,1,0,0,4,4966,36.77
21333,1,1,2,1,0,6,11,16947,91.91
21334,1,1,1,1,0,0,4,4966,36.77
21335,1,1,1,1,0,6,10,16522,90.12
21336,1,0,2,1,0,0,4,4966,36.77
21337,1,0,2,1,0,0,4,4966,36.77
21338,1,0,2,1,1,0,5,8690,54.42
21339,1,0,2,1,0,0,4,4966,36.77
21340,1,0,2,1,0,0,4,4966,36.77
21341,1,1,2,1,0,0,5,8690,54.42
21342,1,4,3,1,0,0,9,15950,87.44
21343,1,1,2,1,0,0,5,8690,54.42
21344,1,0,2,1,0,4,8,15186,83.84
21345,1,3,5,4,4,0,17,18193,98.23
21346,1,4,0,1,0,0,6,11521,68.36
21347,1,0,3,1,0,0,5,8690,54.42
21348,1,4,1,1,0,0,7,13868,78.23
21349,1,3,1,1,0,0,6,11521,68.36
21350,1,0,1,1,0,0,3,1352,17.01
21351,1,0,1,0,0,0,2,32,3.72
21352,1,1,2,1,0,0,5,8690,54.42
21353,1,0,0,0,1,0,2,32,3.72
21354,1,0,2,1,3,0,7,13868,78.23
21355,1,1,2,1,1,0,6,11521,68.36
21356,1,0,1,1,0,0,3,1352,17.01
21357,1,0,2,1,0,0,4,4966,36.77
21358,1,0,1,1,0,0,3,1352,17.01
21359,1,0,1,1,0,0,3,1352,17.01
21360,1,1,1,1,0,0,4,4966,36.77
21361,1,3,0,1,0,0,5,8690,54.42
21362,1,0,3,1,1,0,6,11521,68.36
21363,1,4,3,2,0,0,10,16522,90.12
21364,3,4,4,3,1,0,15,17888,96.85
21365,1,3,2,1,0,0,7,13868,78.23
21367,1,0,2,1,0,4,8,15186,83.84
21368,1,0,3,1,0,0,5,8690,54.42
21369,1,4,4,2,0,0,11,16947,91.91
21370,1,0,4,1,1,6,13,17456,94.66
21371,1,0,1,1,0,0,3,1352,17.01
21372,1,0,1,1,0,0,3,1352,17.01
21373,1,3,0,1,0,0,5,8690,54.42
21374,1,1,1,1,0,0,4,4966,36.77
21375,1,0,1,1,0,0,3,1352,17.01
21376,1,1,1,1,0,0,4,4966,36.77
21377,1,1,1,1,0,0,4,4966,36.77
21378,1,0,3,2,0,0,6,11521,68.36
21379,1,2,1,1,0,0,5,8690,54.42
21380,1,0,1,1,0,0,3,1352,17.01
21381,1,5,1,1,0,0,8,15186,83.84
21382,1,1,2,1,0,0,5,8690,54.42
21383,1,1,1,1,0,0,4,4966,36.77
21384,1,0,1,1,0,0,3,1352,17.01
21385,1,2,0,1,0,0,4,4966,36.77
21386,1,0,1,1,0,0,3,1352,17.01
21387,1,1,4,1,0,0,7,13868,78.23
21388,1,4,0,1,0,0,6,11521,68.36
21389,1,3,0,1,0,0,5,8690,54.42
21390,1,3,1,1,0,0,6,11521,68.36
21391,1,0,2,1,0,0,4,4966,36.77
21392,1,0,1,1,0,0,3,1352,17.01
21393,1,0,1,1,4,0,7,13868,78.23
21394,1,0,1,1,0,0,3,1352,17.01
21395,1,0,3,2,3,0,9,15950,87.44
21396,1,0,1,1,0,0,3,1352,17.01
21397,1,0,2,1,1,0,5,8690,54.42
21398,1,3,2,2,0,0,8,15186,83.84
21399,1,0,1,1,0,0,3,1352,17.01
21400,1,1,2,1,0,0,5,8690,54.42
21401,1,4,2,1,0,0,8,15186,83.84
21402,1,3,2,1,0,0,7,13868,78.23
21403,1,0,1,1,0,0,3,1352,17.01
21404,1,5,2,2,0,0,10,16522,90.12
21405,1,1,0,1,0,0,3,1352,17.01
21406,1,2,0,1,0,0,4,4966,36.77
21407,1,3,1,1,0,0,6,11521,68.36
21408,1,2,0,1,0,0,4,4966,36.77
21409,1,1,0,1,0,0,3,1352,17.01
21410,1,1,1,1,0,0,4,4966,36.77
21411,1,1,1,1,0,0,4,4966,36.77
21412,1,0,0,1,0,0,2,32,3.72
21413,1,2,0,1,0,0,4,4966,36.77
21414,1,4,1,0,0,0,6,11521,68.36
21415,1,2,1,1,0,0,5,8690,54.42
21416,1,2,2,1,0,0,6,11521,68.36
21417,1,3,1,1,0,0,6,11521,68.36
21418,1,2,1,1,0,0,5,8690,54.42
21419,1,3,1,1,0,0,6,11521,68.36
21420,1,1,1,1,0,0,4,4966,36.77
21421,1,2,1,1,0,0,5,8690,54.42
21422,1,1,2,1,0,0,5,8690,54.42
21423,1,3,0,1,0,0,5,8690,54.42
21424,1,0,2,1,1,6,11,16947,91.91
21425,1,0,1,1,0,0,3,1352,17.01
21426,1,4,1,1,0,0,7,13868,78.23
21427,1,0,1,1,0,0,3,1352,17.01
21428,1,0,2,1,0,8,12,17186,93.28
21429,1,0,0,1,0,0,2,32,3.72
21430,1,1,0,1,0,0,3,1352,17.01
21431,1,2,0,1,0,0,4,4966,36.77
21432,1,0,0,1,0,0,2,32,3.72
21433,1,0,0,1,0,0,2,32,3.72
21434,1,2,0,1,0,0,4,4966,36.77
21435,1,3,0,1,0,0,5,8690,54.42
21436,1,4,1,1,0,0,7,13868,78.23
21437,1,0,1,1,0,0,3,1352,17.01
21438,1,5,1,1,0,0,8,15186,83.84
21439,1,0,1,1,0,0,3,1352,17.01
21440,1,1,1,1,0,0,4,4966,36.77
21441,1,0,0,1,0,0,2,32,3.72
21442,1,0,1,1,0,0,3,1352,17.01
21443,1,1,1,1,0,0,4,4966,36.77
21444,1,4,1,1,0,0,7,13868,78.23
21445,1,0,3,1,1,0,6,11521,68.36
21446,1,4,1,1,0,0,7,13868,78.23
21447,1,0,1,1,0,0,3,1352,17.01
21448,1,0,0,1,0,0,2,32,3.72
21449,1,0,0,1,0,0,2,32,3.72
21450,1,3,2,1,1,0,8,15186,83.84
21451,1,1,2,1,0,0,5,8690,54.42
21452,1,0,4,2,2,0,9,15950,87.44
21453,1,0,4,1,1,0,7,13868,78.23
21454,1,1,1,1,0,0,4,4966,36.77
21455,1,4,0,1,0,0,6,11521,68.36
21456,1,0,0,1,0,10,12,17186,93.28
21457,3,0,3,1,2,10,19,18362,99.04
21458,1,0,2,1,0,0,4,4966,36.77
21459,1,2,1,1,0,0,5,8690,54.42
21460,1,2,1,1,0,0,5,8690,54.42
21461,1,3,1,1,0,0,6,11521,68.36
21462,1,2,1,1,0,0,5,8690,54.42
21463,1,2,1,1,0,0,5,8690,54.42
21464,1,2,1,1,0,0,5,8690,54.42
21465,1,2,2,1,0,0,6,11521,68.36
21466,1,4,0,1,0,0,6,11521,68.36
21467,1,0,1,1,0,0,3,1352,17.01
21468,1,5,0,1,0,0,7,13868,78.23
21469,1,4,1,1,0,0,7,13868,78.23
21470,1,1,0,1,0,0,3,1352,17.01
21471,1,0,0,1,0,0,2,32,3.72
21472,1,4,1,1,0,0,7,13868,78.23
21473,1,2,2,1,0,0,6,11521,68.36
21474,1,3,1,1,0,0,6,11521,68.36
21475,1,2,0,1,0,0,4,4966,36.77
21476,1,0,1,1,0,0,3,1352,17.01
21477,1,0,0,1,0,0,2,32,3.72
21478,1,0,2,1,1,0,5,8690,54.42
21479,1,0,2,1,0,0,4,4966,36.77
21480,1,3,2,1,0,0,7,13868,78.23
21481,1,0,0,1,0,0,2,32,3.72
21482,1,1,0,1,0,0,3,1352,17.01
21483,1,2,0,1,0,0,4,4966,36.77
21484,1,2,0,1,0,0,4,4966,36.77
21485,1,3,0,1,0,0,5,8690,54.42
21486,1,0,1,1,0,0,3,1352,17.01
21487,1,3,0,1,0,0,5,8690,54.42
21488,1,1,0,1,0,0,3,1352,17.01
21489,1,0,1,1,0,0,3,1352,17.01
21490,1,1,1,1,0,0,4,4966,36.77
21491,1,4,0,1,0,0,6,11521,68.36
21492,1,3,2,1,0,0,7,13868,78.23
21493,1,0,2,1,0,0,4,4966,36.77
21494,1,1,1,1,0,0,4,4966,36.77
21495,1,2,1,1,0,0,5,8690,54.42
21496,1,1,0,1,0,0,3,1352,17.01
21497,1,0,2,1,0,0,4,4966,36.77
21498,1,1,1,1,0,0,4,4966,36.77
21499,1,1,0,1,0,0,3,1352,17.01
21500,1,1,0,1,0,0,3,1352,17.01
21501,1,0,1,1,0,0,3,1352,17.01
21502,1,0,1,1,0,0,3,1352,17.01
21503,1,0,3,2,1,0,7,13868,78.23
21504,1,3,1,1,0,0,6,11521,68.36
21505,1,2,1,1,0,0,5,8690,54.42
21506,1,2,1,1,0,0,5,8690,54.42
21507,1,3,1,1,0,0,6,11521,68.36
21508,1,3,1,1,0,0,6,11521,68.36
21509,1,1,1,1,0,0,4,4966,36.77
21510,1,3,1,1,0,0,6,11521,68.36
21511,1,0,1,1,0,0,3,1352,17.01
21512,1,0,0,1,0,2,4,4966,36.77
21513,1,0,0,1,0,0,2,32,3.72
21514,1,2,0,1,0,0,4,4966,36.77
21515,1,0,1,1,0,0,3,1352,17.01
21516,1,0,0,1,0,0,2,32,3.72
21517,1,4,1,1,0,0,7,13868,78.23
21518,1,2,0,1,0,0,4,4966,36.77
21519,1,4,1,1,0,0,7,13868,78.23
21520,1,0,1,1,0,0,3,1352,17.01
21521,1,4,1,1,0,0,7,13868,78.23
21522,1,2,1,1,0,0,5,8690,54.42
21523,1,0,0,1,0,0,2,32,3.72
21524,1,3,0,1,0,0,5,8690,54.42
21525,1,0,0,1,0,0,2,32,3.72
21526,1,1,0,1,0,0,3,1352,17.01
21527,1,1,1,1,0,0,4,4966,36.77
21528,1,0,0,1,0,0,2,32,3.72
21529,1,0,1,1,0,0,3,1352,17.01
21530,1,3,1,1,0,0,6,11521,68.36
21531,1,1,1,1,0,0,4,4966,36.77
21532,1,0,2,2,0,0,5,8690,54.42
21533,1,0,0,1,0,6,8,15186,83.84
21534,1,0,2,1,0,0,4,4966,36.77
21535,1,0,1,1,0,0,3,1352,17.01
21536,1,2,1,1,0,0,5,8690,54.42
21537,1,4,1,1,0,0,7,13868,78.23
21538,1,1,0,1,0,0,3,1352,17.01
21539,1,0,1,1,0,0,3,1352,17.01
21540,1,3,0,1,0,0,5,8690,54.42
21541,1,1,0,1,0,0,3,1352,17.01
21542,1,0,2,1,0,0,4,4966,36.77
21543,1,3,0,1,0,0,5,8690,54.42
21544,1,4,0,1,0,0,6,11521,68.36
21545,1,4,0,1,0,0,6,11521,68.36
21546,1,4,0,1,0,0,6,11521,68.36
21547,1,5,0,1,0,0,7,13868,78.23
21548,1,2,1,1,0,0,5,8690,54.42
21550,1,3,0,1,0,0,5,8690,54.42
21551,1,1,0,1,0,0,3,1352,17.01
21552,1,0,0,1,0,0,2,32,3.72
21553,1,1,1,1,0,0,4,4966,36.77
21554,1,1,1,1,0,0,4,4966,36.77
21555,1,2,1,1,0,0,5,8690,54.42
21556,1,2,1,1,0,0,5,8690,54.42
21557,1,3,1,1,0,0,6,11521,68.36
21558,1,1,1,1,0,0,4,4966,36.77
21559,1,2,1,1,0,0,5,8690,54.42
21560,1,0,1,1,0,0,3,1352,17.01
21561,1,0,1,1,0,0,3,1352,17.01
21562,1,0,2,1,0,6,10,16522,90.12
21563,1,0,1,1,0,0,3,1352,17.01
21564,1,0,2,1,0,6,10,16522,90.12
21565,1,0,5,2,1,0,9,15950,87.44
21566,1,4,5,2,0,0,12,17186,93.28
21567,1,0,1,1,0,0,3,1352,17.01
21568,1,2,5,2,0,0,10,16522,90.12
21569,1,1,1,1,0,0,4,4966,36.77
21570,1,4,0,1,0,0,6,11521,68.36
21571,1,5,5,2,0,0,13,17456,94.66
21572,1,3,1,1,0,0,6,11521,68.36
21573,1,0,0,1,0,0,2,32,3.72
21574,1,1,1,1,0,0,4,4966,36.77
21575,1,3,1,1,0,0,6,11521,68.36
21576,1,2,0,1,0,0,4,4966,36.77
21577,1,0,1,1,0,0,3,1352,17.01
21578,1,2,0,1,0,0,4,4966,36.77
21579,1,1,0,1,0,0,3,1352,17.01
21580,1,4,1,1,0,0,7,13868,78.23
21581,1,4,0,1,0,0,6,11521,68.36
21582,1,0,2,1,0,0,4,4966,36.77
21583,1,0,3,1,1,4,10,16522,90.12
21584,1,5,1,1,0,0,8,15186,83.84
21585,1,0,2,1,0,0,4,4966,36.77
21586,1,1,1,1,0,0,4,4966,36.77
21587,1,0,0,1,3,0,5,8690,54.42
21588,1,1,1,1,2,0,6,11521,68.36
21589,1,0,1,1,0,0,3,1352,17.01
21590,1,4,1,1,0,0,7,13868,78.23
21591,1,1,2,1,0,0,5,8690,54.42
21592,1,0,1,1,0,0,3,1352,17.01
21593,1,1,1,1,1,0,5,8690,54.42
21594,1,1,2,1,1,0,6,11521,68.36
21595,1,0,4,1,2,4,12,17186,93.28
21596,1,0,1,1,0,4,7,13868,78.23
21597,1,2,0,1,0,0,4,4966,36.77
21598,1,0,1,1,0,0,3,1352,17.01
21599,1,0,2,1,0,0,4,4966,36.77
21600,1,0,1,1,1,0,4,4966,36.77
21601,1,1,0,1,0,0,3,1352,17.01
21602,1,0,2,1,0,0,4,4966,36.77
21603,1,2,1,1,0,0,5,8690,54.42
21604,1,0,0,1,0,0,2,32,3.72
21605,1,0,2,1,0,0,4,4966,36.77
21606,1,0,2,1,0,0,4,4966,36.77
21607,1,0,1,1,0,0,3,1352,17.01
21608,1,1,0,1,0,0,3,1352,17.01
21609,1,0,0,1,0,0,2,32,3.72
21610,1,0,0,1,0,0,2,32,3.72
21611,1,1,0,1,0,0,3,1352,17.01
21612,1,2,0,1,0,0,4,4966,36.77
21613,1,3,1,1,0,0,6,11521,68.36
21614,1,4,0,1,0,0,6,11521,68.36
21615,1,2,0,1,0,0,4,4966,36.77
21616,1,0,1,1,0,0,3,1352,17.01
21617,1,1,0,1,0,0,3,1352,17.01
21618,1,0,0,1,0,0,2,32,3.72
21619,1,4,0,1,0,0,6,11521,68.36
21620,1,1,0,1,0,0,3,1352,17.01
21621,1,4,0,1,0,0,6,11521,68.36
21622,1,1,1,1,0,0,4,4966,36.77
21623,3,0,4,1,1,8,17,18193,98.23
21624,1,0,2,1,1,0,5,8690,54.42
21625,1,1,1,1,0,0,4,4966,36.77
21626,1,1,1,1,0,0,4,4966,36.77
21627,1,0,2,1,0,0,4,4966,36.77
21628,1,0,0,1,0,0,2,32,3.72
21629,1,4,2,1,0,0,8,15186,83.84
21630,1,1,1,1,0,0,4,4966,36.77
21631,1,2,1,1,0,0,5,8690,54.42
21632,1,4,0,1,0,0,6,11521,68.36
21633,1,3,0,2,0,0,6,11521,68.36
21634,1,3,1,1,0,0,6,11521,68.36
21635,1,1,2,1,0,0,5,8690,54.42
21636,1,4,0,1,0,0,6,11521,68.36
21637,1,2,0,1,0,0,4,4966,36.77
21638,1,1,0,1,0,0,3,1352,17.01
21639,1,0,0,1,0,0,2,32,3.72
21640,1,0,0,1,0,0,2,32,3.72
21641,1,1,2,1,0,0,5,8690,54.42
21642,1,0,0,1,0,0,2,32,3.72
21643,1,3,0,1,0,0,5,8690,54.42
21644,1,1,2,1,0,4,9,15950,87.44
21645,1,0,1,1,0,0,3,1352,17.01
21646,1,1,1,1,0,0,4,4966,36.77
21647,1,4,0,1,0,0,6,11521,68.36
21648,1,1,2,1,0,0,5,8690,54.42
21649,1,1,1,1,0,0,4,4966,36.77
21650,1,4,1,1,0,0,7,13868,78.23
21651,1,0,1,1,0,0,3,1352,17.01
21652,1,2,0,1,0,0,4,4966,36.77
21653,1,0,0,1,0,0,2,32,3.72
21654,1,2,1,1,0,0,5,8690,54.42
21655,1,0,1,1,0,0,3,1352,17.01
21656,1,0,1,1,0,0,3,1352,17.01
21657,1,0,1,1,0,0,3,1352,17.01
21658,1,0,1,1,0,0,3,1352,17.01
21659,1,0,2,1,1,0,5,8690,54.42
21660,1,0,1,1,0,0,3,1352,17.01
21661,1,0,4,1,1,0,7,13868,78.23
21662,1,0,2,1,0,0,4,4966,36.77
21663,1,0,1,1,0,0,3,1352,17.01
21664,1,4,0,1,0,0,6,11521,68.36
21665,1,1,2,1,3,0,8,15186,83.84
21666,1,0,0,0,0,0,1,1,0.08
21667,1,0,2,1,0,0,4,4966,36.77
21668,1,1,1,1,0,0,4,4966,36.77
21669,1,2,0,1,0,0,4,4966,36.77
21670,1,0,2,1,0,0,4,4966,36.77
21671,1,1,0,1,0,0,3,1352,17.01
21672,1,1,0,1,0,0,3,1352,17.01
21673,1,1,0,1,0,0,3,1352,17.01
21674,1,4,0,1,0,0,6,11521,68.36
21675,1,0,0,1,0,0,2,32,3.72
21676,1,0,2,1,1,0,5,8690,54.42
21677,1,4,0,1,0,0,6,11521,68.36
21678,1,0,1,1,0,0,3,1352,17.01
21679,1,3,1,1,0,0,6,11521,68.36
21680,1,0,2,1,3,0,7,13868,78.23
21681,1,0,2,1,1,0,5,8690,54.42
21682,1,0,2,1,0,0,4,4966,36.77
21683,1,1,2,1,0,0,5,8690,54.42
21684,1,0,1,1,0,2,5,8690,54.42
21685,1,0,1,1,0,0,3,1352,17.01
21686,1,0,1,1,0,0,3,1352,17.01
21687,1,0,0,1,0,0,2,32,3.72
21688,1,0,0,1,0,0,2,32,3.72
21689,1,0,0,1,0,0,2,32,3.72
21690,1,1,0,1,0,0,3,1352,17.01
21691,1,1,1,1,0,0,4,4966,36.77
21692,1,0,0,1,0,0,2,32,3.72
21693,1,1,0,1,0,0,3,1352,17.01
21694,1,0,0,1,0,0,2,32,3.72
21695,1,0,0,1,0,0,2,32,3.72
21696,1,0,1,1,0,0,3,1352,17.01
21697,1,0,1,1,0,0,3,1352,17.01
21698,1,0,2,1,1,0,5,8690,54.42
21699,1,1,1,1,0,0,4,4966,36.77
21700,1,1,1,1,0,0,4,4966,36.77
21701,1,0,1,1,0,0,3,1352,17.01
21702,1,1,2,1,0,0,5,8690,54.42
21703,1,5,0,1,0,0,7,13868,78.23
21704,1,1,2,1,0,0,5,8690,54.42
21705,1,0,3,1,0,0,5,8690,54.42
21706,1,0,2,1,0,0,4,4966,36.77
21707,1,4,0,1,0,0,6,11521,68.36
21708,1,1,2,1,0,0,5,8690,54.42
21709,1,0,2,1,0,0,4,4966,36.77
21710,1,2,0,1,0,0,4,4966,36.77
21711,1,1,3,1,0,0,6,11521,68.36
21712,1,0,1,1,0,0,3,1352,17.01
21713,1,0,2,1,0,6,10,16522,90.12
21714,1,1,1,1,0,0,4,4966,36.77
21715,1,0,0,1,0,6,8,15186,83.84
21716,1,3,1,1,0,0,6,11521,68.36
21717,1,3,5,1,0,0,10,16522,90.12
21718,1,3,2,1,0,0,7,13868,78.23
21719,1,0,4,1,2,6,14,17699,95.82
21721,1,4,4,1,0,0,10,16522,90.12
21722,1,0,5,1,2,6,15,17888,96.85
21723,1,0,5,1,2,6,15,17888,96.85
21724,1,4,2,1,0,0,8,15186,83.84
21725,1,1,4,1,1,6,14,17699,95.82
21726,1,3,2,1,0,0,7,13868,78.23
21727,1,0,3,1,2,8,15,17888,96.85
21728,1,0,3,1,2,8,15,17888,96.85
21729,1,0,0,1,0,0,2,32,3.72
21730,1,1,1,1,0,6,10,16522,90.12
21731,1,0,1,1,0,6,9,15950,87.44
21732,1,1,1,1,0,6,10,16522,90.12
21733,1,5,0,1,0,0,7,13868,78.23
21734,1,4,0,1,0,0,6,11521,68.36
21735,1,0,0,1,0,0,2,32,3.72
21736,1,0,2,1,0,0,4,4966,36.77
21737,1,1,0,1,0,0,3,1352,17.01
21738,1,1,0,1,0,0,3,1352,17.01
21739,1,4,0,1,0,0,6,11521,68.36
21740,1,1,1,1,0,6,10,16522,90.12
21741,1,0,1,1,0,0,3,1352,17.01
21742,1,5,0,1,0,0,7,13868,78.23
21743,1,3,1,1,0,0,6,11521,68.36
21744,1,2,0,1,0,0,4,4966,36.77
21745,1,0,2,1,0,0,4,4966,36.77
21746,1,0,3,1,0,0,5,8690,54.42
21747,1,2,2,1,0,0,6,11521,68.36
21748,1,2,1,1,0,0,5,8690,54.42
21749,1,1,0,1,0,0,3,1352,17.01
21750,1,0,3,1,1,4,10,16522,90.12
21751,1,1,0,1,0,0,3,1352,17.01
21752,1,0,1,1,0,0,3,1352,17.01
21753,1,4,0,1,0,0,6,11521,68.36
21754,1,2,1,1,0,0,5,8690,54.42
21755,1,2,1,1,0,0,5,8690,54.42
21756,1,3,1,1,0,0,6,11521,68.36
21757,1,1,0,1,0,0,3,1352,17.01
21758,3,0,5,3,5,0,16,18081,97.67
21759,1,3,1,1,0,0,6,11521,68.36
21760,1,0,2,1,0,0,4,4966,36.77
21761,1,0,2,1,0,0,4,4966,36.77
21762,3,0,5,2,2,0,12,17186,93.28
21763,1,0,1,1,0,0,3,1352,17.01
21764,1,1,0,1,0,0,3,1352,17.01
21765,1,3,0,1,0,0,5,8690,54.42
21766,1,4,3,2,0,0,10,16522,90.12
21767,1,0,0,1,0,0,2,32,3.72
21768,1,1,1,1,0,0,4,4966,36.77
21769,1,0,3,1,1,6,12,17186,93.28
21770,1,3,1,1,0,0,6,11521,68.36
21771,1,1,1,1,0,6,10,16522,90.12
21772,1,2,0,1,0,0,4,4966,36.77
21773,1,1,0,1,0,0,3,1352,17.01
21774,1,0,1,1,0,0,3,1352,17.01
21775,1,2,2,1,0,0,6,11521,68.36
21776,1,0,0,0,0,0,1,1,0.08
21777,1,1,1,0,0,6,9,15950,87.44
21778,1,0,0,1,0,0,2,32,3.72
21779,1,1,0,1,0,0,3,1352,17.01
21780,1,0,0,1,0,0,2,32,3.72
21781,1,4,1,1,0,0,7,13868,78.23
21782,1,4,2,1,0,0,8,15186,83.84
21783,1,0,1,1,0,0,3,1352,17.01
21784,1,5,3,1,0,0,10,16522,90.12
21785,1,1,0,1,0,0,3,1352,17.01
21786,1,0,1,1,0,0,3,1352,17.01
21787,1,0,0,1,0,0,2,32,3.72
21788,1,1,2,1,0,0,5,8690,54.42
21789,1,1,2,1,1,0,6,11521,68.36
21790,1,5,1,1,0,0,8,15186,83.84
21791,1,1,1,1,0,0,4,4966,36.77
21792,1,0,0,1,0,2,4,4966,36.77
21793,1,0,0,1,0,0,2,32,3.72
21794,1,4,0,1,0,0,6,11521,68.36
21795,1,3,2,1,0,0,7,13868,78.23
21796,1,0,3,1,1,0,6,11521,68.36
21797,1,0,1,1,0,0,3,1352,17.01
21798,1,4,2,2,0,0,9,15950,87.44
21799,1,1,0,1,0,0,3,1352,17.01
21800,1,1,1,1,0,0,4,4966,36.77
21801,1,2,2,1,0,0,6,11521,68.36
21802,1,3,2,1,0,0,7,13868,78.23
21803,1,5,0,1,0,0,7,13868,78.23
21805,1,0,1,1,0,0,3,1352,17.01
21806,1,1,2,1,0,0,5,8690,54.42
21807,1,1,1,1,0,0,4,4966,36.77
21808,1,0,1,1,0,0,3,1352,17.01
21809,1,1,0,1,0,0,3,1352,17.01
21810,1,1,1,1,0,0,4,4966,36.77
21811,1,0,1,1,0,6,9,15950,87.44
21812,1,1,0,1,0,0,3,1352,17.01
21813,1,0,1,1,0,0,3,1352,17.01
21814,1,1,1,1,0,0,4,4966,36.77
21815,1,4,1,1,0,0,7,13868,78.23
21816,1,0,0,1,0,6,8,15186,83.84
21817,1,1,2,1,1,0,6,11521,68.36
21818,1,0,0,1,0,0,2,32,3.72
21819,1,4,0,1,0,0,6,11521,68.36
21820,1,0,1,1,0,0,3,1352,17.01
21821,1,0,1,1,0,0,3,1352,17.01
21822,1,0,2,1,0,0,4,4966,36.77
21823,1,2,1,1,0,0,5,8690,54.42
21824,1,4,0,1,0,0,6,11521,68.36
21825,1,0,1,1,0,0,3,1352,17.01
21826,1,0,1,1,0,0,3,1352,17.01
21827,1,4,0,1,0,0,6,11521,68.36
21828,1,5,2,1,0,0,9,15950,87.44
21829,1,1,2,1,0,0,5,8690,54.42
21830,1,0,0,1,0,0,2,32,3.72
21831,1,1,1,1,0,0,4,4966,36.77
21832,1,0,1,1,0,0,3,1352,17.01
21833,1,1,1,1,0,0,4,4966,36.77
21834,1,0,0,1,0,6,8,15186,83.84
21835,1,0,2,1,0,0,4,4966,36.77
21836,1,0,1,1,0,0,3,1352,17.01
21837,1,0,0,1,0,0,2,32,3.72
21838,1,1,1,1,0,0,4,4966,36.77
21839,1,1,0,1,1,0,4,4966,36.77
21840,1,0,3,1,0,0,5,8690,54.42
21841,1,4,0,1,0,0,6,11521,68.36
21842,1,1,0,1,0,0,3,1352,17.01
21843,1,2,0,1,0,0,4,4966,36.77
21844,1,3,0,1,0,0,5,8690,54.42
21845,1,1,1,1,0,0,4,4966,36.77
21846,1,1,0,1,0,0,3,1352,17.01
21847,1,0,2,1,0,4,8,15186,83.84
21848,1,0,0,1,0,0,2,32,3.72
21849,1,1,1,1,0,0,4,4966,36.77
21850,1,0,0,1,0,0,2,32,3.72
21851,1,0,1,1,0,0,3,1352,17.01
21852,1,3,0,1,0,0,5,8690,54.42
21853,1,0,0,1,0,0,2,32,3.72
21854,1,0,0,1,0,0,2,32,3.72
21855,1,0,2,1,0,0,4,4966,36.77
21856,1,0,3,1,0,10,15,17888,96.85
21857,1,0,0,1,0,0,2,32,3.72
21858,1,1,1,1,0,0,4,4966,36.77
21859,1,0,1,1,0,0,3,1352,17.01
21860,1,0,0,0,0,0,1,1,0.08
21861,1,1,1,1,0,0,4,4966,36.77
21862,1,0,1,1,0,2,5,8690,54.42
21863,1,2,1,1,0,0,5,8690,54.42
21864,1,2,1,1,0,0,5,8690,54.42
21865,1,0,0,1,0,0,2,32,3.72
21866,1,1,0,1,0,0,3,1352,17.01
21867,1,0,1,1,0,0,3,1352,17.01
21868,1,4,1,0,1,0,7,13868,78.23
21869,1,3,1,0,0,0,5,8690,54.42
21870,1,0,0,1,0,10,12,17186,93.28
21871,1,0,1,1,0,0,3,1352,17.01
21872,1,2,1,1,0,0,5,8690,54.42
21873,1,0,1,1,0,0,3,1352,17.01
21874,1,1,1,1,0,0,4,4966,36.77
21875,1,0,0,1,1,0,3,1352,17.01
21876,1,1,0,1,0,0,3,1352,17.01
21877,1,1,1,1,0,0,4,4966,36.77
21878,1,3,0,0,0,0,4,4966,36.77
21879,1,1,1,1,0,0,4,4966,36.77
21880,1,1,1,1,0,0,4,4966,36.77
21881,1,0,2,1,0,0,4,4966,36.77
21882,1,0,0,1,0,0,2,32,3.72
21883,1,0,3,2,1,0,7,13868,78.23
21884,1,0,3,1,0,0,5,8690,54.42
21885,1,0,2,1,0,0,4,4966,36.77
21886,1,4,0,1,0,0,6,11521,68.36
21888,1,0,0,1,0,0,2,32,3.72
21889,1,3,0,1,0,0,5,8690,54.42
21890,1,0,1,1,0,0,3,1352,17.01
21891,1,5,0,1,0,0,7,13868,78.23
21892,1,0,1,1,0,0,3,1352,17.01
21893,1,5,0,1,0,0,7,13868,78.23
21894,1,4,3,1,0,0,9,15950,87.44
21895,1,2,1,1,0,0,5,8690,54.42
21896,1,0,1,1,0,0,3,1352,17.01
21897,1,5,0,1,0,0,7,13868,78.23
21898,1,0,1,1,0,0,3,1352,17.01
21899,3,1,5,2,0,0,11,16947,91.91
21900,1,3,0,1,0,0,5,8690,54.42
21901,1,2,0,1,0,0,4,4966,36.77
21902,1,1,0,1,0,0,3,1352,17.01
21903,1,0,0,1,0,0,2,32,3.72
21904,1,0,1,1,0,0,3,1352,17.01
21905,1,1,0,1,0,0,3,1352,17.01
21906,1,0,4,2,0,0,7,13868,78.23
21907,1,0,2,1,0,0,4,4966,36.77
21908,1,4,1,1,0,0,7,13868,78.23
21909,1,0,2,1,1,10,15,17888,96.85
21910,1,2,2,1,0,0,6,11521,68.36
21911,1,0,1,1,0,0,3,1352,17.01
21912,1,1,2,1,0,0,5,8690,54.42
21913,1,1,2,1,0,4,9,15950,87.44
21914,1,0,2,1,0,0,4,4966,36.77
21915,1,0,1,1,0,0,3,1352,17.01
21916,1,1,1,1,0,2,6,11521,68.36
21917,1,0,0,1,0,0,2,32,3.72
21918,1,4,3,1,0,0,9,15950,87.44
21919,1,1,0,1,0,4,7,13868,78.23
21920,1,1,0,1,0,0,3,1352,17.01
21921,1,0,1,1,0,0,3,1352,17.01
21922,1,1,1,1,0,6,10,16522,90.12
21923,1,2,2,1,0,0,6,11521,68.36
21924,1,1,1,1,0,0,4,4966,36.77
21925,1,1,0,1,0,10,13,17456,94.66
21926,1,2,1,1,0,0,5,8690,54.42
21927,1,1,0,1,0,0,3,1352,17.01
21928,1,2,1,1,0,0,5,8690,54.42
21929,1,2,1,1,0,0,5,8690,54.42
21930,1,0,0,1,0,0,2,32,3.72
21931,1,1,2,1,0,0,5,8690,54.42
21932,1,0,4,2,0,0,7,13868,78.23
21933,1,1,1,1,0,0,4,4966,36.77
21934,1,0,1,1,0,0,3,1352,17.01
21935,1,0,3,1,3,0,8,15186,83.84
21936,1,1,1,1,0,0,4,4966,36.77
21937,1,1,1,1,0,0,4,4966,36.77
21938,1,0,4,1,1,4,11,16947,91.91
21939,1,3,0,1,0,0,5,8690,54.42
21940,1,0,1,1,0,0,3,1352,17.01
21941,1,1,1,1,0,0,4,4966,36.77
21942,1,0,1,1,0,0,3,1352,17.01
21943,1,3,1,1,0,6,12,17186,93.28
21944,1,2,0,1,0,0,4,4966,36.77
21945,1,2,2,1,0,0,6,11521,68.36
21946,1,4,2,1,0,0,8,15186,83.84
21947,1,1,1,1,0,0,4,4966,36.77
21948,1,0,1,1,0,2,5,8690,54.42
21949,1,4,0,1,0,0,6,11521,68.36
21950,1,1,2,1,0,0,5,8690,54.42
21951,1,4,0,1,0,0,6,11521,68.36
21952,1,0,1,1,0,0,3,1352,17.01
21953,1,4,0,1,0,0,6,11521,68.36
21954,1,0,1,1,0,0,3,1352,17.01
21955,1,3,1,1,0,0,6,11521,68.36
21956,1,0,0,1,0,0,2,32,3.72
21957,1,0,2,1,0,0,4,4966,36.77
21958,1,1,1,1,0,0,4,4966,36.77
21959,1,1,1,1,0,0,4,4966,36.77
21960,1,0,2,1,0,0,4,4966,36.77
21961,1,1,1,1,0,0,4,4966,36.77
21962,1,0,4,2,0,0,7,13868,78.23
21963,1,4,1,1,0,0,7,13868,78.23
21964,1,4,0,1,0,0,6,11521,68.36
21965,1,3,0,1,0,0,5,8690,54.42
21966,1,0,1,1,0,0,3,1352,17.01
21967,1,4,0,1,0,0,6,11521,68.36
21968,1,4,0,1,0,0,6,11521,68.36
21969,1,2,1,1,0,0,5,8690,54.42
21970,1,1,0,1,0,0,3,1352,17.01
21971,1,1,0,1,0,0,3,1352,17.01
21972,1,1,2,1,0,0,5,8690,54.42
21973,1,0,0,1,0,0,2,32,3.72
21974,1,0,0,1,0,0,2,32,3.72
21975,1,2,1,1,0,0,5,8690,54.42
21976,1,1,1,1,0,6,10,16522,90.12
21977,1,0,1,1,0,4,7,13868,78.23
21978,1,2,0,1,0,0,4,4966,36.77
21979,1,0,1,1,0,0,3,1352,17.01
21980,1,3,1,1,0,0,6,11521,68.36
21981,1,0,0,1,0,0,2,32,3.72
21982,1,1,1,1,0,0,4,4966,36.77
21983,1,0,1,1,0,0,3,1352,17.01
21984,1,1,1,1,0,0,4,4966,36.77
21985,1,1,2,1,0,0,5,8690,54.42
21986,1,0,1,1,0,4,7,13868,78.23
21987,1,0,1,1,0,0,3,1352,17.01
21988,1,0,3,1,1,0,6,11521,68.36
21989,1,0,1,1,0,6,9,15950,87.44
21990,1,4,0,1,0,0,6,11521,68.36
21991,1,0,1,1,1,10,14,17699,95.82
21992,1,1,1,1,0,0,4,4966,36.77
21993,1,3,0,1,0,0,5,8690,54.42
21994,1,3,2,1,0,0,7,13868,78.23
21995,1,1,0,1,0,0,3,1352,17.01
21996,1,0,3,1,1,6,12,17186,93.28
21997,1,0,4,1,1,10,17,18193,98.23
21998,1,0,1,1,0,0,3,1352,17.01
21999,1,2,0,1,0,0,4,4966,36.77
22000,1,4,0,1,0,0,6,11521,68.36
22001,1,0,0,1,0,0,2,32,3.72
22002,1,0,0,1,0,0,2,32,3.72
22003,1,0,2,1,0,0,4,4966,36.77
22004,1,1,1,1,0,0,4,4966,36.77
22005,1,5,1,1,0,0,8,15186,83.84
22006,1,0,2,1,0,0,4,4966,36.77
22007,1,4,1,1,0,0,7,13868,78.23
22008,1,3,0,1,0,0,5,8690,54.42
22009,1,2,1,1,0,0,5,8690,54.42
22010,1,0,1,1,0,0,3,1352,17.01
22011,1,2,0,1,0,0,4,4966,36.77
22012,1,0,1,1,0,0,3,1352,17.01
22013,1,0,1,1,0,0,3,1352,17.01
22014,1,1,0,1,0,0,3,1352,17.01
22015,1,1,0,1,0,0,3,1352,17.01
22016,1,0,4,2,1,0,8,15186,83.84
22017,1,4,1,1,1,0,8,15186,83.84
22018,1,2,1,1,0,0,5,8690,54.42
22019,1,2,0,1,0,0,4,4966,36.77
22020,1,4,3,1,0,0,9,15950,87.44
22021,1,4,2,2,0,0,9,15950,87.44
22022,1,0,1,1,0,0,3,1352,17.01
22023,1,0,2,1,0,0,4,4966,36.77
22024,1,2,1,1,0,0,5,8690,54.42
22025,1,1,0,1,0,0,3,1352,17.01
22026,1,0,0,1,0,0,2,32,3.72
22027,1,1,2,1,0,0,5,8690,54.42
22028,1,3,0,1,0,0,5,8690,54.42
22029,1,0,3,1,2,0,7,13868,78.23
22030,1,0,1,1,0,0,3,1352,17.01
22031,1,2,1,1,0,0,5,8690,54.42
22032,1,4,0,1,0,0,6,11521,68.36
22033,1,0,1,1,0,4,7,13868,78.23
22034,1,1,1,1,1,0,5,8690,54.42
22035,1,2,0,1,0,0,4,4966,36.77
22036,1,2,1,1,0,0,5,8690,54.42
22037,1,0,2,1,0,0,4,4966,36.77
22038,1,4,0,1,0,0,6,11521,68.36
22039,1,0,0,1,1,2,5,8690,54.42
22040,1,0,1,1,0,0,3,1352,17.01
22041,1,3,0,1,0,0,5,8690,54.42
22042,1,4,2,1,0,0,8,15186,83.84
22043,1,2,1,1,0,0,5,8690,54.42
22044,1,1,2,1,0,0,5,8690,54.42
22045,1,4,1,1,0,0,7,13868,78.23
22046,1,4,0,1,0,0,6,11521,68.36
22047,1,3,0,1,0,0,5,8690,54.42
22048,1,0,0,1,0,2,4,4966,36.77
22049,1,0,3,1,1,6,12,17186,93.28
22050,3,0,5,1,3,6,18,18287,98.68
22051,1,1,3,2,0,0,7,13868,78.23
22052,1,0,1,1,0,0,3,1352,17.01
22053,1,3,0,1,0,0,5,8690,54.42
22054,1,1,2,1,0,6,11,16947,91.91
22055,1,1,1,1,0,0,4,4966,36.77
22056,1,5,0,1,0,0,7,13868,78.23
22057,1,0,2,1,0,0,4,4966,36.77
22058,1,0,2,1,0,0,4,4966,36.77
22059,1,0,2,1,0,6,10,16522,90.12
22060,1,2,3,1,0,0,7,13868,78.23
22061,1,0,1,1,0,0,3,1352,17.01
22062,1,0,2,1,3,6,13,17456,94.66
22063,1,0,1,1,0,0,3,1352,17.01
22064,1,1,0,1,0,0,3,1352,17.01
22065,1,3,0,1,0,0,5,8690,54.42
22066,1,4,0,1,0,0,6,11521,68.36
22067,1,2,0,1,0,0,4,4966,36.77
22068,1,0,1,1,0,0,3,1352,17.01
22070,1,0,1,1,0,0,3,1352,17.01
22071,1,3,0,1,0,0,5,8690,54.42
22072,1,0,0,1,0,0,2,32,3.72
22073,1,0,1,1,0,0,3,1352,17.01
22074,1,2,1,1,0,0,5,8690,54.42
22075,1,0,2,1,0,0,4,4966,36.77
22076,1,0,2,1,0,0,4,4966,36.77
22077,1,1,1,1,0,0,4,4966,36.77
22078,1,3,1,1,0,0,6,11521,68.36
22079,1,3,1,1,0,0,6,11521,68.36
22080,1,0,1,1,0,0,3,1352,17.01
22081,1,0,0,1,0,0,2,32,3.72
22082,1,1,1,1,0,0,4,4966,36.77
22083,1,0,0,1,0,0,2,32,3.72
22084,1,1,1,1,0,0,4,4966,36.77
22086,1,0,1,1,0,0,3,1352,17.01
22087,1,4,3,1,0,0,9,15950,87.44
22088,1,1,1,1,0,0,4,4966,36.77
22089,3,4,5,4,4,0,20,18419,99.31
22090,1,3,1,1,0,0,6,11521,68.36
22091,1,5,0,1,0,0,7,13868,78.23
22092,1,2,0,1,0,0,4,4966,36.77
22093,1,0,1,1,0,0,3,1352,17.01
22094,1,0,0,1,0,0,2,32,3.72
22095,1,0,2,1,0,0,4,4966,36.77
22096,1,4,0,1,0,0,6,11521,68.36
22097,1,1,1,1,0,0,4,4966,36.77
22098,1,0,3,1,1,8,14,17699,95.82
22099,1,3,1,1,0,0,6,11521,68.36
22100,1,0,3,2,0,0,6,11521,68.36
22101,1,0,1,1,0,0,3,1352,17.01
22102,1,0,1,1,0,0,3,1352,17.01
22103,1,0,0,1,0,0,2,32,3.72
22104,1,1,1,1,0,0,4,4966,36.77
22105,1,1,0,1,0,0,3,1352,17.01
22106,1,1,0,1,0,0,3,1352,17.01
22107,1,1,0,1,0,0,3,1352,17.01
22108,1,4,0,1,0,0,6,11521,68.36
22109,1,0,0,1,0,0,2,32,3.72
22110,1,3,0,1,0,0,5,8690,54.42
22111,1,0,1,1,0,0,3,1352,17.01
22112,1,0,3,1,0,0,5,8690,54.42
22113,1,5,1,1,0,0,8,15186,83.84
22114,1,1,2,2,0,0,6,11521,68.36
22115,1,5,0,1,0,0,7,13868,78.23
22116,1,0,2,1,0,0,4,4966,36.77
22117,1,0,2,1,0,0,4,4966,36.77
22118,1,0,3,1,0,0,5,8690,54.42
22119,1,0,1,1,0,0,3,1352,17.01
22120,1,1,0,1,0,0,3,1352,17.01
22121,1,2,0,1,0,0,4,4966,36.77
22122,1,0,2,1,0,8,12,17186,93.28
22123,1,0,0,1,0,0,2,32,3.72
22124,1,0,2,1,0,0,4,4966,36.77
22125,1,4,1,1,0,0,7,13868,78.23
22126,1,2,3,1,0,0,7,13868,78.23
22127,1,1,2,1,0,2,7,13868,78.23
22128,1,0,2,1,0,0,4,4966,36.77
22129,1,2,2,1,0,0,6,11521,68.36
22130,1,2,0,1,0,0,4,4966,36.77
22131,1,4,1,1,0,0,7,13868,78.23
22133,1,0,0,1,0,0,2,32,3.72
22134,1,2,0,1,0,0,4,4966,36.77
22135,1,2,0,1,0,0,4,4966,36.77
22136,1,4,1,1,1,0,8,15186,83.84
22137,1,1,1,1,0,6,10,16522,90.12
22138,1,0,2,1,1,0,5,8690,54.42
22139,1,0,2,1,0,6,10,16522,90.12
22140,1,1,0,1,0,0,3,1352,17.01
22141,1,1,1,1,0,10,14,17699,95.82
22142,1,0,4,2,0,0,7,13868,78.23
22143,1,0,0,1,0,0,2,32,3.72
22144,1,3,0,1,0,0,5,8690,54.42
22145,1,4,0,0,0,0,5,8690,54.42
22146,1,0,0,1,0,0,2,32,3.72
22147,1,0,3,1,1,10,16,18081,97.67
22148,1,0,1,1,0,0,3,1352,17.01
22149,1,0,1,1,0,0,3,1352,17.01
22150,1,2,0,1,0,0,4,4966,36.77
22151,1,1,0,1,0,0,3,1352,17.01
22152,1,1,0,1,0,0,3,1352,17.01
22153,1,0,1,1,0,0,3,1352,17.01
22154,1,0,1,1,0,6,9,15950,87.44
22155,1,1,0,1,0,0,3,1352,17.01
22156,1,4,0,1,0,0,6,11521,68.36
22157,1,1,2,1,0,0,5,8690,54.42
22158,1,0,0,1,0,0,2,32,3.72
22159,1,1,0,1,0,0,3,1352,17.01
22160,1,0,2,1,0,0,4,4966,36.77
22161,1,0,0,1,0,0,2,32,3.72
22162,1,0,0,1,0,0,2,32,3.72
22163,1,1,0,1,0,0,3,1352,17.01
22164,1,3,0,1,0,0,5,8690,54.42
22165,1,1,1,1,1,0,5,8690,54.42
22166,1,2,1,1,0,0,5,8690,54.42
22167,1,0,2,1,0,0,4,4966,36.77
22168,1,0,1,1,0,4,7,13868,78.23
22169,1,1,1,1,0,0,4,4966,36.77
22170,1,4,5,1,0,0,11,16947,91.91
22171,1,0,2,1,0,0,4,4966,36.77
22172,1,0,2,1,1,0,5,8690,54.42
22173,1,0,1,1,0,0,3,1352,17.01
22174,1,2,1,1,0,0,5,8690,54.42
22175,1,1,1,1,0,0,4,4966,36.77
22176,1,3,0,1,0,0,5,8690,54.42
22177,1,0,1,1,0,0,3,1352,17.01
22178,1,4,0,1,0,0,6,11521,68.36
22179,1,1,1,1,0,0,4,4966,36.77
22180,1,0,2,1,0,0,4,4966,36.77
22181,1,3,0,1,0,0,5,8690,54.42
22182,1,0,2,1,0,0,4,4966,36.77
22183,1,0,0,1,0,6,8,15186,83.84
22184,1,2,0,1,0,0,4,4966,36.77
22185,1,0,3,1,0,0,5,8690,54.42
22186,1,1,2,1,0,0,5,8690,54.42
22187,1,2,1,1,0,0,5,8690,54.42
22188,1,1,0,0,0,0,2,32,3.72
22189,1,4,1,1,0,0,7,13868,78.23
22190,1,1,0,1,0,0,3,1352,17.01
22191,1,0,0,1,0,0,2,32,3.72
22192,1,3,0,1,0,0,5,8690,54.42
22193,1,0,1,1,0,0,3,1352,17.01
22194,1,0,1,1,0,0,3,1352,17.01
22195,1,1,0,1,0,0,3,1352,17.01
22196,1,4,0,1,0,0,6,11521,68.36
22197,1,2,1,1,0,0,5,8690,54.42
22198,1,1,0,1,0,0,3,1352,17.01
22199,1,0,3,1,0,0,5,8690,54.42
22200,1,3,0,1,0,0,5,8690,54.42
22201,1,2,1,1,0,0,5,8690,54.42
22202,1,5,3,1,0,0,10,16522,90.12
22203,1,1,1,1,0,6,10,16522,90.12
22204,1,0,1,1,0,0,3,1352,17.01
22205,1,1,2,1,1,0,6,11521,68.36
22206,1,0,1,1,0,0,3,1352,17.01
22207,1,0,1,1,0,0,3,1352,17.01
22208,1,4,0,1,0,0,6,11521,68.36
22209,1,1,3,1,0,0,6,11521,68.36
22210,1,1,1,1,0,0,4,4966,36.77
22211,1,0,1,1,0,0,3,1352,17.01
22212,1,1,1,1,0,0,4,4966,36.77
22213,1,0,1,1,0,0,3,1352,17.01
22214,1,0,2,1,0,0,4,4966,36.77
22215,1,2,0,1,0,0,4,4966,36.77
22216,1,2,1,1,0,0,5,8690,54.42
22217,1,1,1,1,0,0,4,4966,36.77
22218,1,2,2,1,0,0,6,11521,68.36
22219,1,4,1,1,0,0,7,13868,78.23
22220,1,0,3,1,0,0,5,8690,54.42
22221,1,3,1,1,0,0,6,11521,68.36
22222,1,1,1,1,0,0,4,4966,36.77
22223,1,1,1,1,0,0,4,4966,36.77
22224,1,1,1,1,0,0,4,4966,36.77
22225,1,1,2,1,0,0,5,8690,54.42
22226,1,0,5,1,3,0,10,16522,90.12
22227,1,0,2,1,0,0,4,4966,36.77
22228,1,0,3,1,0,0,5,8690,54.42
22229,1,0,1,1,0,0,3,1352,17.01
22230,1,3,1,1,1,0,7,13868,78.23
22231,1,0,2,1,0,0,4,4966,36.77
22232,1,0,1,1,0,0,3,1352,17.01
22233,1,0,1,1,0,0,3,1352,17.01
22234,1,2,0,1,0,0,4,4966,36.77
22235,1,2,1,1,0,0,5,8690,54.42
22236,1,0,1,1,0,0,3,1352,17.01
22237,1,0,1,1,0,0,3,1352,17.01
22238,1,0,1,1,0,0,3,1352,17.01
22239,1,0,2,1,0,0,4,4966,36.77
22240,1,3,0,1,0,0,5,8690,54.42
22241,1,1,2,1,0,0,5,8690,54.42
22242,1,5,3,2,0,0,11,16947,91.91
22243,1,1,0,1,0,0,3,1352,17.01
22244,1,1,2,1,1,0,6,11521,68.36
22245,1,2,0,1,0,0,4,4966,36.77
22246,1,1,5,1,0,0,8,15186,83.84
22247,1,3,1,1,0,0,6,11521,68.36
22248,1,1,1,1,0,0,4,4966,36.77
22249,1,0,0,1,0,0,2,32,3.72
22250,1,1,0,1,0,0,3,1352,17.01
22251,1,0,2,1,2,0,6,11521,68.36
22252,1,1,0,1,0,0,3,1352,17.01
22253,1,2,3,2,0,0,8,15186,83.84
22254,1,0,3,2,2,0,8,15186,83.84
22255,1,1,1,1,0,0,4,4966,36.77
22256,1,1,0,1,0,0,3,1352,17.01
22257,1,1,1,1,0,0,4,4966,36.77
22258,1,2,0,1,0,0,4,4966,36.77
22259,1,1,0,1,0,0,3,1352,17.01
22260,1,0,3,1,0,0,5,8690,54.42
22261,1,0,0,1,0,0,2,32,3.72
22262,1,0,1,1,0,0,3,1352,17.01
22263,1,0,2,1,0,0,4,4966,36.77
22264,1,2,0,1,0,0,4,4966,36.77
22265,1,4,0,1,0,0,6,11521,68.36
22266,1,0,2,1,0,0,4,4966,36.77
22267,1,0,3,1,0,0,5,8690,54.42
22268,1,1,0,1,0,0,3,1352,17.01
22269,1,2,0,1,0,0,4,4966,36.77
22270,1,0,0,1,0,0,2,32,3.72
22271,1,2,0,1,0,0,4,4966,36.77
22272,1,3,1,1,0,0,6,11521,68.36
22273,1,1,0,1,0,0,3,1352,17.01
22274,1,0,1,1,1,0,4,4966,36.77
22275,1,1,0,1,0,0,3,1352,17.01
22276,1,1,0,1,0,0,3,1352,17.01
22277,1,2,1,1,0,0,5,8690,54.42
22278,1,0,4,1,0,0,6,11521,68.36
22279,1,2,0,1,0,0,4,4966,36.77
22280,1,2,1,1,0,0,5,8690,54.42
22281,1,2,1,1,0,0,5,8690,54.42
22282,1,0,1,1,0,0,3,1352,17.01
22283,1,1,1,1,0,0,4,4966,36.77
22284,1,0,1,1,0,2,5,8690,54.42
22285,1,0,1,1,0,0,3,1352,17.01
22286,1,1,1,1,0,0,4,4966,36.77
22287,1,0,2,1,0,6,10,16522,90.12
22288,1,0,2,1,0,0,4,4966,36.77
22289,1,3,1,1,0,0,6,11521,68.36
22290,1,1,2,1,0,0,5,8690,54.42
22291,1,2,0,1,0,0,4,4966,36.77
22292,1,1,1,1,0,0,4,4966,36.77
22293,1,0,1,1,0,0,3,1352,17.01
22294,1,2,0,1,0,0,4,4966,36.77
22295,1,0,1,1,0,0,3,1352,17.01
22296,1,1,1,1,0,0,4,4966,36.77
22297,1,3,2,1,0,0,7,13868,78.23
22298,1,0,1,1,0,0,3,1352,17.01
22299,1,3,1,1,0,0,6,11521,68.36
22300,1,4,0,1,0,0,6,11521,68.36
22301,1,1,2,1,0,0,5,8690,54.42
22302,1,4,2,1,0,0,8,15186,83.84
22303,1,3,1,1,0,0,6,11521,68.36
22304,1,1,1,1,0,0,4,4966,36.77
22305,1,1,0,1,0,0,3,1352,17.01
22306,1,0,1,1,0,0,3,1352,17.01
22307,1,1,1,1,0,0,4,4966,36.77
22308,1,0,1,1,0,0,3,1352,17.01
22309,1,1,1,1,0,0,4,4966,36.77
22310,1,0,1,1,0,0,3,1352,17.01
22311,1,0,1,1,0,0,3,1352,17.01
22312,1,4,0,1,0,0,6,11521,68.36
22313,1,2,2,1,0,0,6,11521,68.36
22314,1,3,0,1,1,0,6,11521,68.36
22315,1,2,1,1,0,0,5,8690,54.42
22316,1,0,0,1,0,0,2,32,3.72
22317,1,1,2,1,0,0,5,8690,54.42
22318,1,0,2,1,0,0,4,4966,36.77
22319,1,1,1,1,0,0,4,4966,36.77
22320,1,1,1,1,0,0,4,4966,36.77
22321,1,1,1,1,0,0,4,4966,36.77
22322,1,2,0,1,0,0,4,4966,36.77
22323,1,0,1,1,0,0,3,1352,17.01
22324,1,0,1,1,4,0,7,13868,78.23
22325,1,2,0,1,0,0,4,4966,36.77
22326,1,3,1,1,1,0,7,13868,78.23
22327,1,4,1,1,0,0,7,13868,78.23
22328,1,4,0,1,0,0,6,11521,68.36
22329,1,0,1,1,0,0,3,1352,17.01
22330,1,1,0,1,0,0,3,1352,17.01
22331,1,1,0,1,0,0,3,1352,17.01
22332,1,1,1,1,0,0,4,4966,36.77
22333,1,0,1,1,0,0,3,1352,17.01
22334,1,1,0,1,0,0,3,1352,17.01
22335,1,1,0,1,0,0,3,1352,17.01
22336,1,4,4,1,0,0,10,16522,90.12
22337,1,0,2,1,1,4,9,15950,87.44
22338,1,3,1,1,0,0,6,11521,68.36
22339,1,0,2,1,0,0,4,4966,36.77
22340,1,3,0,1,0,0,5,8690,54.42
22341,1,3,0,1,0,0,5,8690,54.42
22342,1,1,1,1,0,0,4,4966,36.77
22343,1,0,1,0,0,0,2,32,3.72
22344,1,0,2,1,0,0,4,4966,36.77
22345,1,3,0,1,0,0,5,8690,54.42
22346,1,0,0,1,0,2,4,4966,36.77
22347,1,1,1,1,0,0,4,4966,36.77
22348,1,0,0,1,0,0,2,32,3.72
22349,1,0,2,1,0,0,4,4966,36.77
22350,1,0,0,1,0,0,2,32,3.72
22351,1,0,3,1,0,0,5,8690,54.42
22352,1,4,0,1,0,0,6,11521,68.36
22353,1,1,0,1,0,0,3,1352,17.01
22354,1,1,0,1,0,6,9,15950,87.44
22355,1,3,1,1,0,0,6,11521,68.36
22356,1,2,1,1,0,0,5,8690,54.42
22357,1,0,0,1,0,0,2,32,3.72
22358,1,1,0,1,0,0,3,1352,17.01
22359,1,4,0,1,0,0,6,11521,68.36
22360,1,4,0,1,0,0,6,11521,68.36
22361,1,0,0,1,0,0,2,32,3.72
22362,1,3,0,1,0,0,5,8690,54.42
22363,1,0,1,1,0,0,3,1352,17.01
22364,1,3,1,1,0,0,6,11521,68.36
22365,1,4,0,1,0,0,6,11521,68.36
22366,1,0,1,1,0,0,3,1352,17.01
22367,1,1,1,1,0,0,4,4966,36.77
22368,1,1,2,1,0,0,5,8690,54.42
22369,1,3,0,1,0,0,5,8690,54.42
22370,1,4,2,1,0,0,8,15186,83.84
22371,1,1,2,1,1,0,6,11521,68.36
22372,1,0,1,1,0,0,3,1352,17.01
22373,1,1,0,1,0,0,3,1352,17.01
22374,1,4,0,1,0,0,6,11521,68.36
22375,1,1,1,1,0,0,4,4966,36.77
22376,1,3,1,1,0,0,6,11521,68.36
22377,1,5,0,1,0,0,7,13868,78.23
22378,1,1,1,1,0,0,4,4966,36.77
22379,1,0,1,1,0,0,3,1352,17.01
22380,1,4,0,1,0,0,6,11521,68.36
22381,1,2,0,1,0,0,4,4966,36.77
22382,1,1,2,1,0,0,5,8690,54.42
22383,1,0,1,1,0,0,3,1352,17.01
22384,1,2,2,1,0,0,6,11521,68.36
22385,1,3,2,1,0,0,7,13868,78.23
22386,1,1,2,1,0,0,5,8690,54.42
22387,1,0,3,1,0,0,5,8690,54.42
22388,1,5,1,1,0,0,8,15186,83.84
22389,1,1,1,1,0,0,4,4966,36.77
22390,1,0,1,1,0,10,13,17456,94.66
22391,1,0,5,1,0,0,7,13868,78.23
22392,1,0,0,1,0,10,12,17186,93.28
22393,3,1,5,2,2,0,13,17456,94.66
22394,1,2,0,1,0,0,4,4966,36.77
22395,1,3,0,1,0,0,5,8690,54.42
22396,1,4,1,1,0,0,7,13868,78.23
22397,1,1,0,1,0,0,3,1352,17.01
22398,3,4,5,4,3,0,19,18362,99.04
22399,1,0,2,1,0,0,4,4966,36.77
22400,1,0,2,1,0,0,4,4966,36.77
22401,1,1,3,1,0,0,6,11521,68.36
22402,1,0,5,1,0,0,7,13868,78.23
22403,1,3,2,1,0,0,7,13868,78.23
22404,1,2,0,1,0,0,4,4966,36.77
22405,1,1,0,1,0,0,3,1352,17.01
22406,1,0,1,1,0,6,9,15950,87.44
22407,1,2,3,2,0,0,8,15186,83.84
22408,1,1,2,1,0,0,5,8690,54.42
22409,1,5,1,1,0,0,8,15186,83.84
22410,1,0,0,1,0,0,2,32,3.72
22411,1,3,0,1,0,0,5,8690,54.42
22412,1,4,3,1,0,0,9,15950,87.44
22413,1,2,0,1,0,0,4,4966,36.77
22414,1,2,2,1,0,0,6,11521,68.36
22415,1,0,2,1,0,0,4,4966,36.77
22416,1,0,1,1,0,0,3,1352,17.01
22417,1,3,0,1,0,0,5,8690,54.42
22418,1,2,1,1,0,0,5,8690,54.42
22419,1,2,1,1,0,0,5,8690,54.42
22420,1,0,1,1,0,0,3,1352,17.01
22421,1,3,0,1,0,0,5,8690,54.42
22422,1,0,1,1,0,0,3,1352,17.01
22423,1,3,0,1,0,0,5,8690,54.42
22424,1,1,2,1,0,0,5,8690,54.42
22425,1,0,0,1,1,0,3,1352,17.01
22426,1,0,2,1,0,0,4,4966,36.77
22427,1,0,1,1,0,0,3,1352,17.01
22428,1,0,0,1,0,0,2,32,3.72
22429,1,0,2,1,0,0,4,4966,36.77
22430,1,0,3,1,1,6,12,17186,93.28
22431,1,4,0,1,0,0,6,11521,68.36
22432,1,3,1,1,0,0,6,11521,68.36
22433,1,1,1,1,0,0,4,4966,36.77
22434,1,1,1,1,0,0,4,4966,36.77
22435,1,3,0,1,0,0,5,8690,54.42
22436,1,4,0,2,0,0,7,13868,78.23
22437,1,2,0,1,0,0,4,4966,36.77
22438,1,3,0,1,0,0,5,8690,54.42
22439,1,1,1,1,0,0,4,4966,36.77
22440,1,1,0,1,0,0,3,1352,17.01
22441,1,0,0,1,0,0,2,32,3.72
22442,1,0,3,1,0,0,5,8690,54.42
22443,1,0,1,1,0,0,3,1352,17.01
22444,3,4,5,4,4,0,20,18419,99.31
22445,1,0,3,1,0,0,5,8690,54.42
22446,3,1,5,4,5,0,18,18287,98.68
22447,1,4,0,1,0,0,6,11521,68.36
22448,1,4,1,1,0,0,7,13868,78.23
22449,1,2,0,1,0,0,4,4966,36.77
22450,1,0,2,1,0,0,4,4966,36.77
22451,1,1,1,1,0,0,4,4966,36.77
22452,1,1,1,1,0,0,4,4966,36.77
22453,1,1,1,0,0,0,3,1352,17.01
22454,1,2,0,1,0,0,4,4966,36.77
22455,1,0,1,1,0,0,3,1352,17.01
22456,1,1,1,1,0,4,8,15186,83.84
22457,1,2,0,1,0,0,4,4966,36.77
22458,1,0,3,1,1,0,6,11521,68.36
22459,1,0,1,1,0,0,3,1352,17.01
22460,1,4,2,1,0,0,8,15186,83.84
22461,1,0,0,1,0,0,2,32,3.72
22462,1,0,1,1,0,0,3,1352,17.01
22463,1,1,0,1,0,6,9,15950,87.44
22464,1,1,2,1,0,0,5,8690,54.42
22465,1,0,0,1,0,0,2,32,3.72
22466,1,0,2,1,0,0,4,4966,36.77
22467,1,1,1,1,0,6,10,16522,90.12
22468,1,0,1,1,0,4,7,13868,78.23
22469,1,4,0,1,0,0,6,11521,68.36
22470,1,1,1,1,0,0,4,4966,36.77
22471,1,1,2,1,2,0,7,13868,78.23
22472,1,1,1,1,0,0,4,4966,36.77
22473,1,3,0,1,0,0,5,8690,54.42
22474,1,2,2,1,0,0,6,11521,68.36
22475,1,2,0,1,0,0,4,4966,36.77
22476,1,2,1,1,0,0,5,8690,54.42
22477,1,4,2,1,0,0,8,15186,83.84
22478,1,4,1,1,0,0,7,13868,78.23
22479,1,4,2,2,0,0,9,15950,87.44
22480,1,3,0,1,0,0,5,8690,54.42
22481,1,0,0,1,0,0,2,32,3.72
22482,1,2,0,1,0,0,4,4966,36.77
22483,1,5,1,1,0,0,8,15186,83.84
22484,1,0,1,1,0,0,3,1352,17.01
22485,1,3,0,1,0,0,5,8690,54.42
22486,1,3,0,1,0,0,5,8690,54.42
22487,1,0,0,1,0,0,2,32,3.72
22488,1,0,1,1,2,0,5,8690,54.42
22489,1,5,2,1,0,0,9,15950,87.44
22490,1,1,3,1,0,0,6,11521,68.36
22491,1,0,1,1,0,0,3,1352,17.01
22492,1,0,2,1,0,0,4,4966,36.77
22493,1,0,1,1,0,0,3,1352,17.01
22494,1,0,2,1,0,0,4,4966,36.77
22495,1,1,2,1,0,0,5,8690,54.42
22496,1,2,1,1,0,0,5,8690,54.42
22497,1,1,1,1,0,0,4,4966,36.77
22498,1,3,0,0,0,0,4,4966,36.77
22499,1,2,2,1,0,6,12,17186,93.28
22500,1,0,1,1,0,0,3,1352,17.01
22501,1,0,1,1,0,0,3,1352,17.01
22502,1,0,1,1,0,0,3,1352,17.01
22503,1,1,1,1,0,0,4,4966,36.77
22504,1,0,2,1,0,0,4,4966,36.77
22505,1,2,1,1,0,0,5,8690,54.42
22506,1,1,1,1,0,0,4,4966,36.77
22507,1,1,0,1,0,0,3,1352,17.01
22508,1,0,1,1,0,0,3,1352,17.01
22509,1,1,1,1,0,0,4,4966,36.77
22510,1,0,2,1,0,0,4,4966,36.77
22511,1,1,1,1,0,0,4,4966,36.77
22512,1,4,0,1,0,0,6,11521,68.36
22513,1,1,0,1,0,0,3,1352,17.01
22514,1,4,0,1,0,0,6,11521,68.36
22515,1,1,0,1,0,0,3,1352,17.01
22516,1,1,2,1,0,0,5,8690,54.42
22517,1,0,1,1,0,0,3,1352,17.01
22518,1,4,2,1,0,0,8,15186,83.84
22519,1,0,1,1,0,0,3,1352,17.01
22521,1,4,0,1,0,0,6,11521,68.36
22522,1,5,0,1,0,0,7,13868,78.23
22523,1,1,1,1,0,0,4,4966,36.77
22524,1,1,0,1,0,0,3,1352,17.01
22525,1,1,1,1,0,0,4,4966,36.77
22526,1,0,1,1,0,6,9,15950,87.44
22527,1,1,1,1,0,0,4,4966,36.77
22528,1,0,1,1,0,0,3,1352,17.01
22529,1,1,0,1,0,0,3,1352,17.01
22530,1,2,1,1,0,0,5,8690,54.42
22531,1,2,0,1,0,0,4,4966,36.77
22532,1,1,1,1,0,0,4,4966,36.77
22533,1,0,0,1,0,0,2,32,3.72
22534,1,2,1,1,0,0,5,8690,54.42
22535,1,4,0,1,0,0,6,11521,68.36
22536,1,4,0,1,0,0,6,11521,68.36
22537,1,0,1,1,0,0,3,1352,17.01
22538,1,2,1,1,0,0,5,8690,54.42
22539,1,3,0,1,0,0,5,8690,54.42
22540,1,4,1,1,0,0,7,13868,78.23
22541,1,0,1,1,0,0,3,1352,17.01
22542,1,0,2,1,0,0,4,4966,36.77
22543,1,0,1,1,0,0,3,1352,17.01
22544,1,3,1,1,0,0,6,11521,68.36
22545,1,0,1,1,0,0,3,1352,17.01
22546,3,3,5,2,3,0,16,18081,97.67
22547,1,0,2,1,0,2,6,11521,68.36
22548,1,3,2,1,0,0,7,13868,78.23
22549,1,4,2,1,0,0,8,15186,83.84
22550,1,0,1,1,0,0,3,1352,17.01
22551,1,0,0,1,0,0,2,32,3.72
22552,1,0,1,1,0,4,7,13868,78.23
22553,1,1,1,1,0,0,4,4966,36.77
22554,1,0,4,1,0,0,6,11521,68.36
22555,1,0,2,2,0,0,5,8690,54.42
22556,1,2,0,1,0,0,4,4966,36.77
22557,1,2,1,1,0,0,5,8690,54.42
22558,1,0,1,1,0,0,3,1352,17.01
22559,1,1,0,1,0,0,3,1352,17.01
22560,1,0,2,1,0,0,4,4966,36.77
22561,1,0,0,1,0,0,2,32,3.72
22562,1,4,3,1,0,0,9,15950,87.44
22563,1,4,1,1,0,0,7,13868,78.23
22564,1,0,1,1,0,0,3,1352,17.01
22565,1,0,0,1,0,0,2,32,3.72
22566,1,4,0,1,0,0,6,11521,68.36
22567,1,0,0,1,0,0,2,32,3.72
22568,1,2,1,1,0,0,5,8690,54.42
22569,1,2,1,1,0,0,5,8690,54.42
22570,1,0,1,1,0,10,13,17456,94.66
22571,1,4,2,2,0,0,9,15950,87.44
22572,1,4,0,1,0,0,6,11521,68.36
22573,1,1,1,1,0,0,4,4966,36.77
22574,1,0,2,1,0,0,4,4966,36.77
22575,1,2,1,1,0,0,5,8690,54.42
22576,1,3,0,1,0,0,5,8690,54.42
22577,1,1,2,1,1,0,6,11521,68.36
22578,1,0,2,1,0,6,10,16522,90.12
22579,1,0,0,1,0,0,2,32,3.72
22580,1,1,0,1,0,0,3,1352,17.01
22581,1,0,1,1,0,0,3,1352,17.01
22582,1,0,2,1,0,0,4,4966,36.77
22584,3,0,4,1,3,0,11,16947,91.91
22585,1,2,1,1,0,0,5,8690,54.42
22586,1,0,1,1,0,0,3,1352,17.01
22587,1,2,0,1,0,0,4,4966,36.77
22588,1,0,0,1,0,6,8,15186,83.84
22589,1,0,0,1,0,0,2,32,3.72
22590,1,2,0,1,0,0,4,4966,36.77
22591,1,0,2,1,1,0,5,8690,54.42
22592,1,0,1,1,0,0,3,1352,17.01
22593,1,0,3,1,0,0,5,8690,54.42
22594,1,4,0,1,0,0,6,11521,68.36
22595,1,0,2,1,0,0,4,4966,36.77
22596,1,0,0,1,0,0,2,32,3.72
22597,1,0,2,1,0,0,4,4966,36.77
22598,1,3,1,1,0,0,6,11521,68.36
22599,1,0,2,1,0,0,4,4966,36.77
22600,1,2,3,1,0,0,7,13868,78.23
22601,1,0,3,1,1,0,6,11521,68.36
22602,1,0,0,1,0,0,2,32,3.72
22603,1,1,0,1,2,0,5,8690,54.42
22604,1,0,0,1,0,0,2,32,3.72
22605,1,0,2,1,0,0,4,4966,36.77
22606,1,4,0,1,0,0,6,11521,68.36
22607,1,0,1,1,0,0,3,1352,17.01
22608,1,1,2,1,0,0,5,8690,54.42
22609,1,4,0,1,0,0,6,11521,68.36
22610,1,2,0,1,0,0,4,4966,36.77
22611,1,4,0,1,0,0,6,11521,68.36
22612,1,0,0,1,0,0,2,32,3.72
22613,1,1,1,1,0,0,4,4966,36.77
22614,1,1,1,1,0,0,4,4966,36.77
22615,1,4,2,1,0,0,8,15186,83.84
22616,1,0,4,1,0,0,6,11521,68.36
22617,1,0,1,1,1,6,10,16522,90.12
22618,1,4,1,1,0,0,7,13868,78.23
22619,1,2,0,1,0,0,4,4966,36.77
22620,1,1,1,1,0,0,4,4966,36.77
22621,1,4,3,1,0,0,9,15950,87.44
22622,1,0,1,1,0,0,3,1352,17.01
22623,1,0,1,1,0,0,3,1352,17.01
22624,1,2,1,1,0,0,5,8690,54.42
22625,1,0,1,1,0,0,3,1352,17.01
22626,1,3,2,1,0,0,7,13868,78.23
22627,1,0,1,1,0,0,3,1352,17.01
22628,1,4,0,1,0,0,6,11521,68.36
22629,1,1,2,1,0,0,5,8690,54.42
22630,1,2,0,1,0,0,4,4966,36.77
22631,1,1,0,1,0,0,3,1352,17.01
22632,1,1,1,1,0,0,4,4966,36.77
22633,1,2,1,1,1,0,6,11521,68.36
22634,1,4,2,1,0,0,8,15186,83.84
22635,3,0,5,1,2,6,17,18193,98.23
22636,1,1,1,1,0,0,4,4966,36.77
22637,1,0,0,1,0,2,4,4966,36.77
22638,1,0,0,1,0,0,2,32,3.72
22639,1,3,0,1,0,0,5,8690,54.42
22641,1,1,1,1,0,0,4,4966,36.77
22642,1,2,0,1,0,0,4,4966,36.77
22643,1,1,1,1,0,0,4,4966,36.77
22644,1,0,2,1,0,0,4,4966,36.77
22645,1,0,2,1,0,0,4,4966,36.77
22646,1,0,1,1,0,0,3,1352,17.01
22647,1,3,0,1,0,0,5,8690,54.42
22648,1,0,0,1,0,0,2,32,3.72
22649,1,4,0,1,0,0,6,11521,68.36
22650,1,2,0,1,0,0,4,4966,36.77
22651,1,2,1,1,0,0,5,8690,54.42
22652,1,1,1,1,0,0,4,4966,36.77
22653,1,0,1,1,0,0,3,1352,17.01
22654,1,1,1,1,0,0,4,4966,36.77
22655,1,0,1,1,0,6,9,15950,87.44
22656,1,2,1,1,0,0,5,8690,54.42
22657,1,1,2,1,0,0,5,8690,54.42
22658,1,2,1,1,0,0,5,8690,54.42
22659,1,2,1,1,0,0,5,8690,54.42
22660,1,0,0,1,0,0,2,32,3.72
22661,1,0,4,1,0,0,6,11521,68.36
22662,1,0,1,1,0,0,3,1352,17.01
22663,1,2,3,1,0,0,7,13868,78.23
22664,1,1,1,1,0,0,4,4966,36.77
22665,1,1,0,1,0,0,3,1352,17.01
22666,1,1,1,1,0,0,4,4966,36.77
22667,1,2,1,1,0,0,5,8690,54.42
22668,1,0,1,1,0,0,3,1352,17.01
22669,1,2,1,1,0,0,5,8690,54.42
22670,1,1,0,1,0,0,3,1352,17.01
22671,1,3,1,1,0,0,6,11521,68.36
22672,1,1,0,1,0,0,3,1352,17.01
22673,1,0,2,1,0,0,4,4966,36.77
22674,1,3,0,1,0,0,5,8690,54.42
22675,1,0,2,1,0,0,4,4966,36.77
22676,1,4,3,2,0,0,10,16522,90.12
22677,1,0,2,1,1,0,5,8690,54.42
22678,1,0,1,1,0,0,3,1352,17.01
22679,1,1,0,0,0,0,2,32,3.72
22680,1,2,1,1,0,0,5,8690,54.42
22681,1,0,1,1,0,0,3,1352,17.01
22682,1,1,1,1,0,0,4,4966,36.77
22683,1,2,0,1,0,0,4,4966,36.77
22684,1,0,2,1,1,0,5,8690,54.42
22685,1,2,2,1,1,0,7,13868,78.23
22686,1,1,3,1,0,0,6,11521,68.36
22687,1,0,5,1,0,0,7,13868,78.23
22688,1,4,2,1,0,0,8,15186,83.84
22689,1,0,1,1,0,2,5,8690,54.42
22690,1,1,1,1,0,0,4,4966,36.77
22691,1,1,1,0,0,6,9,15950,87.44
22692,1,4,0,1,0,0,6,11521,68.36
22693,1,2,3,2,0,0,8,15186,83.84
22694,1,0,1,1,0,0,3,1352,17.01
22695,1,1,0,1,0,0,3,1352,17.01
22696,1,1,2,1,0,0,5,8690,54.42
22697,1,0,3,1,0,0,5,8690,54.42
22699,1,1,0,1,0,0,3,1352,17.01
22700,1,1,0,1,0,0,3,1352,17.01
22701,1,0,0,1,0,0,2,32,3.72
22702,1,0,1,1,0,0,3,1352,17.01
22703,1,1,1,1,0,0,4,4966,36.77
22704,1,0,1,1,0,0,3,1352,17.01
22705,1,0,0,1,0,0,2,32,3.72
22706,1,4,1,1,0,0,7,13868,78.23
22707,1,2,0,1,0,0,4,4966,36.77
22708,1,1,1,1,0,0,4,4966,36.77
22709,1,0,2,1,0,0,4,4966,36.77
22710,1,1,1,1,0,0,4,4966,36.77
22711,1,1,1,1,0,4,8,15186,83.84
22712,1,0,1,1,0,0,3,1352,17.01
22713,1,0,2,1,0,0,4,4966,36.77
22714,1,0,2,1,0,0,4,4966,36.77
22715,1,0,2,1,0,0,4,4966,36.77
22716,1,0,3,1,2,0,7,13868,78.23
22717,1,0,1,1,0,0,3,1352,17.01
22718,1,0,0,0,0,0,1,1,0.08
22719,1,0,0,1,0,0,2,32,3.72
22720,1,2,1,1,0,0,5,8690,54.42
22721,1,3,0,1,0,0,5,8690,54.42
22722,1,0,1,1,0,0,3,1352,17.01
22723,1,0,2,1,1,0,5,8690,54.42
22724,1,0,1,1,1,0,4,4966,36.77
22725,1,0,1,1,0,0,3,1352,17.01
22726,1,0,2,1,0,0,4,4966,36.77
22727,1,0,4,1,2,0,8,15186,83.84
22728,1,5,0,1,0,0,7,13868,78.23
22729,1,0,0,1,0,0,2,32,3.72
22730,1,0,1,1,0,0,3,1352,17.01
22731,1,0,1,1,0,0,3,1352,17.01
22732,1,0,3,1,1,0,6,11521,68.36
22733,1,0,4,1,0,0,6,11521,68.36
22734,1,0,2,0,1,0,4,4966,36.77
22735,1,0,2,1,1,0,5,8690,54.42
22736,1,1,0,1,0,0,3,1352,17.01
22737,1,1,1,1,0,0,4,4966,36.77
22738,1,0,2,1,0,0,4,4966,36.77
22739,1,0,2,1,1,6,11,16947,91.91
22740,1,1,1,1,0,2,6,11521,68.36
22741,1,1,1,1,0,6,10,16522,90.12
22742,1,0,1,1,0,0,3,1352,17.01
22743,1,1,1,1,0,0,4,4966,36.77
22744,1,0,0,1,0,0,2,32,3.72
22745,1,2,1,1,0,0,5,8690,54.42
22746,1,4,0,1,0,0,6,11521,68.36
22747,1,3,1,1,0,0,6,11521,68.36
22748,1,2,2,1,0,0,6,11521,68.36
22749,1,0,2,1,0,0,4,4966,36.77
22750,1,0,1,1,0,0,3,1352,17.01
22751,1,0,2,1,0,0,4,4966,36.77
22752,1,0,2,1,0,0,4,4966,36.77
22753,1,3,1,1,0,0,6,11521,68.36
22754,1,1,0,0,0,0,2,32,3.72
22755,1,5,3,1,0,0,10,16522,90.12
22756,1,1,1,1,0,0,4,4966,36.77
22757,1,3,0,1,0,0,5,8690,54.42
22758,1,1,1,1,0,0,4,4966,36.77
22759,1,4,1,1,0,0,7,13868,78.23
22760,1,2,0,1,0,0,4,4966,36.77
22761,1,3,0,1,0,0,5,8690,54.42
22762,1,1,1,1,0,0,4,4966,36.77
22763,1,1,0,1,0,0,3,1352,17.01
22764,1,1,1,1,0,0,4,4966,36.77
22765,1,0,1,1,0,0,3,1352,17.01
22766,1,0,0,1,0,0,2,32,3.72
22767,1,1,2,1,0,0,5,8690,54.42
22768,1,1,1,1,0,0,4,4966,36.77
22769,1,4,0,1,0,0,6,11521,68.36
22770,1,0,4,1,2,0,8,15186,83.84
22771,1,1,0,1,0,0,3,1352,17.01
22772,1,4,0,1,0,0,6,11521,68.36
22773,1,1,1,1,0,0,4,4966,36.77
22774,1,2,0,1,0,0,4,4966,36.77
22775,1,1,1,1,0,0,4,4966,36.77
22776,1,1,0,1,0,0,3,1352,17.01
22777,1,2,0,1,0,0,4,4966,36.77
22778,1,0,0,1,0,0,2,32,3.72
22779,1,0,2,1,0,0,4,4966,36.77
22780,1,0,0,1,0,0,2,32,3.72
22781,1,1,0,1,0,0,3,1352,17.01
22782,1,2,0,1,0,0,4,4966,36.77
22783,1,0,3,1,0,8,13,17456,94.66
22784,1,1,1,1,0,0,4,4966,36.77
22785,1,0,4,2,0,0,7,13868,78.23
22786,1,4,1,1,0,0,7,13868,78.23
22787,1,0,3,1,0,0,5,8690,54.42
22788,1,0,2,1,1,0,5,8690,54.42
22789,1,4,1,1,0,0,7,13868,78.23
22790,1,0,0,1,0,0,2,32,3.72
22791,1,0,1,1,0,0,3,1352,17.01
22792,1,0,1,1,0,0,3,1352,17.01
22793,3,0,5,2,2,0,12,17186,93.28
22794,1,0,1,1,0,0,3,1352,17.01
22795,1,1,1,1,0,0,4,4966,36.77
22796,1,1,1,1,0,0,4,4966,36.77
22797,1,1,0,1,0,0,3,1352,17.01
22798,1,0,1,1,0,0,3,1352,17.01
22799,4,4,5,4,5,0,22,18498,99.73
22800,1,0,2,1,0,0,4,4966,36.77
22801,3,2,5,5,3,0,18,18287,98.68
22802,1,3,3,1,0,0,8,15186,83.84
22803,1,2,2,1,0,0,6,11521,68.36
22804,1,4,2,1,3,0,11,16947,91.91
22805,1,0,4,1,1,0,7,13868,78.23
22806,1,1,0,1,0,4,7,13868,78.23
22807,1,1,1,1,0,0,4,4966,36.77
22808,1,0,1,1,0,0,3,1352,17.01
22809,1,3,0,1,0,0,5,8690,54.42
22810,1,0,1,1,0,0,3,1352,17.01
22811,1,0,2,1,0,0,4,4966,36.77
22812,1,0,2,1,0,6,10,16522,90.12
22813,1,0,1,1,0,0,3,1352,17.01
22814,1,1,0,1,0,0,3,1352,17.01
22815,1,1,1,1,0,0,4,4966,36.77
22816,1,1,1,1,0,0,4,4966,36.77
22817,1,0,1,1,0,0,3,1352,17.01
22818,1,1,0,1,0,0,3,1352,17.01
22819,1,0,1,1,0,0,3,1352,17.01
22820,1,1,0,1,0,0,3,1352,17.01
22821,1,3,0,1,0,0,5,8690,54.42
22822,1,4,1,1,0,0,7,13868,78.23
22823,1,1,0,1,0,0,3,1352,17.01
22824,1,0,1,1,0,0,3,1352,17.01
22825,1,0,1,1,0,0,3,1352,17.01
22826,1,3,1,1,0,0,6,11521,68.36
22827,1,1,1,1,0,0,4,4966,36.77
22828,1,0,1,1,0,0,3,1352,17.01
22829,1,1,0,1,0,0,3,1352,17.01
22830,1,2,1,1,0,0,5,8690,54.42
22831,1,0,0,1,0,0,2,32,3.72
22832,1,2,0,1,0,0,4,4966,36.77
22833,1,4,0,1,0,0,6,11521,68.36
22834,1,1,1,1,0,0,4,4966,36.77
22835,1,0,0,1,0,0,2,32,3.72
22836,1,3,1,1,0,0,6,11521,68.36
22837,1,0,1,1,0,0,3,1352,17.01
22838,1,0,0,1,0,0,2,32,3.72
22839,1,0,1,1,0,0,3,1352,17.01
22840,1,1,2,1,0,0,5,8690,54.42
22841,1,0,0,1,0,0,2,32,3.72
22842,1,4,0,1,0,0,6,11521,68.36
22843,1,1,0,1,0,0,3,1352,17.01
22844,1,1,3,2,0,0,7,13868,78.23
22845,1,3,0,1,0,0,5,8690,54.42
22846,1,2,0,1,0,0,4,4966,36.77
22847,1,0,1,1,0,0,3,1352,17.01
22848,1,0,1,1,0,0,3,1352,17.01
22849,1,0,0,1,0,0,2,32,3.72
22850,1,0,1,1,0,0,3,1352,17.01
22851,1,0,1,0,0,2,4,4966,36.77
22852,1,4,0,1,0,0,6,11521,68.36
22853,1,1,0,1,0,0,3,1352,17.01
22854,1,1,1,1,0,0,4,4966,36.77
22855,3,2,3,2,3,0,13,17456,94.66
22856,1,0,1,1,0,0,3,1352,17.01
22857,1,2,1,1,0,0,5,8690,54.42
22858,1,1,3,1,0,0,6,11521,68.36
22859,1,1,1,1,0,4,8,15186,83.84
22861,1,4,1,1,0,0,7,13868,78.23
22862,1,1,0,1,0,0,3,1352,17.01
22863,1,2,0,1,0,0,4,4966,36.77
22864,1,0,1,1,0,0,3,1352,17.01
22865,1,2,1,1,0,0,5,8690,54.42
22867,1,2,1,1,0,0,5,8690,54.42
22868,1,0,1,1,0,0,3,1352,17.01
22869,1,2,1,1,0,0,5,8690,54.42
22870,1,0,0,1,0,0,2,32,3.72
22871,1,0,1,1,1,0,4,4966,36.77
22872,1,0,1,1,0,0,3,1352,17.01
22873,1,0,2,1,0,0,4,4966,36.77
22874,1,3,0,1,0,0,5,8690,54.42
22875,1,0,0,1,0,0,2,32,3.72
22876,1,0,2,1,0,0,4,4966,36.77
22877,1,0,2,1,0,0,4,4966,36.77
22878,1,0,0,1,0,0,2,32,3.72
22879,1,2,2,1,0,0,6,11521,68.36
22880,1,2,1,1,0,0,5,8690,54.42
22881,1,0,1,1,0,0,3,1352,17.01
22882,1,0,1,1,0,6,9,15950,87.44
22883,1,0,4,1,1,6,13,17456,94.66
22884,1,0,4,2,1,6,14,17699,95.82
22885,1,3,0,1,0,0,5,8690,54.42
22886,1,1,1,1,0,0,4,4966,36.77
22887,1,0,0,1,0,0,2,32,3.72
22888,1,1,0,1,0,0,3,1352,17.01
22889,1,1,0,1,0,0,3,1352,17.01
22890,1,0,2,1,0,0,4,4966,36.77
22891,1,1,0,1,0,0,3,1352,17.01
22892,1,3,0,1,0,0,5,8690,54.42
22893,1,0,1,1,0,0,3,1352,17.01
22894,1,5,0,1,0,0,7,13868,78.23
22895,1,0,2,1,1,4,9,15950,87.44
22896,1,0,1,1,0,0,3,1352,17.01
22897,1,3,2,1,0,0,7,13868,78.23
22898,1,0,2,1,0,4,8,15186,83.84
22899,1,1,2,1,0,0,5,8690,54.42
22900,3,3,3,2,2,0,13,17456,94.66
22901,1,2,1,1,0,0,5,8690,54.42
22902,1,4,0,1,0,0,6,11521,68.36
22903,3,3,3,2,2,0,13,17456,94.66
22904,4,4,5,4,5,0,22,18498,99.73
22905,1,4,1,1,0,0,7,13868,78.23
22906,3,1,5,1,3,6,19,18362,99.04
22907,1,3,2,1,0,0,7,13868,78.23
22908,1,0,1,1,0,0,3,1352,17.01
22909,1,0,0,1,0,0,2,32,3.72
22910,1,0,3,1,0,0,5,8690,54.42
22911,1,2,1,1,0,0,5,8690,54.42
22912,1,0,1,1,0,4,7,13868,78.23
22913,1,0,2,1,1,0,5,8690,54.42
22914,1,1,1,1,0,0,4,4966,36.77
22915,1,0,1,1,0,6,9,15950,87.44
22916,1,0,1,1,0,0,3,1352,17.01
22917,1,3,1,1,0,0,6,11521,68.36
22918,1,0,2,1,0,0,4,4966,36.77
22919,1,1,1,1,0,0,4,4966,36.77
22920,1,1,0,1,0,0,3,1352,17.01
22921,1,1,0,1,0,0,3,1352,17.01
22922,1,0,0,1,0,0,2,32,3.72
22923,1,0,0,1,0,0,2,32,3.72
22924,1,0,2,1,0,0,4,4966,36.77
22925,1,0,0,1,0,0,2,32,3.72
22926,1,4,0,1,0,0,6,11521,68.36
22927,1,0,1,1,0,0,3,1352,17.01
22928,1,0,1,1,0,6,9,15950,87.44
22929,1,0,2,1,0,0,4,4966,36.77
22930,1,1,2,1,0,0,5,8690,54.42
22931,1,0,1,1,0,0,3,1352,17.01
22932,1,3,0,1,0,0,5,8690,54.42
22933,1,1,1,1,0,0,4,4966,36.77
22934,1,4,0,1,0,0,6,11521,68.36
22935,1,3,1,1,0,0,6,11521,68.36
22936,1,2,1,1,0,0,5,8690,54.42
22937,1,0,0,1,0,0,2,32,3.72
22938,1,1,1,1,0,0,4,4966,36.77
22939,1,4,0,1,0,0,6,11521,68.36
22940,1,1,2,1,0,0,5,8690,54.42
22941,1,1,2,1,0,0,5,8690,54.42
22942,1,0,1,1,0,0,3,1352,17.01
22943,1,3,3,1,0,0,8,15186,83.84
22944,1,2,3,1,0,0,7,13868,78.23
22945,1,3,3,1,0,0,8,15186,83.84
22946,1,0,1,1,0,4,7,13868,78.23
22947,1,4,0,1,0,0,6,11521,68.36
22948,1,1,0,1,0,0,3,1352,17.01
22949,1,1,2,1,0,2,7,13868,78.23
22950,1,3,0,1,0,0,5,8690,54.42
22951,1,1,0,1,0,0,3,1352,17.01
22952,1,0,1,1,0,0,3,1352,17.01
22953,1,0,4,1,0,0,6,11521,68.36
22954,1,4,0,1,0,0,6,11521,68.36
22955,1,2,1,1,0,0,5,8690,54.42
22956,1,3,1,1,0,0,6,11521,68.36
22957,1,0,2,1,0,0,4,4966,36.77
22958,1,1,1,1,0,0,4,4966,36.77
22959,1,2,1,1,0,0,5,8690,54.42
22960,1,0,1,1,0,0,3,1352,17.01
22961,1,0,1,1,0,6,9,15950,87.44
22962,1,1,1,1,0,0,4,4966,36.77
22963,3,0,3,1,1,10,18,18287,98.68
22964,1,1,2,1,0,0,5,8690,54.42
22965,1,1,1,1,0,0,4,4966,36.77
22966,1,0,4,1,3,0,9,15950,87.44
22967,1,4,0,1,0,0,6,11521,68.36
22968,1,1,3,1,0,0,6,11521,68.36
22969,1,0,1,1,0,0,3,1352,17.01
22970,1,0,3,1,2,0,7,13868,78.23
22971,4,0,5,1,2,0,12,17186,93.28
22972,3,0,5,5,0,0,13,17456,94.66
22973,1,1,1,1,0,4,8,15186,83.84
22974,1,0,0,1,0,0,2,32,3.72
22975,1,2,2,1,0,0,6,11521,68.36
22976,1,1,2,1,0,0,5,8690,54.42
22978,1,3,1,1,0,0,6,11521,68.36
22979,1,1,2,1,0,0,5,8690,54.42
22980,1,1,0,1,0,0,3,1352,17.01
22981,1,0,2,1,0,0,4,4966,36.77
22982,1,3,1,1,0,0,6,11521,68.36
22983,1,0,1,1,0,0,3,1352,17.01
22984,1,1,1,1,0,0,4,4966,36.77
22985,1,1,3,1,0,0,6,11521,68.36
22986,1,0,0,1,0,0,2,32,3.72
22987,1,4,0,1,0,0,6,11521,68.36
22988,1,2,0,1,2,0,6,11521,68.36
22989,1,0,1,1,0,0,3,1352,17.01
22990,1,2,4,2,0,0,9,15950,87.44
22991,1,1,1,1,0,4,8,15186,83.84
22992,1,2,0,0,0,0,3,1352,17.01
22993,1,0,2,1,0,0,4,4966,36.77
22994,1,0,1,1,0,0,3,1352,17.01
22995,1,0,0,1,0,0,2,32,3.72
22996,1,0,1,1,0,0,3,1352,17.01
22997,1,0,2,1,0,0,4,4966,36.77
22998,1,0,2,1,0,8,12,17186,93.28
22999,1,0,2,1,1,0,5,8690,54.42
23000,1,4,0,1,0,0,6,11521,68.36
23001,1,0,0,1,0,0,2,32,3.72
23002,1,2,1,1,0,4,9,15950,87.44
23003,1,1,1,1,0,0,4,4966,36.77
23004,1,2,0,0,0,0,3,1352,17.01
23005,1,2,0,1,0,0,4,4966,36.77
23006,1,0,1,1,0,0,3,1352,17.01
23007,1,0,1,1,0,0,3,1352,17.01
23008,1,0,2,1,0,0,4,4966,36.77
23009,1,2,3,1,0,0,7,13868,78.23
23010,1,0,2,1,0,0,4,4966,36.77
23011,1,1,3,1,0,0,6,11521,68.36
23012,1,0,2,1,0,0,4,4966,36.77
23013,1,1,1,1,0,0,4,4966,36.77
23014,1,1,1,1,0,6,10,16522,90.12
23015,1,4,0,1,0,0,6,11521,68.36
23016,1,2,0,1,0,0,4,4966,36.77
23017,1,1,0,0,0,0,2,32,3.72
23018,1,0,1,1,0,0,3,1352,17.01
23019,1,2,1,1,0,0,5,8690,54.42
23020,1,3,1,1,0,0,6,11521,68.36
23021,1,0,1,1,2,0,5,8690,54.42
23022,1,4,0,1,0,0,6,11521,68.36
23023,1,4,0,1,0,0,6,11521,68.36
23024,1,4,0,1,0,0,6,11521,68.36
23025,1,1,2,1,1,0,6,11521,68.36
23026,1,0,1,1,0,0,3,1352,17.01
23027,1,3,2,1,0,0,7,13868,78.23
23028,1,2,1,1,0,0,5,8690,54.42
23029,1,3,0,1,0,0,5,8690,54.42
23030,1,3,1,1,0,0,6,11521,68.36
23031,1,1,0,1,0,0,3,1352,17.01
23032,1,1,0,1,0,0,3,1352,17.01
23033,1,0,2,1,0,0,4,4966,36.77
23034,1,0,0,1,0,0,2,32,3.72
23035,1,4,0,1,0,0,6,11521,68.36
23036,1,0,3,1,1,0,6,11521,68.36
23037,1,0,0,1,0,6,8,15186,83.84
23038,1,1,0,1,0,0,3,1352,17.01
23039,1,1,0,1,0,0,3,1352,17.01
23040,1,1,1,1,0,0,4,4966,36.77
23041,1,1,0,1,0,0,3,1352,17.01
23042,1,4,0,1,1,0,7,13868,78.23
23043,1,1,2,1,0,0,5,8690,54.42
23044,1,0,0,1,0,6,8,15186,83.84
23045,1,2,1,1,0,0,5,8690,54.42
23046,1,0,1,1,0,0,3,1352,17.01
23047,1,3,1,1,0,0,6,11521,68.36
23048,1,0,1,1,0,0,3,1352,17.01
23049,1,1,0,1,0,0,3,1352,17.01
23050,1,0,2,1,1,6,11,16947,91.91
23051,1,0,2,1,1,6,11,16947,91.91
23052,1,2,1,1,1,0,6,11521,68.36
23053,1,0,1,1,0,0,3,1352,17.01
23054,1,0,0,1,0,0,2,32,3.72
23055,1,0,4,1,0,0,6,11521,68.36
23056,1,0,2,1,0,6,10,16522,90.12
23057,1,0,1,1,0,6,9,15950,87.44
23058,1,1,2,1,0,0,5,8690,54.42
23059,1,0,0,1,0,0,2,32,3.72
23060,1,0,1,1,0,0,3,1352,17.01
23061,1,4,2,1,0,0,8,15186,83.84
23062,1,3,1,1,0,0,6,11521,68.36
23063,1,0,3,1,0,0,5,8690,54.42
23064,1,0,3,1,0,0,5,8690,54.42
23065,1,1,1,1,0,0,4,4966,36.77
23066,1,0,3,1,0,0,5,8690,54.42
23067,1,0,2,1,0,0,4,4966,36.77
23068,1,0,1,1,0,2,5,8690,54.42
23069,1,1,0,1,0,0,3,1352,17.01
23070,1,3,1,1,0,0,6,11521,68.36
23071,1,2,1,1,0,0,5,8690,54.42
23072,1,0,0,1,0,0,2,32,3.72
23073,1,0,1,1,0,0,3,1352,17.01
23074,1,1,1,1,0,0,4,4966,36.77
23075,1,0,1,1,0,0,3,1352,17.01
23076,1,3,0,1,0,0,5,8690,54.42
23077,1,0,2,1,0,0,4,4966,36.77
23078,1,1,2,1,0,0,5,8690,54.42
23079,1,4,1,1,0,0,7,13868,78.23
23080,1,0,2,1,3,0,7,13868,78.23
23081,1,0,1,1,0,0,3,1352,17.01
23082,4,4,5,4,5,0,22,18498,99.73
23083,1,0,0,1,0,0,2,32,3.72
23084,1,0,2,1,0,0,4,4966,36.77
23085,1,0,1,1,0,0,3,1352,17.01
23086,1,1,1,1,0,0,4,4966,36.77
23087,1,0,1,1,0,0,3,1352,17.01
23088,1,3,0,1,0,0,5,8690,54.42
23089,1,0,0,1,0,0,2,32,3.72
23090,1,0,1,1,0,4,7,13868,78.23
23091,3,0,4,2,3,4,16,18081,97.67
23092,1,4,0,1,0,0,6,11521,68.36
23093,1,3,0,1,0,0,5,8690,54.42
23094,1,1,2,1,0,0,5,8690,54.42
23095,1,3,1,1,0,0,6,11521,68.36
23096,1,1,0,1,0,0,3,1352,17.01
23097,1,4,2,1,0,0,8,15186,83.84
23098,1,1,1,1,0,0,4,4966,36.77
23099,1,0,1,1,0,0,3,1352,17.01
23100,1,0,1,1,0,0,3,1352,17.01
23101,1,1,0,1,0,0,3,1352,17.01
23102,1,0,1,1,0,0,3,1352,17.01
23103,1,1,1,1,0,0,4,4966,36.77
23104,1,4,0,1,0,0,6,11521,68.36
23105,3,4,3,2,2,0,14,17699,95.82
23106,1,2,1,1,0,0,5,8690,54.42
23107,3,0,5,5,5,0,18,18287,98.68
23108,3,2,3,2,2,0,12,17186,93.28
23109,1,1,2,1,0,0,5,8690,54.42
23110,1,0,0,1,0,0,2,32,3.72
23111,1,4,2,2,0,0,9,15950,87.44
23112,1,5,2,2,0,0,10,16522,90.12
23113,1,0,1,1,0,0,3,1352,17.01
23114,1,4,0,1,0,0,6,11521,68.36
23115,1,1,1,1,0,0,4,4966,36.77
23116,1,0,0,1,0,0,2,32,3.72
23117,1,1,1,1,0,0,4,4966,36.77
23118,1,2,1,1,0,0,5,8690,54.42
23119,1,4,1,1,0,0,7,13868,78.23
23120,1,1,1,1,0,0,4,4966,36.77
23121,1,1,0,1,0,0,3,1352,17.01
23122,1,2,2,1,0,0,6,11521,68.36
23123,1,1,1,1,0,0,4,4966,36.77
23124,1,0,2,1,0,0,4,4966,36.77
23125,1,4,1,1,0,0,7,13868,78.23
23126,1,0,1,1,0,6,9,15950,87.44
23127,1,0,1,1,0,6,9,15950,87.44
23128,1,0,3,0,0,0,4,4966,36.77
23129,1,0,1,1,0,0,3,1352,17.01
23130,1,3,0,1,0,0,5,8690,54.42
23131,1,0,0,1,0,0,2,32,3.72
23132,1,0,1,1,0,0,3,1352,17.01
23133,1,1,0,1,0,0,3,1352,17.01
23134,1,0,2,1,0,0,4,4966,36.77
23135,1,3,2,1,0,0,7,13868,78.23
23136,1,0,2,1,0,0,4,4966,36.77
23137,3,0,4,1,5,0,13,17456,94.66
23138,1,1,2,1,0,0,5,8690,54.42
23139,1,4,0,1,0,0,6,11521,68.36
23140,1,4,0,1,0,0,6,11521,68.36
23141,1,0,0,1,0,0,2,32,3.72
23142,1,0,4,2,1,0,8,15186,83.84
23143,1,0,0,1,0,6,8,15186,83.84
23144,1,2,2,1,0,0,6,11521,68.36
23145,1,2,1,1,0,0,5,8690,54.42
23146,1,0,1,1,0,0,3,1352,17.01
23147,1,0,4,1,2,0,8,15186,83.84
23148,1,4,2,1,0,0,8,15186,83.84
23149,1,3,1,1,0,0,6,11521,68.36
23150,1,2,1,1,0,0,5,8690,54.42
23151,1,2,0,1,0,0,4,4966,36.77
23152,1,2,1,1,0,0,5,8690,54.42
23153,1,0,1,1,0,0,3,1352,17.01
23154,1,0,0,1,0,0,2,32,3.72
23155,1,1,1,1,0,0,4,4966,36.77
23156,1,0,0,1,0,0,2,32,3.72
23157,1,0,0,1,0,0,2,32,3.72
23158,1,0,0,1,0,6,8,15186,83.84
23159,1,0,2,1,1,6,11,16947,91.91
23160,1,0,1,1,0,4,7,13868,78.23
23161,1,1,0,1,0,0,3,1352,17.01
23162,1,3,3,1,0,0,8,15186,83.84
23163,1,0,2,1,0,0,4,4966,36.77
23164,1,0,3,1,0,0,5,8690,54.42
23165,1,1,1,1,0,0,4,4966,36.77
23166,1,0,3,2,3,0,9,15950,87.44
23167,1,5,3,1,0,0,10,16522,90.12
23168,1,4,2,1,0,0,8,15186,83.84
23169,1,1,0,1,0,0,3,1352,17.01
23170,1,3,1,1,0,0,6,11521,68.36
23171,1,2,0,1,0,0,4,4966,36.77
23172,1,0,0,1,0,0,2,32,3.72
23173,1,0,1,1,0,0,3,1352,17.01
23174,1,2,0,1,0,0,4,4966,36.77
23175,1,5,2,2,0,0,10,16522,90.12
23176,1,0,0,1,0,0,2,32,3.72
23177,1,0,2,1,0,0,4,4966,36.77
23178,1,0,1,1,0,0,3,1352,17.01
23179,1,0,1,1,1,0,4,4966,36.77
23180,1,0,1,1,0,0,3,1352,17.01
23181,1,2,1,1,0,0,5,8690,54.42
23182,1,0,3,1,0,0,5,8690,54.42
23183,1,1,0,1,0,0,3,1352,17.01
23184,1,2,1,1,0,0,5,8690,54.42
23185,1,0,1,1,0,0,3,1352,17.01
23186,1,1,0,1,0,0,3,1352,17.01
23187,1,1,1,1,0,0,4,4966,36.77
23188,1,0,1,1,0,0,3,1352,17.01
23189,1,0,0,1,0,0,2,32,3.72
23190,1,3,1,1,0,0,6,11521,68.36
23191,1,0,1,1,1,6,10,16522,90.12
23192,1,4,1,1,0,0,7,13868,78.23
23193,1,0,1,1,0,0,3,1352,17.01
23194,1,2,2,1,0,0,6,11521,68.36
23195,1,0,2,1,0,0,4,4966,36.77
23196,1,0,3,1,0,0,5,8690,54.42
23197,1,0,0,1,0,0,2,32,3.72
23198,1,0,1,1,0,0,3,1352,17.01
23199,1,3,0,1,0,0,5,8690,54.42
23200,1,0,3,1,0,2,7,13868,78.23
23201,1,0,2,1,1,0,5,8690,54.42
23202,1,0,1,1,0,0,3,1352,17.01
23203,1,0,1,1,0,0,3,1352,17.01
23204,3,0,4,1,2,8,18,18287,98.68
23205,1,1,2,1,0,0,5,8690,54.42
23206,1,1,1,1,0,0,4,4966,36.77
23207,1,0,0,1,0,0,2,32,3.72
23208,1,0,0,1,0,0,2,32,3.72
23209,1,1,2,1,0,0,5,8690,54.42
23210,1,1,1,1,0,4,8,15186,83.84
23211,1,4,1,1,0,0,7,13868,78.23
23212,1,0,1,1,0,0,3,1352,17.01
23213,3,0,5,1,3,6,18,18287,98.68
23214,1,2,1,1,0,0,5,8690,54.42
23215,1,0,2,1,0,0,4,4966,36.77
23216,1,4,0,1,0,0,6,11521,68.36
23217,1,0,1,1,0,0,3,1352,17.01
23218,1,2,1,1,0,0,5,8690,54.42
23219,1,0,2,1,0,0,4,4966,36.77
23220,1,3,0,1,0,0,5,8690,54.42
23221,1,0,2,1,0,0,4,4966,36.77
23222,1,4,1,1,0,0,7,13868,78.23
23223,1,0,1,1,0,0,3,1352,17.01
23224,1,0,3,1,0,0,5,8690,54.42
23225,1,0,1,1,0,0,3,1352,17.01
23226,1,2,1,1,0,0,5,8690,54.42
23227,1,0,0,1,0,6,8,15186,83.84
23228,1,0,0,1,0,0,2,32,3.72
23229,1,0,1,1,0,0,3,1352,17.01
23230,1,3,1,1,0,4,10,16522,90.12
23231,1,0,2,1,0,0,4,4966,36.77
23232,1,0,2,1,0,6,10,16522,90.12
23233,1,1,1,1,0,0,4,4966,36.77
23234,1,0,1,1,0,6,9,15950,87.44
23235,1,1,0,1,0,0,3,1352,17.01
23236,1,2,3,1,0,0,7,13868,78.23
23237,1,0,0,1,0,0,2,32,3.72
23238,1,0,1,1,0,0,3,1352,17.01
23239,1,0,1,1,0,0,3,1352,17.01
23240,1,0,3,1,0,0,5,8690,54.42
23241,4,0,5,1,4,0,14,17699,95.82
23242,1,4,2,1,0,0,8,15186,83.84
23243,1,0,4,2,1,0,8,15186,83.84
23244,1,1,0,1,0,0,3,1352,17.01
23245,1,1,1,1,0,0,4,4966,36.77
23246,1,2,0,1,0,0,4,4966,36.77
23247,1,1,1,1,0,0,4,4966,36.77
23248,1,4,2,2,0,0,9,15950,87.44
23249,1,2,2,1,0,0,6,11521,68.36
23250,1,0,0,1,0,0,2,32,3.72
23251,1,2,1,1,0,6,11,16947,91.91
23252,1,0,5,1,0,0,7,13868,78.23
23253,1,3,2,1,0,0,7,13868,78.23
23254,1,0,1,1,0,0,3,1352,17.01
23255,1,4,0,1,0,0,6,11521,68.36
23256,1,1,0,1,0,0,3,1352,17.01
23257,1,0,1,1,0,0,3,1352,17.01
23258,1,3,1,1,0,0,6,11521,68.36
23259,1,1,1,1,0,0,4,4966,36.77
23260,1,1,0,1,0,0,3,1352,17.01
23261,1,0,2,1,0,0,4,4966,36.77
23262,1,0,0,1,0,0,2,32,3.72
23263,1,2,1,1,0,0,5,8690,54.42
23264,1,4,0,1,0,0,6,11521,68.36
23265,1,1,0,1,0,0,3,1352,17.01
23266,1,3,2,1,0,0,7,13868,78.23
23267,1,0,2,1,0,0,4,4966,36.77
23268,1,1,2,1,0,0,5,8690,54.42
23269,1,0,2,1,0,0,4,4966,36.77
23270,1,2,1,1,0,0,5,8690,54.42
23271,1,2,1,1,0,0,5,8690,54.42
23272,1,1,1,1,1,0,5,8690,54.42
23273,1,2,1,1,0,0,5,8690,54.42
23274,1,5,0,1,0,0,7,13868,78.23
23275,1,1,2,1,0,0,5,8690,54.42
23276,1,0,1,1,0,0,3,1352,17.01
23277,1,3,0,1,0,0,5,8690,54.42
23278,1,0,1,1,0,0,3,1352,17.01
23279,1,1,0,1,0,0,3,1352,17.01
23280,1,3,2,1,1,0,8,15186,83.84
23281,1,0,0,1,0,6,8,15186,83.84
23282,1,4,2,1,1,0,9,15950,87.44
23283,1,0,5,1,0,0,7,13868,78.23
23284,1,0,2,1,0,0,4,4966,36.77
23285,1,0,2,1,0,0,4,4966,36.77
23286,1,1,5,1,0,0,8,15186,83.84
23287,1,2,0,1,0,0,4,4966,36.77
23288,1,1,1,1,0,0,4,4966,36.77
23289,3,0,5,1,3,6,18,18287,98.68
23290,1,3,1,1,0,0,6,11521,68.36
23291,1,4,1,1,0,0,7,13868,78.23
23292,1,0,2,1,0,6,10,16522,90.12
23293,1,1,0,1,0,0,3,1352,17.01
23294,1,1,3,2,0,0,7,13868,78.23
23295,1,0,2,1,0,6,10,16522,90.12
23296,1,3,2,1,0,0,7,13868,78.23
23298,1,3,1,1,0,0,6,11521,68.36
23299,1,3,0,1,0,0,5,8690,54.42
23300,1,4,0,1,0,0,6,11521,68.36
23301,1,0,0,1,0,0,2,32,3.72
23302,1,2,1,1,0,0,5,8690,54.42
23303,1,0,1,1,0,2,5,8690,54.42
23304,1,1,1,1,0,0,4,4966,36.77
23305,1,2,2,1,0,0,6,11521,68.36
23306,1,0,1,1,0,0,3,1352,17.01
23307,1,4,0,1,0,0,6,11521,68.36
23308,1,1,1,1,0,0,4,4966,36.77
23309,1,2,0,1,0,0,4,4966,36.77
23310,1,1,2,1,0,0,5,8690,54.42
23311,1,0,1,1,0,0,3,1352,17.01
23312,1,1,2,1,0,0,5,8690,54.42
23313,1,0,2,1,0,0,4,4966,36.77
23314,1,0,1,1,0,0,3,1352,17.01
23315,1,4,0,1,0,0,6,11521,68.36
23316,1,0,1,1,0,6,9,15950,87.44
23317,1,0,1,1,0,0,3,1352,17.01
23318,1,2,1,1,0,0,5,8690,54.42
23319,1,5,1,1,0,0,8,15186,83.84
23320,1,1,0,1,0,0,3,1352,17.01
23321,1,1,0,1,0,0,3,1352,17.01
23322,1,4,1,1,0,0,7,13868,78.23
23323,1,4,1,1,0,0,7,13868,78.23
23324,1,3,0,1,0,0,5,8690,54.42
23325,1,0,5,1,2,0,9,15950,87.44
23326,1,0,3,1,3,0,8,15186,83.84
23327,1,2,1,1,0,0,5,8690,54.42
23328,1,1,1,1,0,0,4,4966,36.77
23329,1,1,2,1,0,0,5,8690,54.42
23330,1,0,0,1,1,0,3,1352,17.01
23331,1,4,1,1,0,0,7,13868,78.23
23332,1,0,1,1,0,0,3,1352,17.01
23333,1,0,2,1,0,0,4,4966,36.77
23334,1,2,4,2,0,0,9,15950,87.44
23335,1,1,1,1,0,0,4,4966,36.77
23336,1,0,1,1,0,0,3,1352,17.01
23337,1,1,1,1,0,0,4,4966,36.77
23338,1,2,2,1,0,0,6,11521,68.36
23339,1,3,2,1,0,0,7,13868,78.23
23340,1,0,2,1,0,0,4,4966,36.77
23341,1,4,0,1,0,0,6,11521,68.36
23342,4,0,4,1,3,4,16,18081,97.67
23343,1,0,0,1,0,0,2,32,3.72
23344,1,0,0,1,0,0,2,32,3.72
23345,1,0,1,1,0,0,3,1352,17.01
23346,1,0,3,2,0,0,6,11521,68.36
23347,1,1,1,1,0,0,4,4966,36.77
23348,1,1,1,1,0,0,4,4966,36.77
23349,1,1,1,1,0,0,4,4966,36.77
23350,1,2,0,1,0,0,4,4966,36.77
23351,1,1,0,1,0,0,3,1352,17.01
23352,1,2,0,1,0,0,4,4966,36.77
23353,1,2,0,1,0,0,4,4966,36.77
23354,1,0,2,1,0,0,4,4966,36.77
23355,1,2,0,1,0,0,4,4966,36.77
23356,1,5,1,1,0,0,8,15186,83.84
23357,1,0,2,1,0,0,4,4966,36.77
23358,1,0,2,1,0,0,4,4966,36.77
23359,1,0,0,1,0,0,2,32,3.72
23360,1,1,2,1,0,6,11,16947,91.91
23361,1,1,1,1,0,0,4,4966,36.77
23362,1,0,3,1,1,0,6,11521,68.36
23363,1,2,1,1,0,0,5,8690,54.42
23364,1,0,0,1,0,0,2,32,3.72
23365,1,1,1,1,0,0,4,4966,36.77
23366,1,0,1,1,0,0,3,1352,17.01
23367,1,1,1,1,0,0,4,4966,36.77
23368,1,2,0,1,0,0,4,4966,36.77
23369,1,1,0,1,0,0,3,1352,17.01
23370,1,2,1,1,0,6,11,16947,91.91
23371,1,1,2,1,0,0,5,8690,54.42
23372,1,3,3,1,0,0,8,15186,83.84
23373,1,1,1,1,0,0,4,4966,36.77
23374,1,3,0,1,0,0,5,8690,54.42
23375,1,0,3,1,0,0,5,8690,54.42
23376,1,0,2,1,0,0,4,4966,36.77
23377,1,3,1,1,0,0,6,11521,68.36
23378,1,1,2,1,0,0,5,8690,54.42
23379,1,2,2,1,0,0,6,11521,68.36
23380,1,1,0,1,0,0,3,1352,17.01
23381,1,1,1,1,0,4,8,15186,83.84
23382,1,2,2,1,1,0,7,13868,78.23
23383,1,4,0,1,0,0,6,11521,68.36
23384,1,0,1,1,0,4,7,13868,78.23
23385,1,1,0,1,0,0,3,1352,17.01
23386,1,0,1,1,0,0,3,1352,17.01
23387,1,1,0,1,0,0,3,1352,17.01
23388,1,0,4,2,3,4,14,17699,95.82
23389,1,1,1,1,0,0,4,4966,36.77
23390,1,4,0,1,0,0,6,11521,68.36
23391,1,2,2,1,0,0,6,11521,68.36
23392,1,1,1,1,0,0,4,4966,36.77
23393,1,4,0,1,0,0,6,11521,68.36
23394,1,3,0,1,0,0,5,8690,54.42
23395,3,4,4,4,3,0,18,18287,98.68
23396,3,3,5,5,3,0,19,18362,99.04
23397,1,0,2,1,0,0,4,4966,36.77
23398,1,2,0,1,0,0,4,4966,36.77
23399,1,1,0,1,0,0,3,1352,17.01
23400,1,3,1,1,0,0,6,11521,68.36
23401,1,0,1,1,0,0,3,1352,17.01
23402,1,2,1,1,0,0,5,8690,54.42
23403,1,0,1,1,0,0,3,1352,17.01
23404,1,0,1,1,0,0,3,1352,17.01
23405,1,0,4,1,0,0,6,11521,68.36
23406,1,0,4,2,1,0,8,15186,83.84
23407,1,1,0,1,0,0,3,1352,17.01
23408,1,4,0,1,0,0,6,11521,68.36
23409,1,1,0,1,0,0,3,1352,17.01
23410,1,1,2,1,0,0,5,8690,54.42
23411,1,0,1,1,0,0,3,1352,17.01
23412,1,1,1,1,0,0,4,4966,36.77
23413,1,1,0,1,0,0,3,1352,17.01
23414,3,0,3,2,3,0,11,16947,91.91
23415,1,0,1,1,0,0,3,1352,17.01
23416,1,3,2,1,0,0,7,13868,78.23
23417,1,3,2,1,0,0,7,13868,78.23
23418,1,0,2,1,0,0,4,4966,36.77
23419,1,0,0,1,0,0,2,32,3.72
23420,1,0,3,2,1,0,7,13868,78.23
23421,1,2,0,1,0,0,4,4966,36.77
23422,1,0,1,1,0,0,3,1352,17.01
23423,1,2,0,1,0,0,4,4966,36.77
23424,1,0,0,1,0,6,8,15186,83.84
23425,1,0,0,1,0,0,2,32,3.72
23426,1,0,2,1,0,4,8,15186,83.84
23427,1,0,1,1,0,0,3,1352,17.01
23428,1,0,1,1,0,0,3,1352,17.01
23429,1,2,2,1,0,0,6,11521,68.36
23430,1,2,1,1,0,0,5,8690,54.42
23431,1,3,1,1,0,0,6,11521,68.36
23432,1,0,3,1,0,0,5,8690,54.42
23433,1,0,2,1,0,0,4,4966,36.77
23434,1,1,1,1,0,0,4,4966,36.77
23435,1,2,0,1,0,0,4,4966,36.77
23436,1,1,0,1,0,0,3,1352,17.01
23437,1,2,0,1,0,0,4,4966,36.77
23438,1,2,0,1,0,0,4,4966,36.77
23439,1,3,1,1,0,0,6,11521,68.36
23440,1,2,1,1,0,0,5,8690,54.42
23441,1,3,2,1,0,0,7,13868,78.23
23442,1,2,1,1,0,0,5,8690,54.42
23443,1,1,2,1,0,0,5,8690,54.42
23444,1,0,2,1,1,6,11,16947,91.91
23445,1,1,1,1,0,0,4,4966,36.77
23446,1,2,0,1,0,0,4,4966,36.77
23447,1,0,0,1,0,6,8,15186,83.84
23448,1,0,1,1,0,0,3,1352,17.01
23449,1,3,0,1,0,0,5,8690,54.42
23450,1,1,1,1,0,0,4,4966,36.77
23451,1,0,2,1,0,0,4,4966,36.77
23452,1,0,1,1,1,0,4,4966,36.77
23453,3,1,5,2,3,0,14,17699,95.82
23454,1,0,3,1,0,0,5,8690,54.42
23455,3,0,5,2,3,4,17,18193,98.23
23456,1,2,0,1,0,0,4,4966,36.77
23457,1,2,1,1,0,0,5,8690,54.42
23458,1,4,0,1,0,0,6,11521,68.36
23459,1,2,0,1,0,0,4,4966,36.77
23460,1,2,1,1,0,0,5,8690,54.42
23461,1,2,2,1,0,6,12,17186,93.28
23462,1,0,0,1,0,0,2,32,3.72
23463,1,0,3,2,1,0,7,13868,78.23
23464,1,0,1,1,0,2,5,8690,54.42
23465,1,0,3,1,2,0,7,13868,78.23
23466,1,0,2,1,0,8,12,17186,93.28
23467,1,5,2,2,0,0,10,16522,90.12
23468,1,2,0,2,0,0,5,8690,54.42
23469,1,0,1,1,0,0,3,1352,17.01
23470,1,1,1,1,0,0,4,4966,36.77
23471,1,4,2,1,0,0,8,15186,83.84
23472,1,1,1,1,0,0,4,4966,36.77
23473,1,0,2,1,0,0,4,4966,36.77
23474,1,4,2,1,0,0,8,15186,83.84
23475,1,2,1,1,0,0,5,8690,54.42
23476,1,0,2,1,0,0,4,4966,36.77
23477,1,4,0,1,0,0,6,11521,68.36
23478,1,0,0,1,0,6,8,15186,83.84
23479,1,0,2,1,0,6,10,16522,90.12
23480,1,1,1,1,0,0,4,4966,36.77
23481,1,0,3,1,0,0,5,8690,54.42
23482,1,0,2,1,0,0,4,4966,36.77
23483,1,0,3,1,0,0,5,8690,54.42
23484,1,2,0,1,0,0,4,4966,36.77
23485,1,0,3,1,3,0,8,15186,83.84
23486,1,0,0,1,0,0,2,32,3.72
23487,1,0,1,1,0,0,3,1352,17.01
23488,1,2,0,1,0,0,4,4966,36.77
23489,1,4,3,1,0,0,9,15950,87.44
23490,1,2,0,1,0,0,4,4966,36.77
23491,1,1,0,1,0,0,3,1352,17.01
23492,1,2,0,1,0,0,4,4966,36.77
23493,1,0,1,1,0,0,3,1352,17.01
23494,1,3,1,1,0,0,6,11521,68.36
23495,1,0,1,1,0,0,3,1352,17.01
23496,1,4,1,1,0,0,7,13868,78.23
23497,1,1,1,1,0,0,4,4966,36.77
23498,1,3,1,1,0,0,6,11521,68.36
23499,1,1,3,1,0,0,6,11521,68.36
23500,1,4,0,1,0,0,6,11521,68.36
23501,1,3,0,1,0,0,5,8690,54.42
23502,1,0,1,1,0,6,9,15950,87.44
23503,1,1,1,1,0,0,4,4966,36.77
23504,1,4,0,0,0,0,5,8690,54.42
23505,1,0,1,1,0,0,3,1352,17.01
23506,1,1,1,1,0,6,10,16522,90.12
23507,1,4,0,1,0,0,6,11521,68.36
23508,1,1,2,1,0,0,5,8690,54.42
23509,1,0,1,1,0,0,3,1352,17.01
23510,1,2,1,1,0,0,5,8690,54.42
23511,1,0,3,3,1,0,8,15186,83.84
23512,3,0,5,2,5,6,21,18462,99.52
23513,1,0,1,1,0,4,7,13868,78.23
23514,1,1,1,1,0,0,4,4966,36.77
23515,1,0,1,1,0,0,3,1352,17.01
23516,3,4,5,2,4,0,18,18287,98.68
23517,1,1,0,1,0,0,3,1352,17.01
23518,1,2,0,1,0,0,4,4966,36.77
23519,1,1,2,1,0,0,5,8690,54.42
23520,1,0,1,1,0,0,3,1352,17.01
23521,1,1,0,1,0,0,3,1352,17.01
23522,1,4,0,1,0,0,6,11521,68.36
23523,1,5,3,2,0,0,11,16947,91.91
23524,1,1,0,1,0,0,3,1352,17.01
23525,3,0,5,1,5,0,14,17699,95.82
23526,1,0,1,1,0,0,3,1352,17.01
23527,3,1,5,3,1,0,13,17456,94.66
23528,1,4,0,1,0,0,6,11521,68.36
23529,1,0,2,1,0,0,4,4966,36.77
23530,1,0,2,1,0,0,4,4966,36.77
23531,1,0,1,1,0,0,3,1352,17.01
23532,1,1,0,1,0,0,3,1352,17.01
23533,1,0,1,1,0,0,3,1352,17.01
23534,1,1,1,1,0,0,4,4966,36.77
23535,1,4,0,1,0,0,6,11521,68.36
23536,1,1,1,1,0,0,4,4966,36.77
23537,1,2,0,1,0,0,4,4966,36.77
23538,1,0,0,1,0,0,2,32,3.72
23539,1,0,1,1,1,0,4,4966,36.77
23541,1,1,0,1,0,0,3,1352,17.01
23542,1,2,1,1,0,0,5,8690,54.42
23543,1,4,0,1,4,0,10,16522,90.12
23544,1,0,0,1,0,0,2,32,3.72
23545,1,2,0,1,0,0,4,4966,36.77
23546,1,0,1,1,0,6,9,15950,87.44
23547,1,2,0,1,0,0,4,4966,36.77
23548,1,1,0,1,0,0,3,1352,17.01
23550,1,0,1,1,0,0,3,1352,17.01
23551,1,0,1,1,0,0,3,1352,17.01
23552,1,3,1,1,0,0,6,11521,68.36
23553,1,0,4,2,0,0,7,13868,78.23
23554,3,0,5,3,3,0,14,17699,95.82
23555,1,0,3,1,0,0,5,8690,54.42
23556,1,0,2,1,1,0,5,8690,54.42
23557,3,0,4,2,5,0,14,17699,95.82
23558,1,0,1,1,0,0,3,1352,17.01
23559,1,4,1,1,0,0,7,13868,78.23
23560,1,0,1,1,0,0,3,1352,17.01
23561,1,1,1,1,0,4,8,15186,83.84
23562,1,1,1,1,0,0,4,4966,36.77
23563,1,0,2,1,0,0,4,4966,36.77
23564,1,2,0,1,0,0,4,4966,36.77
23565,1,3,0,1,0,0,5,8690,54.42
23566,1,0,1,1,0,0,3,1352,17.01
23567,1,2,1,1,0,0,5,8690,54.42
23568,1,1,2,1,0,0,5,8690,54.42
23569,1,2,0,1,0,0,4,4966,36.77
23570,1,2,1,1,0,0,5,8690,54.42
23571,4,0,5,2,5,6,22,18498,99.73
23572,1,0,1,0,1,6,9,15950,87.44
23573,1,1,1,1,0,0,4,4966,36.77
23574,1,1,3,3,1,0,9,15950,87.44
23575,1,4,2,1,0,0,8,15186,83.84
23576,1,0,2,1,0,0,4,4966,36.77
23577,1,4,0,1,0,0,6,11521,68.36
23578,1,4,0,1,0,0,6,11521,68.36
23579,1,4,0,1,0,0,6,11521,68.36
23580,1,1,0,1,0,4,7,13868,78.23
23581,1,2,0,1,0,0,4,4966,36.77
23582,1,1,1,1,0,0,4,4966,36.77
23583,1,2,1,1,0,0,5,8690,54.42
23584,1,0,1,1,0,0,3,1352,17.01
23585,1,1,4,1,0,0,7,13868,78.23
23586,1,1,1,1,0,0,4,4966,36.77
23587,3,3,5,2,4,0,17,18193,98.23
23588,1,0,1,1,0,0,3,1352,17.01
23589,1,3,1,1,0,0,6,11521,68.36
23590,1,2,1,1,0,0,5,8690,54.42
23591,1,2,1,1,0,0,5,8690,54.42
23592,1,0,2,1,0,0,4,4966,36.77
23593,1,1,0,1,0,0,3,1352,17.01
23594,1,0,1,1,0,0,3,1352,17.01
23595,1,1,0,1,0,0,3,1352,17.01
23596,1,2,0,1,0,0,4,4966,36.77
23597,1,0,1,1,0,0,3,1352,17.01
23598,1,0,2,1,0,0,4,4966,36.77
23599,1,2,0,1,0,0,4,4966,36.77
23600,3,1,4,1,3,0,12,17186,93.28
23601,3,0,4,2,2,6,17,18193,98.23
23602,3,0,5,2,2,0,12,17186,93.28
23603,1,4,0,1,0,0,6,11521,68.36
23604,1,5,3,2,0,0,11,16947,91.91
23605,1,1,1,1,0,0,4,4966,36.77
23606,1,2,1,1,0,0,5,8690,54.42
23607,1,0,2,1,0,0,4,4966,36.77
23608,1,4,0,0,0,0,5,8690,54.42
23609,1,3,0,1,0,0,5,8690,54.42
23610,1,0,0,1,0,0,2,32,3.72
23611,1,3,0,1,0,0,5,8690,54.42
23612,1,4,1,1,2,0,9,15950,87.44
23613,1,0,2,1,0,10,14,17699,95.82
23614,1,0,2,1,0,0,4,4966,36.77
23615,1,0,2,1,0,0,4,4966,36.77
23616,1,2,0,1,0,0,4,4966,36.77
23617,1,0,2,1,0,0,4,4966,36.77
23618,1,0,1,1,0,0,3,1352,17.01
23620,1,0,0,1,0,0,2,32,3.72
23621,1,0,1,1,0,0,3,1352,17.01
23622,1,1,1,1,0,0,4,4966,36.77
23623,1,0,1,1,0,0,3,1352,17.01
23624,1,3,0,1,0,0,5,8690,54.42
23625,1,0,4,1,1,0,7,13868,78.23
23626,1,0,1,1,0,4,7,13868,78.23
23627,1,4,0,1,0,0,6,11521,68.36
23628,1,0,5,2,3,0,11,16947,91.91
23629,2,0,5,2,0,0,9,15950,87.44
23630,1,0,4,2,1,0,8,15186,83.84
23631,1,0,2,1,0,0,4,4966,36.77
23632,1,0,0,1,0,0,2,32,3.72
23633,1,1,1,1,0,0,4,4966,36.77
23634,1,1,0,1,0,6,9,15950,87.44
23635,1,0,1,1,0,0,3,1352,17.01
23636,1,3,1,1,0,0,6,11521,68.36
23637,1,0,0,1,0,0,2,32,3.72
23638,1,0,0,1,0,0,2,32,3.72
23639,1,0,0,1,0,0,2,32,3.72
23640,1,2,1,1,0,0,5,8690,54.42
23641,3,0,5,2,5,0,15,17888,96.85
23642,1,1,1,1,0,0,4,4966,36.77
23643,1,1,1,1,0,0,4,4966,36.77
23644,3,0,4,2,3,0,12,17186,93.28
23645,1,1,3,4,4,0,13,17456,94.66
23646,1,1,1,1,0,6,10,16522,90.12
23647,1,0,1,1,0,0,3,1352,17.01
23648,1,2,0,1,0,0,4,4966,36.77
23649,1,0,1,1,0,0,3,1352,17.01
23650,1,2,2,1,0,0,6,11521,68.36
23651,1,3,0,1,0,0,5,8690,54.42
23652,1,2,0,1,0,0,4,4966,36.77
23653,1,0,5,1,0,0,7,13868,78.23
23654,1,0,0,1,0,0,2,32,3.72
23655,1,0,2,1,1,0,5,8690,54.42
23656,3,0,5,2,3,0,13,17456,94.66
23657,3,0,5,2,3,10,23,18538,99.86
23658,1,0,3,2,2,4,12,17186,93.28
23659,1,0,0,1,0,0,2,32,3.72
23660,1,1,1,1,0,0,4,4966,36.77
23661,1,0,0,1,0,0,2,32,3.72
23662,1,1,1,1,0,0,4,4966,36.77
23663,1,0,3,2,0,0,6,11521,68.36
23664,1,0,1,1,0,0,3,1352,17.01
23665,1,0,1,1,0,0,3,1352,17.01
23666,1,0,1,1,0,0,3,1352,17.01
23667,1,3,1,1,0,0,6,11521,68.36
23668,1,2,2,1,0,0,6,11521,68.36
23669,1,5,0,1,0,0,7,13868,78.23
23670,1,0,2,1,0,0,4,4966,36.77
23671,1,1,1,1,0,0,4,4966,36.77
23672,1,1,2,1,0,0,5,8690,54.42
23673,3,2,5,2,3,0,15,17888,96.85
23674,1,4,3,3,2,0,13,17456,94.66
23675,1,1,2,1,0,0,5,8690,54.42
23676,3,0,5,2,4,0,14,17699,95.82
23677,1,0,4,3,0,0,8,15186,83.84
23678,1,0,3,1,1,0,6,11521,68.36
23679,1,3,2,1,0,0,7,13868,78.23
23680,1,0,4,2,0,0,7,13868,78.23
23681,1,3,0,1,0,0,5,8690,54.42
23682,1,2,0,1,0,0,4,4966,36.77
23683,1,2,1,1,0,0,5,8690,54.42
23684,1,0,1,1,0,0,3,1352,17.01
23685,1,2,0,1,0,0,4,4966,36.77
23686,1,0,0,1,0,0,2,32,3.72
23687,1,0,2,2,0,0,5,8690,54.42
23688,3,0,5,3,3,0,14,17699,95.82
23689,1,0,2,1,0,0,4,4966,36.77
23690,1,0,4,1,1,0,7,13868,78.23
23691,1,0,1,1,1,0,4,4966,36.77
23692,1,2,0,1,0,0,4,4966,36.77
23693,1,2,1,1,0,0,5,8690,54.42
23694,1,0,1,1,0,4,7,13868,78.23
23695,1,3,0,1,0,0,5,8690,54.42
23696,1,0,0,1,0,0,2,32,3.72
23697,1,0,0,1,0,0,2,32,3.72
23698,1,0,1,1,0,0,3,1352,17.01
23699,1,1,1,1,0,0,4,4966,36.77
23700,1,1,3,1,3,0,9,15950,87.44
23701,3,0,5,2,3,4,17,18193,98.23
23702,3,0,5,2,4,0,14,17699,95.82
23703,4,0,5,2,5,6,22,18498,99.73
23704,3,2,5,2,5,2,19,18362,99.04
23705,1,0,4,2,0,0,7,13868,78.23
23706,1,0,0,1,0,0,2,32,3.72
23707,1,0,0,1,0,2,4,4966,36.77
23708,1,0,1,1,0,0,3,1352,17.01
23709,1,0,0,1,0,0,2,32,3.72
23710,1,0,1,1,0,0,3,1352,17.01
23711,1,1,1,1,0,0,4,4966,36.77
23712,1,1,0,1,0,0,3,1352,17.01
23713,1,1,0,1,0,0,3,1352,17.01
23714,3,0,4,1,4,0,12,17186,93.28
23715,1,2,1,1,0,0,5,8690,54.42
23716,1,2,0,0,0,0,3,1352,17.01
23717,1,0,1,1,0,6,9,15950,87.44
23718,3,1,5,2,1,0,12,17186,93.28
23719,1,1,3,1,0,0,6,11521,68.36
23720,1,1,1,1,0,0,4,4966,36.77
23721,1,1,1,1,0,0,4,4966,36.77
23722,1,2,0,1,0,0,4,4966,36.77
23723,1,0,0,1,0,6,8,15186,83.84
23724,1,3,1,1,0,0,6,11521,68.36
23725,1,1,1,1,0,0,4,4966,36.77
23726,1,0,1,1,0,6,9,15950,87.44
23727,1,1,1,1,0,0,4,4966,36.77
23728,1,1,1,1,0,0,4,4966,36.77
23729,1,0,2,1,0,0,4,4966,36.77
23730,1,5,2,2,0,0,10,16522,90.12
23731,4,0,5,2,5,10,26,18556,99.96
23732,3,2,4,2,1,0,12,17186,93.28
23733,1,1,1,1,0,0,4,4966,36.77
23734,1,0,0,1,0,0,2,32,3.72
23735,1,0,1,1,0,0,3,1352,17.01
23736,1,0,1,1,0,0,3,1352,17.01
23737,1,1,3,1,0,0,6,11521,68.36
23738,1,2,1,1,0,0,5,8690,54.42
23739,1,2,0,1,0,0,4,4966,36.77
23740,1,2,1,1,0,0,5,8690,54.42
23741,1,1,1,1,0,0,4,4966,36.77
23742,3,0,5,1,2,4,15,17888,96.85
23743,1,0,2,1,1,0,5,8690,54.42
23744,1,0,1,1,1,6,10,16522,90.12
23745,1,3,0,1,0,0,5,8690,54.42
23746,1,2,0,1,0,0,4,4966,36.77
23747,1,2,0,1,0,0,4,4966,36.77
23748,1,2,0,1,0,0,4,4966,36.77
23749,1,2,0,1,0,0,4,4966,36.77
23750,1,4,0,1,0,0,6,11521,68.36
23751,1,3,1,1,0,0,6,11521,68.36
23752,1,0,1,1,0,2,5,8690,54.42
23753,1,0,1,1,0,0,3,1352,17.01
23754,1,4,3,2,0,0,10,16522,90.12
23755,1,0,2,0,0,0,3,1352,17.01
23756,1,4,0,1,0,0,6,11521,68.36
23757,1,1,1,1,0,0,4,4966,36.77
23758,1,0,1,1,0,6,9,15950,87.44
23759,1,3,1,0,0,6,11,16947,91.91
23760,1,0,1,1,0,0,3,1352,17.01
23761,1,2,0,1,0,0,4,4966,36.77
23762,1,0,1,1,0,0,3,1352,17.01
23763,1,2,2,1,0,0,6,11521,68.36
23764,1,0,1,1,0,2,5,8690,54.42
23765,1,3,0,1,0,0,5,8690,54.42
23766,1,2,2,1,0,0,6,11521,68.36
23767,1,0,2,2,0,0,5,8690,54.42
23768,1,0,1,1,0,0,3,1352,17.01
23769,1,2,1,1,0,0,5,8690,54.42
23770,1,0,2,1,0,0,4,4966,36.77
23771,1,1,5,1,0,0,8,15186,83.84
23772,1,0,2,1,0,0,4,4966,36.77
23773,1,0,0,1,0,0,2,32,3.72
23774,1,1,0,1,0,0,3,1352,17.01
23775,1,3,1,1,0,0,6,11521,68.36
23776,1,1,1,1,0,0,4,4966,36.77
23777,1,0,0,1,0,0,2,32,3.72
23778,1,3,1,1,0,0,6,11521,68.36
23779,1,0,0,1,0,0,2,32,3.72
23780,1,2,0,1,2,0,6,11521,68.36
23781,1,3,1,1,0,0,6,11521,68.36
23782,1,0,0,1,0,0,2,32,3.72
23783,1,3,0,1,0,0,5,8690,54.42
23784,1,0,1,1,0,0,3,1352,17.01
23785,1,1,1,1,0,0,4,4966,36.77
23786,1,4,1,1,0,0,7,13868,78.23
23787,1,0,0,1,2,0,4,4966,36.77
23788,1,3,1,1,0,0,6,11521,68.36
23789,1,3,1,1,0,0,6,11521,68.36
23790,3,0,5,2,4,0,14,17699,95.82
23791,1,0,2,1,0,0,4,4966,36.77
23792,1,2,3,3,1,0,10,16522,90.12
23793,1,1,0,1,0,0,3,1352,17.01
23794,1,1,0,1,0,0,3,1352,17.01
23795,1,2,1,1,0,0,5,8690,54.42
23796,1,1,1,1,0,0,4,4966,36.77
23797,1,4,0,1,0,0,6,11521,68.36
23798,1,1,1,1,0,0,4,4966,36.77
23799,1,1,1,1,0,0,4,4966,36.77
23800,1,0,0,1,0,8,10,16522,90.12
23801,1,0,3,2,0,0,6,11521,68.36
23802,1,0,1,1,0,0,3,1352,17.01
23804,1,1,1,1,0,0,4,4966,36.77
23805,1,1,1,1,0,0,4,4966,36.77
23806,1,1,2,1,0,2,7,13868,78.23
23807,1,4,0,1,0,0,6,11521,68.36
23808,1,0,3,1,0,0,5,8690,54.42
23809,1,4,3,1,0,0,9,15950,87.44
23810,1,0,1,1,0,0,3,1352,17.01
23811,1,0,0,1,0,0,2,32,3.72
23812,1,2,2,1,0,0,6,11521,68.36
23813,1,2,0,1,0,0,4,4966,36.77
23814,1,2,1,1,0,0,5,8690,54.42
23815,1,1,1,1,0,6,10,16522,90.12
23816,1,0,4,1,0,0,6,11521,68.36
23817,3,0,5,2,3,0,13,17456,94.66
23818,1,5,0,1,0,0,7,13868,78.23
23819,1,1,4,1,0,0,7,13868,78.23
23820,1,0,1,1,0,0,3,1352,17.01
23821,1,0,0,1,0,0,2,32,3.72
23822,1,1,1,1,0,0,4,4966,36.77
23823,1,1,0,1,0,0,3,1352,17.01
23824,1,2,1,1,0,0,5,8690,54.42
23825,1,2,1,1,0,0,5,8690,54.42
23826,1,2,0,1,0,0,4,4966,36.77
23827,1,4,0,1,0,0,6,11521,68.36
23828,1,1,0,1,0,0,3,1352,17.01
23829,1,1,2,1,0,0,5,8690,54.42
23830,1,2,1,1,0,0,5,8690,54.42
23831,1,3,3,1,0,0,8,15186,83.84
23832,1,0,2,1,0,8,12,17186,93.28
23833,1,3,0,1,0,0,5,8690,54.42
23834,1,2,0,1,0,0,4,4966,36.77
23835,3,4,2,0,0,0,9,15950,87.44
23836,1,1,0,1,0,0,3,1352,17.01
23837,1,0,0,1,0,0,2,32,3.72
23838,1,2,1,1,0,0,5,8690,54.42
23839,1,4,0,1,0,0,6,11521,68.36
23840,1,0,2,1,0,0,4,4966,36.77
23841,1,0,1,1,0,0,3,1352,17.01
23842,1,0,1,1,0,0,3,1352,17.01
23843,1,2,1,1,0,0,5,8690,54.42
23844,1,0,1,1,0,0,3,1352,17.01
23845,4,0,5,2,5,6,22,18498,99.73
23846,1,4,2,1,0,0,8,15186,83.84
23847,4,0,5,2,5,6,22,18498,99.73
23848,1,1,2,1,0,0,5,8690,54.42
23850,1,0,1,1,0,0,3,1352,17.01
23851,1,1,3,2,0,6,13,17456,94.66
23852,1,1,0,1,0,0,3,1352,17.01
23853,1,0,1,1,0,0,3,1352,17.01
23854,1,0,1,1,0,0,3,1352,17.01
23855,1,4,0,1,0,0,6,11521,68.36
23856,1,2,1,1,0,0,5,8690,54.42
23857,1,0,2,1,0,6,10,16522,90.12
23858,1,2,1,1,0,0,5,8690,54.42
23859,1,1,1,1,0,0,4,4966,36.77
23860,1,0,4,1,0,0,6,11521,68.36
23861,1,0,1,1,0,0,3,1352,17.01
23862,1,0,1,1,0,0,3,1352,17.01
23863,1,0,1,1,0,0,3,1352,17.01
23864,1,2,0,1,0,0,4,4966,36.77
23865,1,0,3,2,0,0,6,11521,68.36
23866,1,1,1,1,0,0,4,4966,36.77
23867,1,0,1,1,0,0,3,1352,17.01
23868,1,4,0,1,0,0,6,11521,68.36
23869,1,0,2,1,0,0,4,4966,36.77
23870,1,2,0,1,0,0,4,4966,36.77
23871,1,1,4,1,0,0,7,13868,78.23
23872,1,1,0,1,0,0,3,1352,17.01
23873,1,0,1,1,0,0,3,1352,17.01
23874,1,4,0,1,0,0,6,11521,68.36
23875,1,2,2,1,1,0,7,13868,78.23
23876,1,1,0,1,0,0,3,1352,17.01
23877,1,1,1,0,0,0,3,1352,17.01
23878,1,4,0,1,0,0,6,11521,68.36
23879,1,1,1,1,1,0,5,8690,54.42
23880,3,3,5,2,4,0,17,18193,98.23
23881,2,0,5,2,3,0,12,17186,93.28
23882,1,0,0,1,0,0,2,32,3.72
23883,1,1,1,1,0,0,4,4966,36.77
23884,1,2,1,1,0,0,5,8690,54.42
23885,1,1,0,1,0,0,3,1352,17.01
23886,1,1,0,1,0,0,3,1352,17.01
23887,1,1,2,1,0,0,5,8690,54.42
23888,1,2,4,2,0,0,9,15950,87.44
23889,1,1,2,1,0,0,5,8690,54.42
23890,1,5,0,1,0,0,7,13868,78.23
23891,1,3,0,1,0,0,5,8690,54.42
23892,1,1,0,1,0,0,3,1352,17.01
23893,1,0,1,1,0,0,3,1352,17.01
23894,1,0,1,1,0,0,3,1352,17.01
23895,1,0,3,1,0,0,5,8690,54.42
23896,1,2,0,1,0,0,4,4966,36.77
23897,1,1,0,1,0,0,3,1352,17.01
23898,1,2,1,1,0,0,5,8690,54.42
23899,1,0,1,1,0,0,3,1352,17.01
23900,1,0,0,1,0,0,2,32,3.72
23901,1,0,0,1,0,0,2,32,3.72
23902,3,0,2,1,2,6,14,17699,95.82
23903,1,0,1,1,0,6,9,15950,87.44
23904,3,0,3,1,2,6,15,17888,96.85
23905,1,4,0,1,0,0,6,11521,68.36
23906,1,1,1,1,0,0,4,4966,36.77
23907,1,1,1,1,0,0,4,4966,36.77
23908,1,0,0,1,0,0,2,32,3.72
23909,1,0,0,1,0,0,2,32,3.72
23910,1,0,1,1,0,4,7,13868,78.23
23911,1,0,1,1,0,0,3,1352,17.01
23912,1,0,1,1,1,0,4,4966,36.77
23913,1,0,2,1,0,0,4,4966,36.77
23914,1,1,1,1,0,0,4,4966,36.77
23915,1,4,0,1,0,0,6,11521,68.36
23916,3,0,5,2,3,4,17,18193,98.23
23917,1,1,0,1,0,0,3,1352,17.01
23918,1,0,3,1,1,0,6,11521,68.36
23919,1,0,1,1,0,0,3,1352,17.01
23920,1,2,1,1,0,0,5,8690,54.42
23921,1,4,0,1,0,0,6,11521,68.36
23922,1,1,0,1,0,0,3,1352,17.01
23923,1,1,0,1,0,0,3,1352,17.01
23924,1,0,1,1,0,0,3,1352,17.01
23925,1,1,0,1,0,0,3,1352,17.01
23926,1,2,2,1,0,0,6,11521,68.36
23927,1,0,1,1,0,0,3,1352,17.01
23928,1,1,0,1,0,0,3,1352,17.01
23929,1,0,1,1,0,0,3,1352,17.01
23930,1,1,1,1,0,0,4,4966,36.77
23931,1,3,0,1,0,0,5,8690,54.42
23932,1,0,1,1,0,0,3,1352,17.01
23933,1,0,1,1,0,0,3,1352,17.01
23934,1,0,1,1,0,0,3,1352,17.01
23935,1,2,1,1,0,0,5,8690,54.42
23936,1,0,2,1,0,0,4,4966,36.77
23937,1,2,0,1,0,0,4,4966,36.77
23938,1,3,0,1,0,0,5,8690,54.42
23939,1,0,1,1,0,0,3,1352,17.01
23940,1,0,3,1,1,0,6,11521,68.36
23941,1,4,2,1,0,0,8,15186,83.84
23942,1,2,0,1,0,0,4,4966,36.77
23943,1,0,3,1,1,4,10,16522,90.12
23944,1,0,2,1,0,0,4,4966,36.77
23945,1,1,0,1,0,8,11,16947,91.91
23946,1,2,0,1,0,0,4,4966,36.77
23947,1,1,1,1,0,0,4,4966,36.77
23948,1,1,1,1,0,0,4,4966,36.77
23949,1,4,1,1,0,0,7,13868,78.23
23950,1,2,0,1,0,0,4,4966,36.77
23951,1,0,2,1,0,0,4,4966,36.77
23952,1,0,1,1,0,0,3,1352,17.01
23953,3,3,2,4,3,0,15,17888,96.85
23954,1,0,5,1,0,0,7,13868,78.23
23955,3,2,4,3,4,0,16,18081,97.67
23956,1,1,1,1,0,0,4,4966,36.77
23957,1,0,1,1,0,0,3,1352,17.01
23958,1,0,1,1,0,0,3,1352,17.01
23959,1,1,3,1,0,0,6,11521,68.36
23960,1,1,1,1,0,0,4,4966,36.77
23961,1,0,2,1,0,0,4,4966,36.77
23962,1,0,1,1,0,0,3,1352,17.01
23963,1,0,0,1,0,0,2,32,3.72
23964,1,1,0,1,0,0,3,1352,17.01
23965,1,2,0,1,0,0,4,4966,36.77
23966,1,2,0,1,0,0,4,4966,36.77
23967,1,0,1,1,0,0,3,1352,17.01
23968,1,4,1,1,3,0,10,16522,90.12
23969,1,0,3,1,3,0,8,15186,83.84
23970,1,3,0,1,0,0,5,8690,54.42
23971,1,0,2,1,0,6,10,16522,90.12
23972,1,3,1,1,0,0,6,11521,68.36
23973,1,1,0,1,0,0,3,1352,17.01
23974,1,1,1,1,0,0,4,4966,36.77
23975,1,3,0,1,0,0,5,8690,54.42
23976,1,3,1,1,0,0,6,11521,68.36
23977,1,2,1,1,0,0,5,8690,54.42
23978,1,0,1,2,0,0,4,4966,36.77
23979,1,1,1,1,0,0,4,4966,36.77
23980,1,0,2,1,0,0,4,4966,36.77
23981,3,0,3,2,3,6,17,18193,98.23
23982,4,0,5,2,5,6,22,18498,99.73
23983,1,1,1,1,0,6,10,16522,90.12
23984,1,2,0,1,0,0,4,4966,36.77
23985,1,1,0,1,0,0,3,1352,17.01
23986,1,2,0,1,0,0,4,4966,36.77
23987,1,4,0,1,0,0,6,11521,68.36
23988,1,2,1,1,0,0,5,8690,54.42
23989,1,0,2,1,0,2,6,11521,68.36
23990,1,0,1,1,0,0,3,1352,17.01
23991,1,0,3,1,1,0,6,11521,68.36
23992,1,0,3,1,1,0,6,11521,68.36
23993,3,1,4,1,1,4,14,17699,95.82
23994,1,1,0,1,0,0,3,1352,17.01
23995,1,0,2,1,0,4,8,15186,83.84
23996,1,0,2,1,0,0,4,4966,36.77
23997,1,0,5,2,2,0,10,16522,90.12
23998,1,0,1,1,0,6,9,15950,87.44
23999,1,0,1,1,0,0,3,1352,17.01
24000,1,0,1,1,0,0,3,1352,17.01
24001,1,3,0,1,0,0,5,8690,54.42
24002,1,0,3,1,2,6,13,17456,94.66
24004,1,0,1,1,0,0,3,1352,17.01
24005,1,2,1,1,0,0,5,8690,54.42
24006,1,1,2,1,0,0,5,8690,54.42
24007,1,2,1,1,0,0,5,8690,54.42
24008,1,1,1,1,0,0,4,4966,36.77
24009,1,2,0,1,0,0,4,4966,36.77
24010,1,2,0,1,0,0,4,4966,36.77
24011,1,1,1,1,0,0,4,4966,36.77
24012,3,1,5,2,3,0,14,17699,95.82
24013,3,0,4,1,3,8,19,18362,99.04
24014,1,0,1,1,0,0,3,1352,17.01
24015,1,2,1,1,0,0,5,8690,54.42
24016,1,0,1,1,0,0,3,1352,17.01
24017,1,0,2,1,3,4,11,16947,91.91
24018,1,1,0,1,0,0,3,1352,17.01
24019,1,4,1,1,0,0,7,13868,78.23
24020,1,0,2,1,0,0,4,4966,36.77
24021,1,4,0,0,0,0,5,8690,54.42
24022,1,1,1,1,0,0,4,4966,36.77
24023,1,1,1,1,0,0,4,4966,36.77
24024,1,2,0,1,0,0,4,4966,36.77
24025,1,1,2,1,0,0,5,8690,54.42
24026,1,2,1,1,0,0,5,8690,54.42
24027,1,0,1,1,0,0,3,1352,17.01
24028,1,1,0,1,0,0,3,1352,17.01
24029,1,0,0,1,0,0,2,32,3.72
24031,1,1,1,1,0,0,4,4966,36.77
24032,1,1,1,1,0,0,4,4966,36.77
24033,1,1,1,1,0,0,4,4966,36.77
24034,1,2,0,1,0,0,4,4966,36.77
24035,1,1,0,1,0,0,3,1352,17.01
24036,1,1,1,1,0,0,4,4966,36.77
24037,1,3,0,1,0,0,5,8690,54.42
24038,1,0,1,1,0,0,3,1352,17.01
24039,1,0,3,1,1,0,6,11521,68.36
24040,3,0,5,1,2,4,15,17888,96.85
24041,1,3,0,1,0,0,5,8690,54.42
24042,1,0,1,1,0,6,9,15950,87.44
24043,1,0,2,1,0,0,4,4966,36.77
24044,1,1,1,1,0,0,4,4966,36.77
24045,1,0,4,2,3,0,10,16522,90.12
24046,3,1,5,3,4,0,16,18081,97.67
24047,1,2,2,2,0,0,7,13868,78.23
24048,1,4,0,1,0,0,6,11521,68.36
24049,1,2,1,1,0,0,5,8690,54.42
24050,1,1,1,1,0,0,4,4966,36.77
24051,1,2,1,1,0,0,5,8690,54.42
24052,1,2,0,1,0,0,4,4966,36.77
24053,1,0,1,1,2,0,5,8690,54.42
24054,1,4,0,1,0,0,6,11521,68.36
24055,1,2,1,1,0,0,5,8690,54.42
24056,1,4,3,1,0,0,9,15950,87.44
24057,1,1,1,1,0,6,10,16522,90.12
24058,1,4,1,1,0,0,7,13868,78.23
24059,1,4,1,1,0,0,7,13868,78.23
24060,1,0,3,2,0,0,6,11521,68.36
24061,1,0,2,1,0,0,4,4966,36.77
24062,1,0,0,1,0,0,2,32,3.72
24063,1,3,0,1,0,0,5,8690,54.42
24064,1,0,0,1,0,0,2,32,3.72
24065,3,0,4,1,3,4,15,17888,96.85
24066,1,0,1,1,0,0,3,1352,17.01
24067,1,0,1,1,0,4,7,13868,78.23
24068,1,4,0,1,0,0,6,11521,68.36
24069,1,4,3,1,0,0,9,15950,87.44
24070,1,0,0,1,1,6,9,15950,87.44
24071,1,1,2,1,0,0,5,8690,54.42
24072,1,0,1,1,0,0,3,1352,17.01
24073,1,0,0,1,0,0,2,32,3.72
24074,1,1,1,1,0,0,4,4966,36.77
24075,1,1,1,1,0,0,4,4966,36.77
24076,1,3,0,1,0,0,5,8690,54.42
24077,1,3,3,2,0,0,9,15950,87.44
24078,1,0,1,1,0,0,3,1352,17.01
24079,1,3,0,1,0,0,5,8690,54.42
24080,1,4,0,1,0,0,6,11521,68.36
24081,1,0,0,1,0,6,8,15186,83.84
24082,1,0,1,1,0,0,3,1352,17.01
24083,1,0,1,1,0,0,3,1352,17.01
24084,1,1,0,1,0,0,3,1352,17.01
24085,1,1,0,1,0,0,3,1352,17.01
24086,1,1,0,1,0,0,3,1352,17.01
24087,1,1,0,1,0,0,3,1352,17.01
24088,1,3,2,1,0,6,13,17456,94.66
24090,1,3,0,1,0,0,5,8690,54.42
24091,1,5,0,1,0,0,7,13868,78.23
24092,1,1,0,1,0,0,3,1352,17.01
24093,1,1,2,1,1,4,10,16522,90.12
24094,1,0,1,1,0,0,3,1352,17.01
24095,1,1,1,1,0,0,4,4966,36.77
24096,1,2,0,1,0,0,4,4966,36.77
24097,1,0,1,1,0,0,3,1352,17.01
24098,1,1,0,1,0,0,3,1352,17.01
24099,1,1,0,1,0,0,3,1352,17.01
24100,1,1,1,1,0,0,4,4966,36.77
24101,1,2,1,1,0,0,5,8690,54.42
24102,1,1,2,1,0,0,5,8690,54.42
24103,1,4,1,1,0,0,7,13868,78.23
24104,1,1,0,1,0,0,3,1352,17.01
24105,1,1,2,1,0,0,5,8690,54.42
24106,3,0,4,1,4,0,12,17186,93.28
24107,1,0,1,1,0,0,3,1352,17.01
24108,1,0,0,1,0,0,2,32,3.72
24109,1,0,0,1,0,0,2,32,3.72
24110,1,1,2,1,0,0,5,8690,54.42
24111,1,1,1,1,0,0,4,4966,36.77
24112,1,0,1,1,0,0,3,1352,17.01
24113,1,1,2,1,0,0,5,8690,54.42
24114,1,4,2,1,0,0,8,15186,83.84
24115,1,0,3,2,3,0,9,15950,87.44
24116,1,0,1,1,4,0,7,13868,78.23
24117,1,2,3,2,0,0,8,15186,83.84
24118,1,1,0,1,0,0,3,1352,17.01
24119,1,1,1,1,0,0,4,4966,36.77
24120,1,2,1,1,0,0,5,8690,54.42
24121,1,0,4,2,0,0,7,13868,78.23
24122,1,2,1,1,0,0,5,8690,54.42
24123,1,5,2,2,0,0,10,16522,90.12
24124,1,0,1,1,0,0,3,1352,17.01
24125,1,3,1,1,0,0,6,11521,68.36
24126,1,4,0,1,0,0,6,11521,68.36
24127,1,0,3,1,1,0,6,11521,68.36
24128,1,2,0,1,0,0,4,4966,36.77
24129,3,0,5,2,3,0,13,17456,94.66
24130,3,0,5,1,3,0,12,17186,93.28
24131,1,0,4,1,0,0,6,11521,68.36
24132,1,1,0,1,0,0,3,1352,17.01
24133,1,1,1,1,0,0,4,4966,36.77
24134,1,1,4,1,0,0,7,13868,78.23
24135,1,2,1,1,0,4,9,15950,87.44
24136,1,0,1,1,0,0,3,1352,17.01
24137,1,2,1,1,0,0,5,8690,54.42
24138,1,5,0,1,0,0,7,13868,78.23
24139,1,4,0,1,0,0,6,11521,68.36
24140,1,1,0,1,0,0,3,1352,17.01
24141,1,0,1,1,0,0,3,1352,17.01
24142,1,2,0,1,0,0,4,4966,36.77
24143,1,1,1,1,0,0,4,4966,36.77
24144,1,0,0,1,0,0,2,32,3.72
24145,1,0,0,1,0,0,2,32,3.72
24146,1,0,1,1,0,0,3,1352,17.01
24147,1,1,1,1,0,0,4,4966,36.77
24148,1,2,0,1,0,0,4,4966,36.77
24149,1,0,1,1,0,0,3,1352,17.01
24150,1,3,1,1,0,0,6,11521,68.36
24151,1,5,1,1,0,0,8,15186,83.84
24152,1,0,1,1,0,6,9,15950,87.44
24153,1,4,2,1,0,0,8,15186,83.84
24154,1,1,3,1,0,0,6,11521,68.36
24155,1,1,2,1,0,0,5,8690,54.42
24157,1,0,1,1,0,0,3,1352,17.01
24158,1,0,1,1,2,0,5,8690,54.42
24159,1,4,2,1,0,0,8,15186,83.84
24160,1,4,0,1,0,0,6,11521,68.36
24161,1,0,1,1,0,0,3,1352,17.01
24162,1,1,1,1,0,0,4,4966,36.77
24163,1,1,1,1,0,6,10,16522,90.12
24164,1,0,2,1,0,6,10,16522,90.12
24165,1,0,1,1,0,0,3,1352,17.01
24166,1,5,3,2,0,0,11,16947,91.91
24167,1,5,3,2,0,0,11,16947,91.91
24168,1,0,0,1,0,6,8,15186,83.84
24169,1,1,0,1,0,0,3,1352,17.01
24170,1,1,0,1,0,0,3,1352,17.01
24171,1,0,0,1,0,0,2,32,3.72
24172,1,0,1,1,0,0,3,1352,17.01
24173,1,0,0,1,0,0,2,32,3.72
24174,1,0,2,1,0,0,4,4966,36.77
24175,1,4,0,1,0,0,6,11521,68.36
24176,1,0,5,1,3,0,10,16522,90.12
24177,1,1,1,1,0,0,4,4966,36.77
24178,1,3,1,1,0,0,6,11521,68.36
24179,1,4,1,1,0,0,7,13868,78.23
24180,1,0,1,1,0,0,3,1352,17.01
24181,1,0,2,1,2,6,12,17186,93.28
24182,1,0,1,1,0,0,3,1352,17.01
24183,1,0,0,1,0,0,2,32,3.72
24184,1,4,0,1,0,0,6,11521,68.36
24185,1,4,1,1,0,0,7,13868,78.23
24186,1,0,1,1,0,0,3,1352,17.01
24187,1,4,0,1,0,0,6,11521,68.36
24188,1,0,0,1,0,0,2,32,3.72
24189,1,0,2,1,0,6,10,16522,90.12
24190,1,2,1,1,0,0,5,8690,54.42
24191,1,1,1,1,0,0,4,4966,36.77
24192,1,2,4,1,1,0,9,15950,87.44
24193,1,0,1,1,0,0,3,1352,17.01
24194,1,0,3,1,1,0,6,11521,68.36
24195,1,1,1,1,0,0,4,4966,36.77
24196,1,2,0,1,0,0,4,4966,36.77
24197,1,2,1,1,0,0,5,8690,54.42
24198,1,0,1,1,0,0,3,1352,17.01
24199,1,3,1,1,0,0,6,11521,68.36
24200,1,0,1,1,0,0,3,1352,17.01
24201,1,0,0,1,0,0,2,32,3.72
24202,1,2,1,1,0,0,5,8690,54.42
24203,1,1,0,1,0,0,3,1352,17.01
24204,1,1,0,1,0,0,3,1352,17.01
24205,1,0,2,1,0,0,4,4966,36.77
24206,1,2,0,1,0,0,4,4966,36.77
24207,1,4,0,0,0,0,5,8690,54.42
24208,2,0,5,2,2,0,11,16947,91.91
24209,1,1,3,3,2,0,10,16522,90.12
24210,1,0,2,1,0,0,4,4966,36.77
24211,1,1,0,1,0,0,3,1352,17.01
24212,1,0,4,1,0,0,6,11521,68.36
24213,1,3,4,4,4,0,16,18081,97.67
24214,3,4,5,4,5,0,21,18462,99.52
24215,1,2,1,1,0,0,5,8690,54.42
24216,1,1,1,1,0,0,4,4966,36.77
24217,1,0,1,1,0,0,3,1352,17.01
24218,1,0,1,1,0,0,3,1352,17.01
24219,1,4,0,1,0,0,6,11521,68.36
24220,1,2,1,1,0,0,5,8690,54.42
24221,1,1,1,1,0,0,4,4966,36.77
24222,1,0,2,1,0,0,4,4966,36.77
24223,1,2,1,1,0,0,5,8690,54.42
24224,1,4,1,1,0,0,7,13868,78.23
24225,1,4,0,1,0,0,6,11521,68.36
24226,1,0,1,1,0,0,3,1352,17.01
24227,1,0,1,1,0,0,3,1352,17.01
24228,1,0,4,1,1,2,9,15950,87.44
24230,1,2,1,1,0,0,5,8690,54.42
24231,1,4,0,1,1,0,7,13868,78.23
24232,1,1,1,1,0,0,4,4966,36.77
24233,1,0,0,1,0,0,2,32,3.72
24234,1,1,0,1,0,0,3,1352,17.01
24235,1,1,1,1,0,6,10,16522,90.12
24236,1,1,1,1,0,0,4,4966,36.77
24237,1,3,2,1,0,0,7,13868,78.23
24238,1,1,0,1,0,0,3,1352,17.01
24239,1,1,1,1,0,6,10,16522,90.12
24240,1,1,1,1,0,0,4,4966,36.77
24241,1,0,1,1,0,0,3,1352,17.01
24242,1,4,0,1,0,0,6,11521,68.36
24243,1,1,1,1,0,0,4,4966,36.77
24244,1,1,0,1,0,0,3,1352,17.01
24245,1,1,0,1,0,0,3,1352,17.01
24246,1,1,1,1,0,0,4,4966,36.77
24247,1,0,2,1,0,0,4,4966,36.77
24248,1,1,1,1,0,0,4,4966,36.77
24249,1,0,0,1,0,0,2,32,3.72
24250,1,0,3,1,2,0,7,13868,78.23
24251,1,1,1,1,0,6,10,16522,90.12
24252,1,0,2,1,0,6,10,16522,90.12
24253,1,0,4,2,0,0,7,13868,78.23
24254,1,0,2,1,0,0,4,4966,36.77
24255,1,0,1,1,0,0,3,1352,17.01
24256,3,0,5,2,5,0,15,17888,96.85
24257,1,0,1,1,0,0,3,1352,17.01
24258,1,4,0,1,0,0,6,11521,68.36
24259,1,0,1,1,0,0,3,1352,17.01
24260,1,0,1,1,0,0,3,1352,17.01
24261,1,0,1,1,0,0,3,1352,17.01
24262,1,0,0,1,0,6,8,15186,83.84
24263,1,0,1,1,0,0,3,1352,17.01
24264,1,4,3,1,0,0,9,15950,87.44
24265,1,2,3,1,1,0,8,15186,83.84
24266,1,0,4,1,1,0,7,13868,78.23
24267,1,4,2,1,3,0,11,16947,91.91
24268,3,1,4,4,5,0,17,18193,98.23
24269,1,0,0,1,0,0,2,32,3.72
24270,1,0,1,1,0,0,3,1352,17.01
24271,1,4,0,1,0,0,6,11521,68.36
24272,1,4,1,1,0,0,7,13868,78.23
24273,1,0,1,1,0,0,3,1352,17.01
24274,1,1,1,1,0,0,4,4966,36.77
24275,1,0,0,1,0,0,2,32,3.72
24276,3,0,5,2,3,10,23,18538,99.86
24277,1,1,1,1,0,0,4,4966,36.77
24278,1,1,1,1,0,0,4,4966,36.77
24279,1,1,0,1,0,0,3,1352,17.01
24280,1,0,0,1,0,0,2,32,3.72
24281,1,1,0,1,0,0,3,1352,17.01
24282,1,3,0,1,0,0,5,8690,54.42
24283,1,0,1,1,0,4,7,13868,78.23
24284,1,1,1,1,0,0,4,4966,36.77
24285,1,2,0,1,0,0,4,4966,36.77
24286,1,1,1,1,0,0,4,4966,36.77
24287,1,0,1,1,0,0,3,1352,17.01
24288,3,0,5,2,4,0,14,17699,95.82
24289,3,0,5,3,2,0,13,17456,94.66
24290,1,2,0,1,0,0,4,4966,36.77
24291,1,2,1,1,0,0,5,8690,54.42
24292,1,0,1,1,0,0,3,1352,17.01
24293,1,2,3,2,0,6,14,17699,95.82
24294,1,2,1,1,0,0,5,8690,54.42
24295,1,0,1,1,0,0,3,1352,17.01
24296,1,3,1,1,0,0,6,11521,68.36
24297,1,0,1,1,0,0,3,1352,17.01
24298,1,0,1,1,0,0,3,1352,17.01
24299,1,4,1,1,0,0,7,13868,78.23
24300,1,0,0,1,0,6,8,15186,83.84
24301,1,4,0,1,0,0,6,11521,68.36
24302,1,2,1,1,0,6,11,16947,91.91
24303,1,2,4,1,1,6,15,17888,96.85
24304,1,1,2,1,0,0,5,8690,54.42
24305,1,1,5,2,4,0,13,17456,94.66
24306,3,0,5,2,4,2,16,18081,97.67
24307,1,2,1,1,0,0,5,8690,54.42
24308,1,0,1,1,0,0,3,1352,17.01
24309,1,0,0,1,0,0,2,32,3.72
24310,1,5,0,1,0,0,7,13868,78.23
24311,1,1,1,1,0,4,8,15186,83.84
24312,1,2,0,1,0,0,4,4966,36.77
24313,1,1,0,1,0,0,3,1352,17.01
24314,1,4,0,1,0,0,6,11521,68.36
24315,1,2,1,1,0,0,5,8690,54.42
24316,1,2,0,1,0,0,4,4966,36.77
24317,1,1,1,1,0,0,4,4966,36.77
24318,1,0,5,1,0,0,7,13868,78.23
24319,1,0,1,1,0,0,3,1352,17.01
24320,1,0,1,1,0,0,3,1352,17.01
24321,3,4,5,4,4,0,20,18419,99.31
24322,1,2,0,1,0,0,4,4966,36.77
24323,1,1,3,1,0,0,6,11521,68.36
24324,1,0,2,1,0,0,4,4966,36.77
24325,1,2,0,1,0,0,4,4966,36.77
24326,1,2,0,1,0,0,4,4966,36.77
24327,1,1,0,1,0,0,3,1352,17.01
24328,1,0,0,1,0,0,2,32,3.72
24329,1,2,1,1,0,0,5,8690,54.42
24330,1,4,1,2,0,0,8,15186,83.84
24331,1,1,1,1,0,0,4,4966,36.77
24332,1,2,0,1,0,0,4,4966,36.77
24333,3,0,4,2,3,0,12,17186,93.28
24334,3,1,5,2,3,2,16,18081,97.67
24335,3,4,5,5,0,0,17,18193,98.23
24336,1,1,0,1,0,0,3,1352,17.01
24337,1,1,0,1,0,0,3,1352,17.01
24338,1,2,1,1,0,0,5,8690,54.42
24339,1,1,1,1,0,0,4,4966,36.77
24340,1,1,1,1,0,0,4,4966,36.77
24341,1,1,1,1,0,0,4,4966,36.77
24342,1,0,0,1,0,0,2,32,3.72
24343,1,0,2,1,0,0,4,4966,36.77
24344,1,4,0,1,0,0,6,11521,68.36
24345,1,0,3,1,0,6,11,16947,91.91
24346,1,3,1,1,2,0,8,15186,83.84
24347,1,0,2,1,0,0,4,4966,36.77
24348,1,0,1,1,0,0,3,1352,17.01
24349,1,2,2,1,0,0,6,11521,68.36
24350,1,1,2,1,0,0,5,8690,54.42
24351,1,0,1,1,0,0,3,1352,17.01
24352,1,3,3,1,0,0,8,15186,83.84
24353,1,0,0,1,0,0,2,32,3.72
24354,1,4,0,0,0,0,5,8690,54.42
24355,1,0,0,1,0,0,2,32,3.72
24356,1,0,1,1,0,0,3,1352,17.01
24357,1,0,2,1,0,0,4,4966,36.77
24358,1,0,0,1,0,0,2,32,3.72
24359,1,0,2,1,0,6,10,16522,90.12
24360,1,0,2,1,0,6,10,16522,90.12
24361,1,0,3,1,1,0,6,11521,68.36
24362,1,2,0,1,0,0,4,4966,36.77
24363,1,3,0,1,0,0,5,8690,54.42
24365,1,1,1,1,0,0,4,4966,36.77
24366,1,1,0,1,0,0,3,1352,17.01
24367,1,0,2,1,0,0,4,4966,36.77
24368,1,2,0,1,0,0,4,4966,36.77
24369,1,0,0,1,0,0,2,32,3.72
24370,1,2,0,1,0,0,4,4966,36.77
24371,1,0,3,1,1,0,6,11521,68.36
24372,1,0,0,1,0,0,2,32,3.72
24373,1,2,1,1,0,0,5,8690,54.42
24374,1,3,1,1,0,0,6,11521,68.36
24375,1,4,0,1,0,0,6,11521,68.36
24376,1,4,3,1,1,0,10,16522,90.12
24377,1,1,2,1,0,0,5,8690,54.42
24378,1,4,3,1,0,0,9,15950,87.44
24379,1,0,1,1,0,0,3,1352,17.01
24380,1,0,1,1,0,6,9,15950,87.44
24381,1,1,1,1,0,6,10,16522,90.12
24382,1,0,1,1,0,0,3,1352,17.01
24383,1,0,1,1,0,0,3,1352,17.01
24384,1,0,0,1,0,0,2,32,3.72
24385,1,0,1,1,0,0,3,1352,17.01
24386,1,4,1,1,0,0,7,13868,78.23
24387,1,2,1,1,0,0,5,8690,54.42
24388,1,1,1,1,0,0,4,4966,36.77
24389,1,1,1,1,0,0,4,4966,36.77
24390,1,3,3,2,0,0,9,15950,87.44
24391,3,0,5,2,3,0,13,17456,94.66
24392,3,0,5,3,3,0,14,17699,95.82
24393,3,0,5,2,2,0,12,17186,93.28
24394,1,0,2,1,0,0,4,4966,36.77
24395,1,0,2,1,0,0,4,4966,36.77
24396,1,1,1,1,0,0,4,4966,36.77
24397,1,0,0,1,0,0,2,32,3.72
24398,1,1,1,1,0,0,4,4966,36.77
24399,1,2,3,1,0,0,7,13868,78.23
24400,1,2,0,0,0,0,3,1352,17.01
24401,1,3,0,1,0,0,5,8690,54.42
24402,1,1,0,1,0,0,3,1352,17.01
24403,1,1,1,1,0,0,4,4966,36.77
24404,1,1,0,1,0,0,3,1352,17.01
24405,1,2,1,1,0,0,5,8690,54.42
24406,1,2,1,1,0,0,5,8690,54.42
24407,1,2,1,1,0,0,5,8690,54.42
24408,1,2,1,1,0,6,11,16947,91.91
24409,1,0,0,1,0,0,2,32,3.72
24410,1,1,2,1,0,6,11,16947,91.91
24411,1,0,1,1,0,6,9,15950,87.44
24412,1,1,2,1,0,0,5,8690,54.42
24413,1,2,1,1,0,0,5,8690,54.42
24414,1,0,0,1,0,0,2,32,3.72
24415,1,1,0,1,0,0,3,1352,17.01
24416,1,4,3,2,0,0,10,16522,90.12
24417,1,0,3,1,0,0,5,8690,54.42
24418,1,2,0,1,0,0,4,4966,36.77
24419,1,0,3,1,1,6,12,17186,93.28
24420,3,5,5,3,3,0,19,18362,99.04
24421,3,1,5,2,5,6,22,18498,99.73
24422,3,0,5,2,4,6,20,18419,99.31
24423,1,1,1,1,0,0,4,4966,36.77
24424,1,0,2,1,0,0,4,4966,36.77
24425,1,0,1,1,3,0,6,11521,68.36
24426,1,0,1,1,0,0,3,1352,17.01
24427,1,3,0,1,0,0,5,8690,54.42
24428,1,2,1,1,0,0,5,8690,54.42
24429,1,0,0,1,0,0,2,32,3.72
24430,1,3,1,1,0,0,6,11521,68.36
24431,1,4,0,1,0,0,6,11521,68.36
24432,3,0,5,2,2,0,12,17186,93.28
24433,3,1,5,2,2,0,13,17456,94.66
24434,1,3,3,3,0,0,10,16522,90.12
24435,1,0,3,1,0,0,5,8690,54.42
24436,1,0,1,1,0,0,3,1352,17.01
24437,1,0,0,1,0,0,2,32,3.72
24438,1,0,1,1,0,0,3,1352,17.01
24439,1,3,0,1,0,0,5,8690,54.42
24440,1,1,1,1,0,0,4,4966,36.77
24442,1,0,5,1,1,0,8,15186,83.84
24443,1,0,0,1,0,0,2,32,3.72
24444,1,1,0,1,0,0,3,1352,17.01
24445,1,1,0,1,0,0,3,1352,17.01
24446,1,0,1,1,0,0,3,1352,17.01
24447,1,3,0,0,0,0,4,4966,36.77
24448,1,1,0,1,0,0,3,1352,17.01
24449,1,0,0,1,0,0,2,32,3.72
24450,1,2,1,1,0,0,5,8690,54.42
24451,1,1,1,1,0,0,4,4966,36.77
24452,1,0,1,1,0,0,3,1352,17.01
24453,1,1,0,1,0,0,3,1352,17.01
24454,1,1,1,1,0,0,4,4966,36.77
24455,1,0,1,1,0,0,3,1352,17.01
24456,1,1,0,1,0,0,3,1352,17.01
24458,1,1,3,1,0,0,6,11521,68.36
24459,1,0,3,1,0,0,5,8690,54.42
24460,1,0,1,1,0,0,3,1352,17.01
24461,1,1,0,1,0,0,3,1352,17.01
24462,1,2,2,1,0,0,6,11521,68.36
24463,1,0,1,1,0,4,7,13868,78.23
24464,1,0,1,1,0,0,3,1352,17.01
24465,1,0,0,1,0,0,2,32,3.72
24466,1,1,1,1,0,0,4,4966,36.77
24467,1,1,0,1,0,0,3,1352,17.01
24468,3,0,5,1,2,4,15,17888,96.85
24469,1,1,1,1,0,0,4,4966,36.77
24470,1,1,0,1,0,0,3,1352,17.01
24471,1,1,0,1,0,0,3,1352,17.01
24472,1,1,0,1,0,0,3,1352,17.01
24473,3,0,5,1,5,0,14,17699,95.82
24474,3,1,5,4,4,0,17,18193,98.23
24475,1,0,1,1,0,0,3,1352,17.01
24477,1,1,1,1,0,0,4,4966,36.77
24478,1,1,0,1,0,0,3,1352,17.01
24479,1,0,1,1,0,0,3,1352,17.01
24480,1,0,1,1,0,0,3,1352,17.01
24481,1,0,0,1,0,0,2,32,3.72
24482,1,2,1,1,0,0,5,8690,54.42
24483,1,1,0,1,0,6,9,15950,87.44
24484,1,4,1,1,0,0,7,13868,78.23
24485,1,0,1,1,0,0,3,1352,17.01
24486,3,4,5,3,2,0,17,18193,98.23
24487,3,2,5,2,3,0,15,17888,96.85
24488,3,0,5,1,3,0,12,17186,93.28
24489,1,4,2,1,0,0,8,15186,83.84
24490,1,4,2,1,4,0,12,17186,93.28
24491,1,0,2,1,0,0,4,4966,36.77
24492,1,2,2,1,5,0,11,16947,91.91
24493,1,2,2,1,0,0,6,11521,68.36
24495,1,1,0,1,0,0,3,1352,17.01
24496,1,4,0,1,0,0,6,11521,68.36
24497,1,1,1,1,0,6,10,16522,90.12
24498,1,0,1,1,0,0,3,1352,17.01
24499,1,2,0,1,0,0,4,4966,36.77
24500,1,1,1,1,0,0,4,4966,36.77
24501,1,4,0,1,0,0,6,11521,68.36
24502,1,2,2,1,0,0,6,11521,68.36
24503,1,5,3,3,0,0,12,17186,93.28
24504,3,0,5,1,3,0,12,17186,93.28
24505,1,3,0,1,0,0,5,8690,54.42
24506,3,0,4,1,3,4,15,17888,96.85
24507,1,1,2,2,0,0,6,11521,68.36
24508,1,1,0,1,0,0,3,1352,17.01
24509,1,1,2,1,0,0,5,8690,54.42
24510,1,0,0,1,0,0,2,32,3.72
24511,1,4,0,1,0,0,6,11521,68.36
24512,1,0,0,1,0,0,2,32,3.72
24513,1,4,0,1,0,0,6,11521,68.36
24514,1,1,1,1,0,0,4,4966,36.77
24515,1,4,0,1,0,0,6,11521,68.36
24516,1,0,1,1,0,0,3,1352,17.01
24517,1,0,1,1,0,0,3,1352,17.01
24518,1,3,0,1,0,0,5,8690,54.42
24519,1,1,1,1,0,6,10,16522,90.12
24520,1,0,2,1,0,0,4,4966,36.77
24521,3,0,5,2,4,0,14,17699,95.82
24522,4,0,5,2,4,10,25,18550,99.91
24523,1,0,2,1,0,0,4,4966,36.77
24524,3,0,5,1,3,4,16,18081,97.67
24525,1,0,2,1,0,0,4,4966,36.77
24526,1,1,1,1,0,0,4,4966,36.77
24527,1,0,1,1,0,0,3,1352,17.01
24528,1,1,1,1,0,0,4,4966,36.77
24529,1,0,1,1,0,0,3,1352,17.01
24530,1,0,0,1,0,0,2,32,3.72
24531,1,3,0,1,0,0,5,8690,54.42
24532,1,1,1,1,0,0,4,4966,36.77
24533,1,0,1,1,0,6,9,15950,87.44
24534,1,0,2,1,1,0,5,8690,54.42
24535,1,4,0,1,0,0,6,11521,68.36
24536,1,4,0,1,3,0,9,15950,87.44
24537,1,1,2,1,0,0,5,8690,54.42
24538,1,1,2,1,0,0,5,8690,54.42
24539,1,0,1,1,0,0,3,1352,17.01
24540,4,0,5,2,5,10,26,18556,99.96
24541,4,0,5,2,5,6,22,18498,99.73
24542,1,2,1,1,0,0,5,8690,54.42
24543,1,1,1,1,0,0,4,4966,36.77
24544,1,0,1,1,0,0,3,1352,17.01
24545,1,0,0,1,0,0,2,32,3.72
24546,1,0,2,1,0,0,4,4966,36.77
24547,1,4,3,1,0,0,9,15950,87.44
24548,1,1,1,1,0,0,4,4966,36.77
24549,1,4,0,1,0,0,6,11521,68.36
24550,3,1,5,2,2,0,13,17456,94.66
24551,3,0,4,1,2,8,18,18287,98.68
24552,1,1,0,1,0,0,3,1352,17.01
24553,3,2,3,3,1,0,12,17186,93.28
24554,3,3,4,3,2,0,15,17888,96.85
24555,1,0,2,2,0,0,5,8690,54.42
24556,1,0,2,1,0,0,4,4966,36.77
24557,1,0,1,1,0,0,3,1352,17.01
24558,1,2,0,1,0,0,4,4966,36.77
24559,1,0,1,1,0,0,3,1352,17.01
24560,1,0,1,1,0,0,3,1352,17.01
24561,1,3,0,1,0,0,5,8690,54.42
24562,1,1,1,1,0,0,4,4966,36.77
24563,1,0,0,1,0,0,2,32,3.72
24564,1,2,1,1,0,0,5,8690,54.42
24565,1,4,1,2,0,0,8,15186,83.84
24566,1,0,0,1,0,0,2,32,3.72
24567,1,2,0,1,0,0,4,4966,36.77
24568,1,2,0,1,0,0,4,4966,36.77
24569,1,0,0,1,0,0,2,32,3.72
24570,1,4,0,1,0,0,6,11521,68.36
24571,1,0,2,1,0,0,4,4966,36.77
24572,1,0,1,1,0,0,3,1352,17.01
24573,1,0,2,1,0,0,4,4966,36.77
24574,1,0,0,1,0,0,2,32,3.72
24575,1,0,1,1,0,0,3,1352,17.01
24576,1,0,1,1,0,0,3,1352,17.01
24577,1,0,1,1,0,0,3,1352,17.01
24578,1,0,0,1,0,0,2,32,3.72
24579,1,0,0,1,0,0,2,32,3.72
24580,1,4,1,1,0,0,7,13868,78.23
24581,1,0,0,1,0,0,2,32,3.72
24582,3,0,3,1,2,6,15,17888,96.85
24583,1,1,1,1,0,0,4,4966,36.77
24584,1,0,0,1,0,0,2,32,3.72
24585,1,0,2,1,0,0,4,4966,36.77
24586,1,3,0,1,0,0,5,8690,54.42
24587,1,1,1,1,0,0,4,4966,36.77
24588,1,0,1,1,0,0,3,1352,17.01
24590,1,4,0,1,0,0,6,11521,68.36
24591,1,0,1,1,0,0,3,1352,17.01
24592,1,0,2,1,0,0,4,4966,36.77
24593,1,0,1,1,0,0,3,1352,17.01
24594,1,4,1,1,0,0,7,13868,78.23
24595,3,0,5,2,5,6,21,18462,99.52
24596,1,0,1,1,0,0,3,1352,17.01
24597,1,0,0,1,1,10,13,17456,94.66
24598,1,0,3,1,1,0,6,11521,68.36
24599,1,4,1,1,0,0,7,13868,78.23
24600,1,3,0,1,0,0,5,8690,54.42
24601,1,2,0,1,0,0,4,4966,36.77
24602,1,1,0,1,0,0,3,1352,17.01
24603,1,0,1,1,0,0,3,1352,17.01
24604,1,2,0,1,0,0,4,4966,36.77
24605,1,0,1,1,0,0,3,1352,17.01
24606,3,3,5,3,3,0,17,18193,98.23
24607,3,0,5,2,2,0,12,17186,93.28
24608,3,1,5,1,2,0,12,17186,93.28
24609,3,4,5,4,4,0,20,18419,99.31
24610,3,1,4,2,5,0,15,17888,96.85
24611,1,3,0,1,0,0,5,8690,54.42
24612,1,0,1,1,0,6,9,15950,87.44
24613,1,1,1,1,0,0,4,4966,36.77
24614,1,1,1,1,0,0,4,4966,36.77
24615,1,3,0,1,0,0,5,8690,54.42
24616,1,0,0,1,0,0,2,32,3.72
24617,1,0,0,1,0,0,2,32,3.72
24618,1,0,4,1,1,0,7,13868,78.23
24619,1,2,1,1,0,0,5,8690,54.42
24620,1,0,1,1,0,0,3,1352,17.01
24621,1,0,3,1,1,0,6,11521,68.36
24622,1,2,0,1,0,0,4,4966,36.77
24623,1,0,4,2,2,0,9,15950,87.44
24624,1,0,4,1,1,0,7,13868,78.23
24625,1,3,0,1,0,0,5,8690,54.42
24626,1,0,1,1,0,0,3,1352,17.01
24627,1,0,1,1,0,0,3,1352,17.01
24628,1,1,0,1,0,0,3,1352,17.01
24629,1,0,1,1,0,0,3,1352,17.01
24630,1,3,0,1,0,0,5,8690,54.42
24631,1,5,0,1,0,0,7,13868,78.23
24632,1,3,1,1,0,0,6,11521,68.36
24633,1,1,2,1,0,0,5,8690,54.42
24634,1,0,3,1,0,0,5,8690,54.42
24635,1,3,0,1,0,0,5,8690,54.42
24636,1,3,1,1,0,0,6,11521,68.36
24637,1,3,0,1,0,0,5,8690,54.42
24638,1,4,0,1,0,0,6,11521,68.36
24639,1,1,0,1,0,0,3,1352,17.01
24640,1,1,1,1,1,0,5,8690,54.42
24641,1,3,0,1,0,0,5,8690,54.42
24642,1,1,1,1,0,0,4,4966,36.77
24643,3,0,5,2,3,0,13,17456,94.66
24644,1,5,1,1,0,0,8,15186,83.84
24645,1,1,2,2,3,0,9,15950,87.44
24646,1,2,1,1,0,0,5,8690,54.42
24647,1,0,3,2,0,0,6,11521,68.36
24648,1,3,0,1,0,0,5,8690,54.42
24649,1,0,1,1,0,0,3,1352,17.01
24650,1,4,0,1,0,0,6,11521,68.36
24651,1,3,0,1,0,0,5,8690,54.42
24652,1,1,1,1,0,0,4,4966,36.77
24653,1,1,1,1,0,6,10,16522,90.12
24654,1,2,0,1,0,0,4,4966,36.77
24655,1,5,0,1,0,0,7,13868,78.23
24656,1,5,0,1,0,0,7,13868,78.23
24657,1,2,4,1,2,0,10,16522,90.12
24658,3,0,4,2,5,10,24,18547,99.89
24659,3,0,5,2,3,0,13,17456,94.66
24660,1,1,1,1,0,0,4,4966,36.77
24661,1,0,1,1,0,0,3,1352,17.01
24662,1,3,0,1,0,0,5,8690,54.42
24663,1,4,0,1,0,0,6,11521,68.36
24664,1,4,0,1,0,0,6,11521,68.36
24665,1,1,0,1,0,0,3,1352,17.01
24666,1,2,1,1,0,0,5,8690,54.42
24667,1,4,0,1,0,0,6,11521,68.36
24668,1,2,0,1,0,0,4,4966,36.77
24669,1,0,1,1,0,6,9,15950,87.44
24670,1,3,1,1,0,0,6,11521,68.36
24671,1,3,1,1,0,0,6,11521,68.36
24672,1,0,2,1,0,0,4,4966,36.77
24673,1,1,3,1,0,0,6,11521,68.36
24674,1,0,4,1,0,0,6,11521,68.36
24675,3,0,5,2,3,0,13,17456,94.66
24676,1,0,1,1,0,0,3,1352,17.01
24677,3,1,5,1,2,0,12,17186,93.28
24678,3,0,5,2,3,0,13,17456,94.66
24679,1,1,2,1,0,0,5,8690,54.42
24680,1,0,1,1,0,0,3,1352,17.01
24681,1,2,1,1,0,0,5,8690,54.42
24682,1,0,1,1,0,0,3,1352,17.01
24683,1,0,2,1,0,0,4,4966,36.77
24684,1,4,0,1,0,0,6,11521,68.36
24685,1,1,2,1,0,0,5,8690,54.42
24686,1,0,1,1,0,0,3,1352,17.01
24687,1,0,0,1,0,0,2,32,3.72
24688,3,1,5,2,4,0,15,17888,96.85
24689,3,2,5,2,3,0,15,17888,96.85
24690,4,0,5,3,5,0,17,18193,98.23
24691,1,1,2,1,0,0,5,8690,54.42
24692,3,0,5,1,3,10,22,18498,99.73
24693,1,0,4,1,1,0,7,13868,78.23
24694,1,1,1,1,0,0,4,4966,36.77
24695,1,0,0,1,0,0,2,32,3.72
24696,1,1,2,1,0,0,5,8690,54.42
24697,1,1,0,1,0,0,3,1352,17.01
24699,1,0,1,1,0,0,3,1352,17.01
24700,1,4,1,1,0,0,7,13868,78.23
24701,1,2,0,1,0,0,4,4966,36.77
24702,1,4,2,1,0,0,8,15186,83.84
24703,1,4,0,1,0,0,6,11521,68.36
24704,1,0,3,1,0,0,5,8690,54.42
24705,1,0,0,1,0,0,2,32,3.72
24706,1,0,0,1,0,0,2,32,3.72
24707,1,4,0,1,0,0,6,11521,68.36
24708,1,3,0,1,0,0,5,8690,54.42
24709,1,1,0,1,0,0,3,1352,17.01
24710,1,3,1,1,0,0,6,11521,68.36
24711,1,4,1,1,0,0,7,13868,78.23
24712,1,0,1,1,0,2,5,8690,54.42
24713,1,2,1,1,0,6,11,16947,91.91
24714,3,0,5,2,5,2,17,18193,98.23
24715,1,4,0,1,0,0,6,11521,68.36
24716,1,4,0,1,0,0,6,11521,68.36
24717,3,0,5,2,2,6,18,18287,98.68
24718,1,3,1,1,0,0,6,11521,68.36
24719,1,0,1,1,0,0,3,1352,17.01
24721,1,0,1,1,0,0,3,1352,17.01
24722,3,0,5,3,3,0,14,17699,95.82
24723,1,0,1,1,0,6,9,15950,87.44
24724,1,0,1,1,0,0,3,1352,17.01
24725,1,1,1,1,0,0,4,4966,36.77
24726,1,3,0,1,0,0,5,8690,54.42
24727,1,0,0,1,0,0,2,32,3.72
24728,1,3,1,1,0,0,6,11521,68.36
24730,1,1,1,1,0,0,4,4966,36.77
24731,1,2,1,1,0,0,5,8690,54.42
24732,1,4,0,1,0,0,6,11521,68.36
24733,1,1,1,1,0,0,4,4966,36.77
24735,1,0,1,1,0,0,3,1352,17.01
24736,1,1,2,1,0,0,5,8690,54.42
24737,1,1,1,1,0,0,4,4966,36.77
24738,1,0,3,1,1,0,6,11521,68.36
24739,1,0,1,1,0,4,7,13868,78.23
24740,1,1,1,1,0,0,4,4966,36.77
24741,1,2,1,1,0,0,5,8690,54.42
24742,1,4,0,1,0,0,6,11521,68.36
24743,1,1,1,1,0,0,4,4966,36.77
24744,1,3,0,1,0,0,5,8690,54.42
24745,1,0,0,1,0,0,2,32,3.72
24746,1,2,0,1,0,0,4,4966,36.77
24747,1,0,3,1,2,6,13,17456,94.66
24748,1,1,1,1,0,0,4,4966,36.77
24749,1,1,5,2,1,0,10,16522,90.12
24750,1,0,2,1,0,8,12,17186,93.28
24751,1,3,1,2,0,0,7,13868,78.23
24752,1,4,1,1,0,0,7,13868,78.23
24753,1,4,0,1,0,0,6,11521,68.36
24754,1,2,0,1,0,0,4,4966,36.77
24755,1,0,1,1,0,0,3,1352,17.01
24756,1,5,0,1,0,0,7,13868,78.23
24757,1,5,0,1,0,0,7,13868,78.23
24758,1,0,4,2,1,0,8,15186,83.84
24759,1,0,2,1,0,0,4,4966,36.77
24760,1,2,0,1,0,0,4,4966,36.77
24761,1,2,0,1,0,0,4,4966,36.77
24762,1,2,0,1,0,0,4,4966,36.77
24763,1,1,1,1,0,0,4,4966,36.77
24764,1,0,1,1,0,4,7,13868,78.23
24765,1,1,2,1,0,0,5,8690,54.42
24766,1,1,4,2,2,0,10,16522,90.12
24767,1,3,0,1,0,0,5,8690,54.42
24768,1,0,0,1,0,0,2,32,3.72
24769,1,0,2,1,0,0,4,4966,36.77
24770,1,0,1,1,0,0,3,1352,17.01
24771,1,1,1,1,0,0,4,4966,36.77
24772,1,0,1,1,0,0,3,1352,17.01
24773,1,0,0,1,0,0,2,32,3.72
24775,1,1,2,1,0,0,5,8690,54.42
24776,1,4,0,0,0,0,5,8690,54.42
24777,1,0,0,1,0,0,2,32,3.72
24778,1,4,0,1,0,0,6,11521,68.36
24779,1,1,1,1,0,0,4,4966,36.77
24780,1,0,2,1,0,0,4,4966,36.77
24781,1,4,0,1,0,0,6,11521,68.36
24782,1,0,1,1,0,0,3,1352,17.01
24783,1,0,1,1,0,0,3,1352,17.01
24784,1,1,1,1,0,4,8,15186,83.84
24785,1,0,2,1,0,0,4,4966,36.77
24786,1,0,0,1,0,0,2,32,3.72
24787,1,0,1,1,0,0,3,1352,17.01
24788,3,4,5,4,3,0,19,18362,99.04
24789,3,2,5,5,0,0,15,17888,96.85
24790,3,3,5,4,5,0,20,18419,99.31
24791,1,1,0,1,0,0,3,1352,17.01
24792,1,2,0,1,0,0,4,4966,36.77
24793,1,3,1,1,0,0,6,11521,68.36
24794,1,0,0,1,0,0,2,32,3.72
24795,1,1,1,1,0,0,4,4966,36.77
24796,1,0,3,1,1,0,6,11521,68.36
24797,1,1,1,1,0,0,4,4966,36.77
24798,1,1,0,1,0,0,3,1352,17.01
24799,1,1,1,1,0,0,4,4966,36.77
24800,1,1,2,1,0,0,5,8690,54.42
24801,1,1,0,1,0,0,3,1352,17.01
24802,1,2,0,1,0,0,4,4966,36.77
24803,3,1,5,2,4,0,15,17888,96.85
24804,3,0,5,2,5,0,15,17888,96.85
24805,3,0,5,2,3,0,13,17456,94.66
24806,1,0,3,1,0,4,9,15950,87.44
24807,1,2,1,1,0,0,5,8690,54.42
24808,1,3,0,1,0,0,5,8690,54.42
24809,1,2,1,1,0,0,5,8690,54.42
24810,1,1,1,1,0,0,4,4966,36.77
24811,1,4,1,1,0,0,7,13868,78.23
24812,1,4,0,1,0,0,6,11521,68.36
24813,1,0,0,1,0,0,2,32,3.72
24814,1,0,2,1,0,0,4,4966,36.77
24815,1,1,1,1,0,0,4,4966,36.77
24816,3,0,5,2,3,4,17,18193,98.23
24817,1,4,4,2,0,0,11,16947,91.91
24818,1,0,2,1,1,6,11,16947,91.91
24819,1,1,2,1,0,0,5,8690,54.42
24820,1,1,1,1,0,0,4,4966,36.77
24821,1,3,1,1,0,0,6,11521,68.36
24822,1,3,1,1,0,0,6,11521,68.36
24823,1,1,1,1,0,6,10,16522,90.12
24824,1,1,0,1,0,0,3,1352,17.01
24825,1,0,0,1,0,0,2,32,3.72
24826,1,0,2,1,0,0,4,4966,36.77
24827,1,5,0,1,0,0,7,13868,78.23
24828,1,2,1,1,0,0,5,8690,54.42
24829,1,4,0,1,0,0,6,11521,68.36
24830,1,0,1,1,0,0,3,1352,17.01
24831,1,1,0,1,0,0,3,1352,17.01
24832,1,1,1,1,0,0,4,4966,36.77
24833,1,0,0,1,0,0,2,32,3.72
24834,1,1,0,1,0,0,3,1352,17.01
24835,1,0,1,1,0,0,3,1352,17.01
24836,1,0,1,1,0,0,3,1352,17.01
24837,1,2,1,1,0,0,5,8690,54.42
24838,1,1,0,1,0,0,3,1352,17.01
24839,1,0,1,1,0,0,3,1352,17.01
24840,1,0,1,1,0,0,3,1352,17.01
24841,1,3,0,1,0,0,5,8690,54.42
24842,1,1,1,1,0,0,4,4966,36.77
24843,1,0,2,1,1,0,5,8690,54.42
24844,1,0,5,1,2,0,9,15950,87.44
24845,1,2,0,1,0,0,4,4966,36.77
24846,1,1,0,1,0,0,3,1352,17.01
24847,1,0,1,1,0,6,9,15950,87.44
24848,1,4,0,1,0,0,6,11521,68.36
24849,1,0,1,1,0,0,3,1352,17.01
24850,1,0,2,1,0,0,4,4966,36.77
24851,1,1,1,1,0,0,4,4966,36.77
24852,1,0,3,1,1,0,6,11521,68.36
24853,1,2,0,1,0,0,4,4966,36.77
24854,1,2,0,1,0,0,4,4966,36.77
24855,1,1,2,1,1,0,6,11521,68.36
24856,1,0,0,1,0,0,2,32,3.72
24857,3,0,5,2,3,6,19,18362,99.04
24858,1,0,0,1,0,0,2,32,3.72
24859,1,0,0,1,0,0,2,32,3.72
24860,3,0,5,1,3,0,12,17186,93.28
24861,1,1,0,1,0,0,3,1352,17.01
24862,1,1,0,1,0,0,3,1352,17.01
24863,1,0,0,1,0,2,4,4966,36.77
24864,1,0,1,1,0,0,3,1352,17.01
24865,1,0,0,1,0,0,2,32,3.72
24866,1,0,0,1,0,0,2,32,3.72
24867,1,0,2,1,0,0,4,4966,36.77
24868,1,1,0,1,0,0,3,1352,17.01
24869,1,0,0,1,0,0,2,32,3.72
24870,1,0,0,1,0,0,2,32,3.72
24871,1,0,0,1,0,0,2,32,3.72
24872,1,0,0,1,0,0,2,32,3.72
24873,1,1,0,1,0,0,3,1352,17.01
24874,1,0,1,1,0,0,3,1352,17.01
24875,1,2,1,1,0,0,5,8690,54.42
24876,1,2,0,1,0,0,4,4966,36.77
24877,1,4,1,2,0,0,8,15186,83.84
24878,1,3,1,1,0,0,6,11521,68.36
24879,1,2,0,1,0,0,4,4966,36.77
24880,1,0,4,2,1,0,8,15186,83.84
24881,1,0,1,1,0,0,3,1352,17.01
24882,1,2,2,1,0,0,6,11521,68.36
24883,1,0,2,1,0,2,6,11521,68.36
24884,1,1,1,1,0,0,4,4966,36.77
24885,3,0,5,2,4,0,14,17699,95.82
24886,3,0,5,2,3,0,13,17456,94.66
24887,4,0,5,3,5,0,17,18193,98.23
24888,3,2,5,3,3,0,16,18081,97.67
24889,1,1,0,1,0,4,7,13868,78.23
24890,1,4,0,1,0,0,6,11521,68.36
24891,1,2,1,1,0,0,5,8690,54.42
24892,1,3,0,1,0,0,5,8690,54.42
24893,1,3,1,1,0,0,6,11521,68.36
24894,1,2,0,1,0,0,4,4966,36.77
24895,1,4,1,1,0,0,7,13868,78.23
24896,1,0,1,1,0,0,3,1352,17.01
24897,1,0,1,1,0,0,3,1352,17.01
24898,1,3,1,1,0,0,6,11521,68.36
24899,1,0,1,1,0,4,7,13868,78.23
24900,1,1,1,1,0,0,4,4966,36.77
24901,1,0,0,1,4,0,6,11521,68.36
24902,1,3,1,1,0,0,6,11521,68.36
24903,1,0,1,1,0,0,3,1352,17.01
24904,1,5,0,1,0,0,7,13868,78.23
24905,1,0,0,1,0,0,2,32,3.72
24906,1,1,0,1,0,0,3,1352,17.01
24907,3,0,5,2,4,0,14,17699,95.82
24908,1,1,2,1,0,0,5,8690,54.42
24909,1,0,2,1,0,0,4,4966,36.77
24910,1,1,2,1,1,0,6,11521,68.36
24911,1,4,0,1,0,0,6,11521,68.36
24912,1,0,0,1,0,0,2,32,3.72
24913,1,4,0,1,0,0,6,11521,68.36
24914,1,1,1,1,0,0,4,4966,36.77
24915,1,0,1,1,0,0,3,1352,17.01
24916,1,0,2,1,0,0,4,4966,36.77
24917,1,2,4,1,0,0,8,15186,83.84
24918,1,2,0,1,0,0,4,4966,36.77
24919,1,1,0,1,0,0,3,1352,17.01
24920,1,2,0,1,0,0,4,4966,36.77
24921,1,2,1,1,0,0,5,8690,54.42
24922,1,0,0,1,0,0,2,32,3.72
24923,1,1,0,1,0,0,3,1352,17.01
24924,1,0,2,1,0,0,4,4966,36.77
24925,3,5,4,4,4,0,20,18419,99.31
24926,1,4,0,1,0,0,6,11521,68.36
24927,3,1,4,3,1,0,12,17186,93.28
24928,1,0,1,1,0,0,3,1352,17.01
24929,1,0,0,1,0,0,2,32,3.72
24930,1,1,1,1,0,0,4,4966,36.77
24931,1,0,1,1,0,2,5,8690,54.42
24932,1,4,0,1,0,0,6,11521,68.36
24933,1,3,0,1,0,0,5,8690,54.42
24934,1,0,1,1,0,0,3,1352,17.01
24935,1,1,0,1,0,0,3,1352,17.01
24936,1,1,1,1,0,0,4,4966,36.77
24937,1,3,2,1,1,0,8,15186,83.84
24938,1,0,1,1,0,0,3,1352,17.01
24939,1,1,1,1,0,0,4,4966,36.77
24940,1,1,5,2,4,0,13,17456,94.66
24941,3,0,5,2,4,0,14,17699,95.82
24942,1,0,5,2,2,0,10,16522,90.12
24943,1,0,1,1,0,0,3,1352,17.01
24944,1,0,2,1,0,0,4,4966,36.77
24945,1,1,0,1,0,0,3,1352,17.01
24946,1,1,1,1,0,0,4,4966,36.77
24947,1,1,0,1,0,0,3,1352,17.01
24949,1,1,0,1,0,0,3,1352,17.01
24950,1,0,0,1,0,0,2,32,3.72
24951,3,0,5,1,2,0,11,16947,91.91
24952,1,1,4,2,1,0,9,15950,87.44
24953,3,0,5,2,2,0,12,17186,93.28
24954,3,0,5,2,3,2,15,17888,96.85
24955,1,4,1,1,0,0,7,13868,78.23
24956,1,3,0,1,0,0,5,8690,54.42
24957,1,1,2,1,0,0,5,8690,54.42
24958,1,2,2,1,0,0,6,11521,68.36
24959,1,0,0,1,0,2,4,4966,36.77
24960,1,5,2,2,0,0,10,16522,90.12
24961,1,3,0,1,0,0,5,8690,54.42
24962,1,0,1,1,0,6,9,15950,87.44
24963,1,2,0,1,0,0,4,4966,36.77
24964,1,0,1,1,0,4,7,13868,78.23
24965,1,4,0,1,0,0,6,11521,68.36
24966,1,0,0,1,0,0,2,32,3.72
24967,1,0,1,1,0,0,3,1352,17.01
24968,1,1,2,1,4,4,13,17456,94.66
24969,1,0,1,1,0,0,3,1352,17.01
24970,1,2,0,1,0,0,4,4966,36.77
24971,1,1,1,1,0,0,4,4966,36.77
24972,1,0,1,1,0,0,3,1352,17.01
24973,1,1,1,1,0,4,8,15186,83.84
24974,1,2,1,1,0,0,5,8690,54.42
24975,1,0,0,1,0,0,2,32,3.72
24976,1,0,1,1,0,0,3,1352,17.01
24977,1,3,0,1,0,0,5,8690,54.42
24978,1,0,1,1,0,0,3,1352,17.01
24979,1,0,3,1,0,0,5,8690,54.42
24980,1,2,1,1,0,0,5,8690,54.42
24981,3,4,5,4,4,0,20,18419,99.31
24982,3,1,5,4,3,0,16,18081,97.67
24983,3,4,4,4,4,0,19,18362,99.04
24984,1,0,3,1,0,0,5,8690,54.42
24985,1,0,2,1,0,10,14,17699,95.82
24986,1,0,1,1,0,0,3,1352,17.01
24987,3,0,3,1,3,0,10,16522,90.12
24988,1,1,1,1,0,0,4,4966,36.77
24989,1,2,0,1,0,0,4,4966,36.77
24990,1,0,1,1,0,0,3,1352,17.01
24991,1,2,1,1,0,0,5,8690,54.42
24992,1,1,1,1,0,0,4,4966,36.77
24993,3,1,5,2,4,0,15,17888,96.85
24994,3,0,5,2,4,6,20,18419,99.31
24995,3,0,5,2,5,6,21,18462,99.52
24996,1,0,1,1,0,0,3,1352,17.01
24997,3,0,5,2,3,0,13,17456,94.66
24998,1,4,2,1,0,0,8,15186,83.84
24999,1,0,1,1,0,2,5,8690,54.42
25000,1,2,1,1,0,0,5,8690,54.42
25001,1,0,1,1,0,0,3,1352,17.01
25002,1,4,0,1,0,0,6,11521,68.36
25003,1,0,0,0,0,0,1,1,0.08
25004,1,0,1,1,0,0,3,1352,17.01
25005,1,2,1,1,0,4,9,15950,87.44
25006,1,1,1,1,0,0,4,4966,36.77
25007,1,2,0,1,0,0,4,4966,36.77
25008,1,2,0,1,0,0,4,4966,36.77
25009,1,1,0,1,0,0,3,1352,17.01
25010,1,2,0,1,0,0,4,4966,36.77
25011,1,0,0,1,0,0,2,32,3.72
25012,1,4,0,1,0,0,6,11521,68.36
25013,1,1,2,1,0,0,5,8690,54.42
25014,1,1,0,1,0,0,3,1352,17.01
25015,1,2,1,1,3,0,8,15186,83.84
25016,1,0,1,1,0,0,3,1352,17.01
25017,1,2,0,1,0,0,4,4966,36.77
25018,1,4,1,1,0,0,7,13868,78.23
25019,1,2,1,1,0,0,5,8690,54.42
25020,1,1,1,1,0,0,4,4966,36.77
25021,1,1,1,1,0,0,4,4966,36.77
25022,1,2,1,1,0,0,5,8690,54.42
25023,1,0,0,1,0,0,2,32,3.72
25024,1,1,1,1,0,0,4,4966,36.77
25025,1,4,0,1,0,0,6,11521,68.36
25026,1,0,0,1,0,0,2,32,3.72
25027,4,0,5,1,3,0,13,17456,94.66
25028,1,1,0,1,0,0,3,1352,17.01
25029,1,3,0,1,0,0,5,8690,54.42
25030,1,0,1,1,0,0,3,1352,17.01
25031,1,2,1,1,0,0,5,8690,54.42
25032,1,3,0,1,0,0,5,8690,54.42
25033,1,2,1,1,0,0,5,8690,54.42
25034,1,2,4,1,1,0,9,15950,87.44
25035,1,1,1,1,0,0,4,4966,36.77
25036,1,1,0,1,0,0,3,1352,17.01
25037,1,2,0,1,0,0,4,4966,36.77
25038,3,1,5,4,4,0,17,18193,98.23
25039,3,3,5,5,0,0,16,18081,97.67
25040,1,0,5,1,0,0,7,13868,78.23
25041,1,0,1,1,0,0,3,1352,17.01
25042,1,0,1,1,0,0,3,1352,17.01
25043,1,0,1,1,0,0,3,1352,17.01
25044,1,0,1,1,0,0,3,1352,17.01
25045,1,0,0,1,0,0,2,32,3.72
25046,1,4,1,1,0,0,7,13868,78.23
25047,1,1,1,1,0,0,4,4966,36.77
25048,1,5,0,1,0,0,7,13868,78.23
25049,1,0,1,1,0,0,3,1352,17.01
25050,1,1,0,1,0,0,3,1352,17.01
25051,1,4,1,1,0,0,7,13868,78.23
25052,1,4,1,1,0,0,7,13868,78.23
25053,1,4,2,1,0,0,8,15186,83.84
25054,1,4,1,1,0,0,7,13868,78.23
25055,1,5,1,1,0,0,8,15186,83.84
25056,3,2,5,2,4,6,22,18498,99.73
25057,1,1,2,1,0,0,5,8690,54.42
25058,1,0,2,2,0,0,5,8690,54.42
25059,1,0,0,1,0,0,2,32,3.72
25060,1,0,2,1,0,0,4,4966,36.77
25061,1,3,0,1,0,0,5,8690,54.42
25062,1,4,0,1,0,0,6,11521,68.36
25063,1,0,1,1,0,0,3,1352,17.01
25064,1,0,2,1,0,0,4,4966,36.77
25065,1,0,0,1,0,0,2,32,3.72
25066,1,0,0,1,0,0,2,32,3.72
25067,3,0,5,2,2,0,12,17186,93.28
25068,1,1,0,1,0,0,3,1352,17.01
25069,3,1,5,2,2,0,13,17456,94.66
25070,3,0,5,1,4,0,13,17456,94.66
25071,1,1,1,1,0,0,4,4966,36.77
25072,1,2,2,1,0,0,6,11521,68.36
25073,1,2,1,1,0,0,5,8690,54.42
25074,1,0,1,1,0,0,3,1352,17.01
25075,1,1,1,1,0,0,4,4966,36.77
25076,1,1,0,1,0,0,3,1352,17.01
25077,1,0,0,1,0,0,2,32,3.72
25078,1,2,0,1,0,0,4,4966,36.77
25079,1,4,0,1,0,0,6,11521,68.36
25080,1,1,0,1,0,0,3,1352,17.01
25081,1,1,0,1,0,0,3,1352,17.01
25082,1,2,1,1,0,0,5,8690,54.42
25084,1,4,0,1,0,0,6,11521,68.36
25085,1,0,3,2,3,0,9,15950,87.44
25086,1,2,1,1,0,0,5,8690,54.42
25087,1,0,1,1,0,0,3,1352,17.01
25088,1,0,1,1,0,0,3,1352,17.01
25089,1,3,4,2,0,0,10,16522,90.12
25090,1,1,1,1,0,0,4,4966,36.77
25091,1,3,0,1,0,0,5,8690,54.42
25092,1,1,1,1,0,0,4,4966,36.77
25093,1,0,1,1,0,0,3,1352,17.01
25094,1,1,1,1,0,0,4,4966,36.77
25095,1,4,0,1,0,0,6,11521,68.36
25096,1,4,1,1,0,0,7,13868,78.23
25097,3,0,5,2,3,0,13,17456,94.66
25098,3,0,5,2,1,0,11,16947,91.91
25099,3,4,5,4,4,0,20,18419,99.31
25100,3,5,2,4,3,0,17,18193,98.23
25101,1,1,1,1,0,0,4,4966,36.77
25102,3,0,5,3,3,0,14,17699,95.82
25103,1,1,0,1,0,0,3,1352,17.01
25104,1,0,1,1,0,6,9,15950,87.44
25105,1,1,1,1,0,0,4,4966,36.77
25106,1,1,4,1,0,0,7,13868,78.23
25107,1,1,1,1,0,0,4,4966,36.77
25108,1,3,0,1,0,0,5,8690,54.42
25109,1,0,1,1,0,0,3,1352,17.01
25110,3,0,3,2,4,0,12,17186,93.28
25111,1,0,0,1,0,0,2,32,3.72
25112,1,0,1,1,0,0,3,1352,17.01
25113,1,2,1,1,0,0,5,8690,54.42
25114,3,4,5,3,3,0,18,18287,98.68
25115,1,3,2,1,0,0,7,13868,78.23
25116,1,0,2,1,0,0,4,4966,36.77
25118,1,0,3,1,1,0,6,11521,68.36
25119,1,2,1,1,0,0,5,8690,54.42
25120,1,2,1,1,0,0,5,8690,54.42
25121,1,4,2,2,0,0,9,15950,87.44
25122,1,2,0,1,0,0,4,4966,36.77
25123,1,3,0,1,0,0,5,8690,54.42
25124,1,1,0,1,0,0,3,1352,17.01
25125,1,1,1,1,0,0,4,4966,36.77
25126,1,2,1,1,0,0,5,8690,54.42
25127,1,1,1,1,0,0,4,4966,36.77
25128,1,0,1,1,0,0,3,1352,17.01
25129,1,2,2,2,0,0,7,13868,78.23
25130,1,0,1,1,0,0,3,1352,17.01
25131,1,3,1,1,0,0,6,11521,68.36
25132,1,0,1,1,0,0,3,1352,17.01
25133,1,0,1,1,0,0,3,1352,17.01
25134,1,3,3,2,0,0,9,15950,87.44
25135,3,0,5,2,4,6,20,18419,99.31
25136,1,1,1,1,0,0,4,4966,36.77
25137,3,0,5,2,3,0,13,17456,94.66
25138,3,0,5,2,3,0,13,17456,94.66
25139,1,1,0,1,0,0,3,1352,17.01
25140,1,0,1,1,0,0,3,1352,17.01
25141,1,2,0,1,0,0,4,4966,36.77
25142,1,0,0,1,0,0,2,32,3.72
25143,1,1,1,1,0,0,4,4966,36.77
25144,1,0,0,1,0,0,2,32,3.72
25145,1,2,1,1,0,0,5,8690,54.42
25148,1,3,0,1,0,0,5,8690,54.42
25149,1,0,1,1,0,0,3,1352,17.01
25150,1,2,1,1,0,0,5,8690,54.42
25151,1,3,0,1,0,0,5,8690,54.42
25152,1,0,1,1,0,2,5,8690,54.42
25153,1,4,0,1,0,0,6,11521,68.36
25154,1,0,1,1,0,0,3,1352,17.01
25155,1,1,0,1,0,0,3,1352,17.01
25156,1,0,0,1,0,0,2,32,3.72
25157,1,1,0,1,0,0,3,1352,17.01
25158,1,2,0,1,0,0,4,4966,36.77
25159,1,4,3,1,0,0,9,15950,87.44
25160,3,1,4,2,4,0,14,17699,95.82
25161,1,5,1,1,0,0,8,15186,83.84
25163,1,0,0,1,0,4,6,11521,68.36
25164,1,2,0,1,0,0,4,4966,36.77
25165,1,4,0,1,0,0,6,11521,68.36
25166,1,1,1,1,0,0,4,4966,36.77
25167,1,1,0,1,0,0,3,1352,17.01
25168,1,4,1,1,0,0,7,13868,78.23
25169,1,0,1,1,0,4,7,13868,78.23
25170,1,4,0,1,0,0,6,11521,68.36
25171,1,2,0,1,0,0,4,4966,36.77
25172,1,0,2,1,0,0,4,4966,36.77
25173,1,1,1,1,0,0,4,4966,36.77
25174,1,4,1,1,0,0,7,13868,78.23
25175,4,0,5,1,4,0,14,17699,95.82
25176,1,0,2,2,0,0,5,8690,54.42
25177,1,1,1,1,0,0,4,4966,36.77
25178,1,4,0,1,0,0,6,11521,68.36
25179,1,0,3,1,1,0,6,11521,68.36
25181,1,1,1,1,0,6,10,16522,90.12
25182,1,2,1,1,0,0,5,8690,54.42
25183,1,0,1,1,0,0,3,1352,17.01
25184,1,0,2,1,0,0,4,4966,36.77
25185,1,0,1,1,0,0,3,1352,17.01
25186,1,4,1,1,0,0,7,13868,78.23
25187,4,0,5,2,5,6,22,18498,99.73
25188,1,0,0,1,0,0,2,32,3.72
25189,1,0,4,3,3,0,11,16947,91.91
25190,1,0,1,1,0,0,3,1352,17.01
25191,1,0,2,1,0,0,4,4966,36.77
25192,1,1,4,1,0,0,7,13868,78.23
25193,1,3,0,1,0,0,5,8690,54.42
25194,1,1,2,1,0,0,5,8690,54.42
25195,1,2,2,1,0,0,6,11521,68.36
25196,1,0,1,1,0,0,3,1352,17.01
25197,1,3,0,1,0,0,5,8690,54.42
25198,1,4,0,1,0,0,6,11521,68.36
25199,1,0,1,1,0,0,3,1352,17.01
25200,1,0,1,1,0,0,3,1352,17.01
25201,1,1,0,1,0,0,3,1352,17.01
25202,1,2,4,2,1,0,10,16522,90.12
25203,4,0,5,2,5,6,22,18498,99.73
25204,1,3,1,1,0,0,6,11521,68.36
25205,1,1,2,1,0,0,5,8690,54.42
25206,1,2,0,1,0,0,4,4966,36.77
25207,1,0,1,1,1,0,4,4966,36.77
25208,1,0,0,1,0,0,2,32,3.72
25209,1,0,0,1,0,0,2,32,3.72
25210,1,2,0,1,0,0,4,4966,36.77
25211,1,1,2,1,0,0,5,8690,54.42
25212,1,1,0,1,0,0,3,1352,17.01
25213,3,0,5,2,4,0,14,17699,95.82
25214,3,4,5,3,4,0,19,18362,99.04
25215,1,1,1,1,0,0,4,4966,36.77
25216,3,3,5,2,4,4,21,18462,99.52
25217,3,0,5,2,3,0,13,17456,94.66
25218,1,2,0,1,0,0,4,4966,36.77
25219,1,1,1,1,0,0,4,4966,36.77
25220,1,1,0,1,0,0,3,1352,17.01
25221,1,4,3,2,0,0,10,16522,90.12
25222,1,1,1,1,0,0,4,4966,36.77
25223,1,4,0,1,0,0,6,11521,68.36
25224,1,1,1,1,0,0,4,4966,36.77
25225,1,0,2,1,0,0,4,4966,36.77
25226,1,4,0,1,0,0,6,11521,68.36
25227,1,1,2,1,0,0,5,8690,54.42
25228,1,4,1,1,0,0,7,13868,78.23
25229,1,3,0,1,0,0,5,8690,54.42
25230,1,0,2,1,0,0,4,4966,36.77
25231,3,1,5,1,3,0,13,17456,94.66
25232,3,0,5,2,3,0,13,17456,94.66
25233,1,4,0,1,0,0,6,11521,68.36
25234,1,2,0,1,0,0,4,4966,36.77
25235,1,2,1,1,0,0,5,8690,54.42
25236,1,2,1,1,0,6,11,16947,91.91
25237,1,0,0,1,0,0,2,32,3.72
25238,1,0,1,1,0,0,3,1352,17.01
25239,1,0,0,1,0,0,2,32,3.72
25240,1,0,3,2,1,0,7,13868,78.23
25241,1,0,1,1,0,0,3,1352,17.01
25242,1,0,2,1,0,0,4,4966,36.77
25243,1,0,1,1,0,0,3,1352,17.01
25244,1,2,0,1,0,0,4,4966,36.77
25245,1,1,1,1,0,6,10,16522,90.12
25246,1,3,0,1,0,0,5,8690,54.42
25247,1,1,3,1,0,0,6,11521,68.36
25248,1,1,0,1,0,0,3,1352,17.01
25249,3,2,5,1,3,6,20,18419,99.31
25250,1,1,0,1,0,0,3,1352,17.01
25251,1,0,1,1,0,0,3,1352,17.01
25252,1,1,1,1,0,0,4,4966,36.77
25253,1,0,1,1,0,0,3,1352,17.01
25254,1,5,2,2,0,0,10,16522,90.12
25255,3,0,5,2,3,0,13,17456,94.66
25256,1,4,1,1,0,0,7,13868,78.23
25257,1,1,0,1,0,0,3,1352,17.01
25258,1,0,1,1,0,0,3,1352,17.01
25259,3,1,5,2,3,0,14,17699,95.82
25260,3,0,4,2,5,6,20,18419,99.31
25261,3,0,5,2,3,0,13,17456,94.66
25262,1,2,0,1,0,0,4,4966,36.77
25263,1,3,1,1,0,0,6,11521,68.36
25264,1,0,0,1,0,0,2,32,3.72
25265,1,1,1,1,0,0,4,4966,36.77
25266,1,4,0,1,0,0,6,11521,68.36
25267,1,1,0,1,0,0,3,1352,17.01
25268,1,0,1,1,0,0,3,1352,17.01
25269,1,0,4,2,1,0,8,15186,83.84
25270,3,0,5,3,3,0,14,17699,95.82
25271,3,0,5,1,3,0,12,17186,93.28
25272,3,1,2,4,3,0,13,17456,94.66
25273,3,0,5,1,3,0,12,17186,93.28
25274,3,1,3,3,3,0,13,17456,94.66
25275,1,2,1,1,0,0,5,8690,54.42
25276,1,0,1,1,0,0,3,1352,17.01
25277,1,0,0,1,0,0,2,32,3.72
25278,1,2,0,1,1,0,5,8690,54.42
25279,1,0,0,1,0,0,2,32,3.72
25281,1,2,2,1,0,0,6,11521,68.36
25282,1,0,0,1,0,0,2,32,3.72
25283,1,1,1,1,0,0,4,4966,36.77
25284,1,0,0,1,0,0,2,32,3.72
25285,1,2,0,1,0,0,4,4966,36.77
25286,1,2,0,1,0,0,4,4966,36.77
25287,1,2,2,1,1,0,7,13868,78.23
25288,1,0,2,1,0,0,4,4966,36.77
25289,1,1,0,1,0,0,3,1352,17.01
25290,1,1,1,1,0,0,4,4966,36.77
25291,1,2,0,1,0,0,4,4966,36.77
25292,1,0,1,1,0,0,3,1352,17.01
25293,1,2,1,1,0,0,5,8690,54.42
25294,1,0,0,1,0,0,2,32,3.72
25295,1,1,1,1,0,0,4,4966,36.77
25296,1,2,0,1,0,0,4,4966,36.77
25297,1,0,1,1,0,0,3,1352,17.01
25298,1,3,1,1,0,0,6,11521,68.36
25299,1,1,1,1,0,0,4,4966,36.77
25300,1,1,1,1,0,0,4,4966,36.77
25301,1,1,0,1,0,0,3,1352,17.01
25302,1,2,0,1,0,0,4,4966,36.77
25303,1,1,0,0,0,0,2,32,3.72
25304,1,2,0,1,0,0,4,4966,36.77
25305,1,1,1,1,0,0,4,4966,36.77
25306,1,1,1,1,0,4,8,15186,83.84
25307,1,1,0,1,0,0,3,1352,17.01
25308,1,1,1,1,0,0,4,4966,36.77
25309,1,2,1,1,0,0,5,8690,54.42
25310,1,1,1,1,0,0,4,4966,36.77
25311,1,2,0,1,0,0,4,4966,36.77
25312,1,0,1,1,0,0,3,1352,17.01
25313,1,0,0,1,0,0,2,32,3.72
25314,1,1,0,1,0,0,3,1352,17.01
25315,1,1,2,1,0,0,5,8690,54.42
25316,3,3,5,2,2,0,15,17888,96.85
25317,1,1,4,1,1,0,8,15186,83.84
25318,3,0,5,2,3,0,13,17456,94.66
25319,1,3,2,1,0,0,7,13868,78.23
25320,1,0,1,1,0,0,3,1352,17.01
25321,1,0,1,1,0,0,3,1352,17.01
25322,1,1,0,1,0,0,3,1352,17.01
25323,1,2,3,2,0,0,8,15186,83.84
25324,1,0,0,1,0,0,2,32,3.72
25325,1,0,0,1,0,0,2,32,3.72
25326,1,2,1,1,0,0,5,8690,54.42
25327,1,0,2,1,0,0,4,4966,36.77
25328,1,1,0,1,0,0,3,1352,17.01
25329,1,0,2,1,0,0,4,4966,36.77
25330,1,0,3,1,0,0,5,8690,54.42
25331,1,0,1,1,1,10,14,17699,95.82
25332,3,0,5,2,3,0,13,17456,94.66
25333,3,1,5,2,3,0,14,17699,95.82
25334,3,1,4,2,2,0,12,17186,93.28
25335,1,0,0,1,0,0,2,32,3.72
25336,1,0,1,1,0,0,3,1352,17.01
25337,1,1,0,1,0,0,3,1352,17.01
25338,1,2,0,1,0,0,4,4966,36.77
25339,1,1,1,1,0,6,10,16522,90.12
25340,1,1,5,1,0,0,8,15186,83.84
25341,1,1,1,1,0,0,4,4966,36.77
25342,1,1,1,1,0,0,4,4966,36.77
25343,1,0,1,1,0,0,3,1352,17.01
25344,1,3,1,1,0,0,6,11521,68.36
25345,1,0,1,1,0,6,9,15950,87.44
25346,1,1,1,1,0,0,4,4966,36.77
25347,3,0,4,1,3,2,13,17456,94.66
25348,3,0,5,2,3,4,17,18193,98.23
25349,1,2,2,2,0,0,7,13868,78.23
25350,1,4,1,1,0,0,7,13868,78.23
25351,1,1,2,1,0,0,5,8690,54.42
25352,1,2,0,1,0,0,4,4966,36.77
25353,1,0,0,1,0,0,2,32,3.72
25354,1,0,1,1,0,0,3,1352,17.01
25355,1,1,1,1,0,0,4,4966,36.77
25356,1,2,1,1,0,0,5,8690,54.42
25357,1,0,1,1,0,0,3,1352,17.01
25358,1,1,1,1,0,0,4,4966,36.77
25359,1,1,0,1,0,0,3,1352,17.01
25360,1,3,0,0,0,0,4,4966,36.77
25361,1,0,0,1,0,0,2,32,3.72
25362,1,1,1,1,0,0,4,4966,36.77
25363,3,2,5,2,3,0,15,17888,96.85
25364,1,3,3,1,0,0,8,15186,83.84
25365,3,1,5,2,3,0,14,17699,95.82
25366,1,0,1,1,0,0,3,1352,17.01
25367,1,1,0,1,0,0,3,1352,17.01
25368,1,1,0,1,0,0,3,1352,17.01
25369,1,0,2,1,0,0,4,4966,36.77
25370,1,2,1,1,0,0,5,8690,54.42
25371,1,0,1,1,0,2,5,8690,54.42
25372,1,0,0,1,0,0,2,32,3.72
25373,1,0,0,1,0,0,2,32,3.72
25374,1,2,2,1,0,0,6,11521,68.36
25375,3,0,5,2,3,0,13,17456,94.66
25376,1,1,0,1,0,0,3,1352,17.01
25377,1,4,4,3,3,0,15,17888,96.85
25378,3,0,5,2,2,0,12,17186,93.28
25379,3,1,5,2,3,0,14,17699,95.82
25380,1,2,0,1,0,0,4,4966,36.77
25381,1,1,1,1,0,0,4,4966,36.77
25382,1,0,0,1,0,0,2,32,3.72
25383,1,0,0,1,0,0,2,32,3.72
25384,1,1,2,1,0,0,5,8690,54.42
25385,1,1,1,1,0,0,4,4966,36.77
25386,1,0,1,1,0,0,3,1352,17.01
25387,1,3,1,1,0,0,6,11521,68.36
25388,1,5,0,1,0,0,7,13868,78.23
25389,3,0,4,2,3,0,12,17186,93.28
25390,1,2,0,1,0,0,4,4966,36.77
25391,1,0,3,1,1,0,6,11521,68.36
25392,1,0,2,1,0,0,4,4966,36.77
25393,1,0,0,1,0,0,2,32,3.72
25394,3,1,5,2,3,0,14,17699,95.82
25395,1,4,0,1,0,0,6,11521,68.36
25396,1,1,3,2,0,0,7,13868,78.23
25397,1,4,0,1,0,0,6,11521,68.36
25398,1,0,0,1,0,2,4,4966,36.77
25399,1,0,1,1,1,0,4,4966,36.77
25400,1,2,0,1,0,0,4,4966,36.77
25401,1,0,1,1,0,0,3,1352,17.01
25402,1,3,0,1,0,0,5,8690,54.42
25403,1,1,1,1,0,0,4,4966,36.77
25404,1,1,1,1,0,0,4,4966,36.77
25405,1,5,0,1,0,0,7,13868,78.23
25406,3,0,5,2,5,8,23,18538,99.86
25407,3,0,5,2,2,0,12,17186,93.28
25408,3,0,5,2,2,0,12,17186,93.28
25409,1,1,2,1,1,6,12,17186,93.28
25410,1,4,1,1,0,0,7,13868,78.23
25411,1,0,0,1,0,0,2,32,3.72
25412,1,0,0,1,0,0,2,32,3.72
25413,1,1,1,1,0,0,4,4966,36.77
25414,1,3,1,1,0,0,6,11521,68.36
25415,1,3,0,1,0,0,5,8690,54.42
25416,1,4,0,1,0,0,6,11521,68.36
25417,1,0,2,1,0,6,10,16522,90.12
25418,3,1,4,2,3,2,15,17888,96.85
25419,1,1,0,1,0,0,3,1352,17.01
25420,3,1,5,2,2,0,13,17456,94.66
25421,1,2,0,1,0,0,4,4966,36.77
25422,1,0,5,2,0,0,8,15186,83.84
25423,1,0,1,1,0,0,3,1352,17.01
25424,1,2,1,1,0,0,5,8690,54.42
25425,1,4,0,1,0,0,6,11521,68.36
25426,1,0,0,0,0,0,1,1,0.08
25427,1,1,0,1,0,0,3,1352,17.01
25428,1,2,3,1,0,0,7,13868,78.23
25429,1,2,0,1,0,0,4,4966,36.77
25430,3,0,5,1,3,10,22,18498,99.73
25431,1,0,1,1,1,0,4,4966,36.77
25432,1,1,0,1,0,0,3,1352,17.01
25433,1,1,1,1,0,6,10,16522,90.12
25434,1,3,1,1,0,0,6,11521,68.36
25435,1,2,0,1,0,0,4,4966,36.77
25436,3,1,5,2,3,0,14,17699,95.82
25437,3,0,5,2,3,0,13,17456,94.66
25438,1,1,0,1,0,0,3,1352,17.01
25439,1,1,1,1,0,0,4,4966,36.77
25440,1,0,1,1,0,0,3,1352,17.01
25441,1,0,1,1,0,6,9,15950,87.44
25442,1,0,0,1,0,0,2,32,3.72
25443,1,1,0,1,0,0,3,1352,17.01
25444,1,4,1,1,0,0,7,13868,78.23
25445,1,3,1,1,0,0,6,11521,68.36
25446,1,3,0,1,0,0,5,8690,54.42
25447,1,1,0,1,0,0,3,1352,17.01
25448,1,2,0,1,0,0,4,4966,36.77
25449,1,0,1,1,0,0,3,1352,17.01
25450,1,1,0,1,1,0,4,4966,36.77
25451,1,2,0,1,0,0,4,4966,36.77
25452,1,1,0,1,0,0,3,1352,17.01
25453,1,2,1,1,0,0,5,8690,54.42
25454,1,1,0,1,0,0,3,1352,17.01
25455,1,1,1,1,0,0,4,4966,36.77
25456,1,2,1,1,0,0,5,8690,54.42
25457,1,0,2,1,0,0,4,4966,36.77
25458,1,3,1,1,0,0,6,11521,68.36
25459,1,0,1,1,0,0,3,1352,17.01
25460,1,0,1,1,0,0,3,1352,17.01
25461,1,2,0,1,0,0,4,4966,36.77
25462,1,1,2,1,0,0,5,8690,54.42
25463,3,0,4,1,3,8,19,18362,99.04
25464,1,2,2,1,0,0,6,11521,68.36
25465,1,2,1,1,0,6,11,16947,91.91
25466,1,0,0,1,0,0,2,32,3.72
25467,3,0,4,2,0,0,9,15950,87.44
25468,3,2,3,3,1,0,12,17186,93.28
25469,1,1,1,1,0,0,4,4966,36.77
25470,3,1,4,1,3,2,14,17699,95.82
25471,1,0,1,1,0,0,3,1352,17.01
25472,1,0,2,1,0,4,8,15186,83.84
25473,1,3,0,1,0,0,5,8690,54.42
25474,1,1,2,1,0,0,5,8690,54.42
25475,1,4,0,1,0,0,6,11521,68.36
25476,1,0,1,1,0,0,3,1352,17.01
25477,1,4,0,1,0,0,6,11521,68.36
25478,1,2,1,1,0,0,5,8690,54.42
25479,3,1,5,2,2,0,13,17456,94.66
25480,1,5,5,3,4,0,18,18287,98.68
25481,1,1,1,1,0,0,4,4966,36.77
25482,1,0,1,1,0,0,3,1352,17.01
25483,3,1,5,2,3,0,14,17699,95.82
25484,3,1,5,2,3,0,14,17699,95.82
25485,1,0,3,1,0,0,5,8690,54.42
25486,1,0,0,1,0,0,2,32,3.72
25487,1,0,0,1,0,6,8,15186,83.84
25488,1,0,0,1,1,0,3,1352,17.01
25489,1,0,1,1,0,0,3,1352,17.01
25490,1,1,1,1,0,0,4,4966,36.77
25491,1,1,2,1,0,0,5,8690,54.42
25492,1,2,1,1,0,0,5,8690,54.42
25493,1,0,2,1,0,0,4,4966,36.77
25494,3,0,5,2,3,0,13,17456,94.66
25495,1,5,0,1,0,0,7,13868,78.23
25496,1,3,3,1,0,0,8,15186,83.84
25497,1,1,1,1,0,0,4,4966,36.77
25498,1,4,2,1,0,0,8,15186,83.84
25499,1,0,1,1,0,0,3,1352,17.01
25500,1,1,2,1,3,0,8,15186,83.84
25501,1,0,5,1,0,0,7,13868,78.23
25502,3,0,4,2,3,6,18,18287,98.68
25503,1,0,1,1,0,0,3,1352,17.01
25504,1,0,2,1,0,0,4,4966,36.77
25505,1,1,0,1,0,0,3,1352,17.01
25506,1,1,1,1,0,0,4,4966,36.77
25507,1,1,1,1,0,0,4,4966,36.77
25508,1,0,0,1,0,0,2,32,3.72
25509,1,1,0,1,0,0,3,1352,17.01
25510,1,2,0,1,0,0,4,4966,36.77
25511,1,0,0,1,0,0,2,32,3.72
25512,1,3,1,1,3,0,9,15950,87.44
25513,1,0,0,1,0,0,2,32,3.72
25514,1,2,1,1,0,0,5,8690,54.42
25515,1,1,2,1,0,0,5,8690,54.42
25516,1,0,0,1,0,0,2,32,3.72
25517,1,0,1,1,0,0,3,1352,17.01
25518,1,1,1,1,0,0,4,4966,36.77
25519,1,0,0,1,0,0,2,32,3.72
25520,1,1,1,1,0,0,4,4966,36.77
25521,1,3,1,1,0,0,6,11521,68.36
25522,1,1,1,1,0,0,4,4966,36.77
25523,1,1,1,1,0,0,4,4966,36.77
25524,1,3,0,1,0,0,5,8690,54.42
25525,1,0,5,1,3,0,10,16522,90.12
25526,1,0,0,1,0,0,2,32,3.72
25527,1,2,0,1,0,0,4,4966,36.77
25528,1,0,0,0,0,0,1,1,0.08
25529,1,3,3,1,0,0,8,15186,83.84
25530,1,2,0,1,0,0,4,4966,36.77
25531,1,1,0,1,0,0,3,1352,17.01
25532,1,1,2,1,0,0,5,8690,54.42
25533,1,1,1,1,0,0,4,4966,36.77
25534,1,0,1,1,0,0,3,1352,17.01
25535,1,1,1,1,0,0,4,4966,36.77
25536,1,1,2,1,0,0,5,8690,54.42
25537,1,2,0,1,4,0,8,15186,83.84
25538,1,2,0,1,0,0,4,4966,36.77
25539,1,4,2,1,0,0,8,15186,83.84
25541,1,0,5,2,0,0,8,15186,83.84
25542,1,0,5,1,4,0,11,16947,91.91
25543,3,0,5,2,3,0,13,17456,94.66
25544,1,0,2,1,0,0,4,4966,36.77
25545,1,0,1,1,0,0,3,1352,17.01
25546,1,1,0,1,1,0,4,4966,36.77
25547,1,0,1,1,0,0,3,1352,17.01
25548,1,2,0,1,0,0,4,4966,36.77
25549,1,5,0,1,0,0,7,13868,78.23
25550,1,2,1,1,0,0,5,8690,54.42
25551,1,2,4,1,0,0,8,15186,83.84
25552,1,0,1,1,0,0,3,1352,17.01
25553,1,4,0,1,0,0,6,11521,68.36
25554,4,0,5,2,5,6,22,18498,99.73
25555,3,0,5,2,5,0,15,17888,96.85
25556,3,0,5,2,3,0,13,17456,94.66
25557,1,1,2,1,0,0,5,8690,54.42
25558,1,0,0,1,0,0,2,32,3.72
25559,1,1,1,1,0,0,4,4966,36.77
25560,1,2,1,1,0,0,5,8690,54.42
25561,1,0,1,1,1,10,14,17699,95.82
25562,1,0,4,1,1,0,7,13868,78.23
25563,1,1,1,1,0,0,4,4966,36.77
25564,1,2,1,1,0,0,5,8690,54.42
25565,1,4,1,1,0,0,7,13868,78.23
25566,1,2,0,1,0,0,4,4966,36.77
25567,1,2,0,1,0,0,4,4966,36.77
25568,1,0,0,1,0,0,2,32,3.72
25569,1,0,1,1,0,0,3,1352,17.01
25570,1,1,0,1,0,0,3,1352,17.01
25571,1,3,1,1,0,0,6,11521,68.36
25572,1,1,0,1,0,0,3,1352,17.01
25573,1,4,0,1,0,0,6,11521,68.36
25574,1,1,1,1,0,0,4,4966,36.77
25575,1,0,1,1,0,0,3,1352,17.01
25576,1,3,0,1,0,0,5,8690,54.42
25577,1,1,1,1,0,0,4,4966,36.77
25578,1,1,0,1,0,0,3,1352,17.01
25579,1,0,0,1,0,0,2,32,3.72
25580,1,0,0,1,0,0,2,32,3.72
25581,1,3,1,1,0,0,6,11521,68.36
25582,1,5,2,1,0,0,9,15950,87.44
25583,1,0,1,1,0,0,3,1352,17.01
25584,1,1,0,1,0,0,3,1352,17.01
25585,1,0,2,1,0,0,4,4966,36.77
25586,1,1,2,1,0,0,5,8690,54.42
25587,1,4,1,1,0,0,7,13868,78.23
25588,1,1,1,1,0,0,4,4966,36.77
25589,1,0,4,2,3,0,10,16522,90.12
25590,1,3,1,1,0,0,6,11521,68.36
25591,1,3,1,1,0,0,6,11521,68.36
25592,1,3,1,1,0,0,6,11521,68.36
25593,1,3,0,1,0,0,5,8690,54.42
25595,3,0,4,2,2,6,17,18193,98.23
25596,1,1,0,1,0,0,3,1352,17.01
25598,1,0,1,1,0,0,3,1352,17.01
25599,3,0,5,2,3,0,13,17456,94.66
25600,1,0,1,1,0,0,3,1352,17.01
25601,1,0,2,1,0,4,8,15186,83.84
25602,1,4,2,3,0,0,10,16522,90.12
25603,3,0,5,2,3,0,13,17456,94.66
25604,3,1,5,2,3,0,14,17699,95.82
25605,1,3,1,1,0,0,6,11521,68.36
25606,1,4,2,2,0,0,9,15950,87.44
25607,1,2,0,1,0,0,4,4966,36.77
25608,1,2,0,1,0,0,4,4966,36.77
25609,1,4,0,1,0,0,6,11521,68.36
25610,1,4,0,1,0,0,6,11521,68.36
25611,1,2,2,1,0,0,6,11521,68.36
25612,1,0,1,1,0,0,3,1352,17.01
25613,1,0,1,1,0,0,3,1352,17.01
25614,1,0,2,1,0,0,4,4966,36.77
25615,1,1,2,1,0,0,5,8690,54.42
25616,1,0,2,1,0,6,10,16522,90.12
25617,1,4,0,1,0,0,6,11521,68.36
25618,1,0,2,1,0,0,4,4966,36.77
25619,1,0,3,1,1,0,6,11521,68.36
25620,1,0,3,1,1,0,6,11521,68.36
25621,1,0,1,1,0,0,3,1352,17.01
25622,1,1,1,1,0,0,4,4966,36.77
25623,1,4,0,1,0,0,6,11521,68.36
25624,1,2,1,1,0,0,5,8690,54.42
25625,1,0,2,1,0,0,4,4966,36.77
25626,1,0,2,1,0,0,4,4966,36.77
25627,1,2,0,1,0,0,4,4966,36.77
25628,1,2,0,1,0,0,4,4966,36.77
25629,1,0,2,1,3,0,7,13868,78.23
25630,1,0,1,1,0,0,3,1352,17.01
25631,1,4,2,1,0,0,8,15186,83.84
25632,1,1,0,1,0,0,3,1352,17.01
25633,1,2,0,1,0,0,4,4966,36.77
25634,1,2,0,1,0,0,4,4966,36.77
25635,3,0,5,2,5,0,15,17888,96.85
25636,1,0,1,1,0,0,3,1352,17.01
25637,1,4,0,1,0,0,6,11521,68.36
25638,1,0,0,1,0,0,2,32,3.72
25639,1,0,1,1,0,6,9,15950,87.44
25640,1,0,1,1,0,2,5,8690,54.42
25641,1,4,0,1,0,0,6,11521,68.36
25642,1,5,2,2,0,0,10,16522,90.12
25643,1,1,2,1,0,0,5,8690,54.42
25644,1,2,0,1,0,0,4,4966,36.77
25645,1,0,1,1,0,0,3,1352,17.01
25646,1,0,2,1,0,0,4,4966,36.77
25647,1,0,1,1,0,0,3,1352,17.01
25648,1,0,1,1,0,0,3,1352,17.01
25649,1,0,5,2,0,0,8,15186,83.84
25650,1,0,5,2,0,0,8,15186,83.84
25651,1,4,1,1,0,0,7,13868,78.23
25652,1,4,0,1,0,0,6,11521,68.36
25653,1,0,0,1,0,0,2,32,3.72
25654,1,1,0,1,0,0,3,1352,17.01
25655,1,4,1,1,0,0,7,13868,78.23
25656,1,1,0,1,0,0,3,1352,17.01
25657,1,1,4,1,1,8,16,18081,97.67
25658,1,0,1,1,0,6,9,15950,87.44
25659,1,0,1,1,0,0,3,1352,17.01
25660,3,2,5,2,3,0,15,17888,96.85
25661,1,3,3,1,0,0,8,15186,83.84
25662,3,0,5,2,2,0,12,17186,93.28
25663,3,0,4,2,2,0,11,16947,91.91
25664,3,1,5,1,3,0,13,17456,94.66
25665,1,2,1,1,0,0,5,8690,54.42
25666,1,4,0,1,0,0,6,11521,68.36
25667,1,5,1,1,0,0,8,15186,83.84
25668,1,0,1,1,0,0,3,1352,17.01
25669,1,1,0,1,0,0,3,1352,17.01
25670,1,3,0,1,0,0,5,8690,54.42
25671,1,0,0,0,0,0,1,1,0.08
25672,1,2,0,1,0,0,4,4966,36.77
25673,1,2,0,1,0,0,4,4966,36.77
25674,1,0,1,1,0,0,3,1352,17.01
25675,1,3,1,1,1,0,7,13868,78.23
25676,1,0,1,1,0,0,3,1352,17.01
25677,1,1,1,1,0,0,4,4966,36.77
25678,1,1,0,1,0,0,3,1352,17.01
25679,1,4,0,1,0,0,6,11521,68.36
25680,1,0,1,1,0,0,3,1352,17.01
25681,1,1,1,1,0,0,4,4966,36.77
25682,1,1,3,1,0,0,6,11521,68.36
25683,1,2,0,1,0,0,4,4966,36.77
25684,1,0,0,1,0,0,2,32,3.72
25685,1,4,0,1,0,0,6,11521,68.36
25686,1,2,1,1,0,0,5,8690,54.42
25687,1,0,0,0,0,0,1,1,0.08
25688,1,2,0,1,0,0,4,4966,36.77
25689,1,1,1,1,0,0,4,4966,36.77
25690,1,4,0,0,0,0,5,8690,54.42
25691,1,0,3,1,0,0,5,8690,54.42
25692,3,0,5,2,5,0,15,17888,96.85
25693,1,0,0,1,0,0,2,32,3.72
25694,1,1,2,1,0,2,7,13868,78.23
25695,1,2,1,0,0,0,4,4966,36.77
25696,1,1,0,1,0,0,3,1352,17.01
25697,1,0,1,1,1,6,10,16522,90.12
25698,1,2,2,1,0,0,6,11521,68.36
25699,1,0,0,1,0,0,2,32,3.72
25700,1,0,1,1,0,0,3,1352,17.01
25701,1,3,1,1,0,0,6,11521,68.36
25702,1,0,2,1,0,0,4,4966,36.77
25703,1,2,0,1,0,0,4,4966,36.77
25704,1,1,2,1,0,0,5,8690,54.42
25705,1,2,2,1,0,0,6,11521,68.36
25706,1,2,0,1,0,0,4,4966,36.77
25707,1,0,1,1,0,0,3,1352,17.01
25708,1,1,2,1,0,0,5,8690,54.42
25709,1,2,0,1,0,0,4,4966,36.77
25710,1,0,2,1,0,2,6,11521,68.36
25711,1,1,0,1,0,0,3,1352,17.01
25712,1,0,2,1,0,0,4,4966,36.77
25713,1,2,0,1,0,0,4,4966,36.77
25714,1,4,0,1,4,0,10,16522,90.12
25715,1,1,0,1,0,0,3,1352,17.01
25716,1,2,0,1,0,0,4,4966,36.77
25717,1,0,4,2,0,0,7,13868,78.23
25718,1,4,0,1,4,0,10,16522,90.12
25720,1,1,5,2,0,0,9,15950,87.44
25721,3,0,5,1,2,0,11,16947,91.91
25722,1,1,2,1,0,0,5,8690,54.42
25723,1,0,1,1,0,6,9,15950,87.44
25724,1,1,1,1,0,0,4,4966,36.77
25725,1,2,1,1,0,0,5,8690,54.42
25726,1,1,1,1,0,0,4,4966,36.77
25727,1,3,0,1,0,0,5,8690,54.42
25728,1,0,4,1,0,0,6,11521,68.36
25729,1,1,1,1,0,0,4,4966,36.77
25730,1,3,1,1,0,0,6,11521,68.36
25731,1,1,1,1,0,0,4,4966,36.77
25732,1,0,1,1,0,0,3,1352,17.01
25733,1,2,1,1,0,0,5,8690,54.42
25734,1,1,1,1,0,0,4,4966,36.77
25735,1,4,1,1,0,0,7,13868,78.23
25736,1,0,0,1,0,0,2,32,3.72
25737,1,1,0,1,0,0,3,1352,17.01
25738,1,0,1,1,0,0,3,1352,17.01
25739,1,4,3,2,0,0,10,16522,90.12
25740,1,2,0,1,0,0,4,4966,36.77
25741,1,1,0,1,0,10,13,17456,94.66
25742,1,0,3,1,1,0,6,11521,68.36
25743,1,1,0,1,0,0,3,1352,17.01
25744,1,3,0,1,0,0,5,8690,54.42
25745,1,2,1,1,0,0,5,8690,54.42
25746,3,3,5,4,3,0,18,18287,98.68
25747,1,1,0,1,0,0,3,1352,17.01
25748,1,0,0,1,0,0,2,32,3.72
25749,1,2,2,1,0,0,6,11521,68.36
25750,1,1,0,1,0,0,3,1352,17.01
25751,1,1,1,1,0,0,4,4966,36.77
25752,1,3,1,1,0,0,6,11521,68.36
25753,1,4,0,1,0,0,6,11521,68.36
25754,1,4,0,1,0,0,6,11521,68.36
25755,1,0,0,1,0,0,2,32,3.72
25756,1,0,0,1,0,0,2,32,3.72
25757,1,3,1,1,0,4,10,16522,90.12
25758,1,1,2,1,0,0,5,8690,54.42
25759,1,1,2,1,0,0,5,8690,54.42
25760,1,0,1,1,1,0,4,4966,36.77
25761,1,1,0,1,0,0,3,1352,17.01
25762,1,0,0,1,0,0,2,32,3.72
25763,1,3,0,1,0,0,5,8690,54.42
25764,1,1,1,1,0,0,4,4966,36.77
25765,1,0,4,1,1,0,7,13868,78.23
25766,1,4,2,1,0,0,8,15186,83.84
25767,1,2,1,1,0,0,5,8690,54.42
25768,1,0,2,1,0,0,4,4966,36.77
25769,1,0,5,1,1,0,8,15186,83.84
25770,1,4,0,1,1,0,7,13868,78.23
25771,1,5,0,1,0,0,7,13868,78.23
25772,1,1,1,1,0,0,4,4966,36.77
25773,1,1,1,1,1,0,5,8690,54.42
25774,1,1,1,1,0,4,8,15186,83.84
25775,3,1,5,1,3,0,13,17456,94.66
25776,1,3,0,1,0,0,5,8690,54.42
25777,1,4,1,1,0,0,7,13868,78.23
25778,1,0,1,1,0,0,3,1352,17.01
25779,1,0,3,1,1,0,6,11521,68.36
25780,1,2,0,1,0,0,4,4966,36.77
25781,1,1,0,1,0,0,3,1352,17.01
25782,1,1,2,2,0,0,6,11521,68.36
25783,1,0,3,1,1,10,16,18081,97.67
25784,1,4,0,1,0,0,6,11521,68.36
25785,1,4,0,1,0,0,6,11521,68.36
25786,3,0,5,2,3,0,13,17456,94.66
25787,1,0,3,1,0,0,5,8690,54.42
25788,1,2,0,1,0,0,4,4966,36.77
25789,1,2,1,1,0,0,5,8690,54.42
25790,1,1,0,1,0,0,3,1352,17.01
25791,1,2,1,1,0,0,5,8690,54.42
25792,1,1,1,1,0,0,4,4966,36.77
25793,1,4,0,1,0,0,6,11521,68.36
25794,1,2,0,1,0,0,4,4966,36.77
25795,1,2,1,1,0,0,5,8690,54.42
25796,1,4,0,1,0,0,6,11521,68.36
25797,1,0,1,1,0,0,3,1352,17.01
25798,1,0,1,1,0,10,13,17456,94.66
25799,1,0,3,1,1,0,6,11521,68.36
25800,1,0,3,2,1,0,7,13868,78.23
25801,1,0,3,2,1,0,7,13868,78.23
25802,1,1,1,1,0,0,4,4966,36.77
25803,1,0,1,1,0,0,3,1352,17.01
25804,1,4,3,2,0,0,10,16522,90.12
25805,1,0,2,1,0,0,4,4966,36.77
25806,1,0,2,1,0,0,4,4966,36.77
25807,1,1,1,1,0,0,4,4966,36.77
25808,1,4,1,1,0,0,7,13868,78.23
25809,1,0,2,1,0,0,4,4966,36.77
25810,1,0,0,1,0,0,2,32,3.72
25811,1,1,1,1,0,0,4,4966,36.77
25812,1,1,0,1,0,0,3,1352,17.01
25813,1,0,1,1,0,0,3,1352,17.01
25814,1,0,1,1,0,0,3,1352,17.01
25815,1,0,1,1,0,0,3,1352,17.01
25816,1,1,5,2,0,0,9,15950,87.44
25817,3,0,5,2,2,0,12,17186,93.28
25818,3,0,5,1,2,0,11,16947,91.91
25819,1,1,0,1,0,0,3,1352,17.01
25820,1,1,0,1,0,0,3,1352,17.01
25821,1,0,1,1,0,6,9,15950,87.44
25822,1,1,2,1,0,0,5,8690,54.42
25823,1,0,0,1,0,0,2,32,3.72
25824,1,1,0,1,0,0,3,1352,17.01
25825,1,2,1,1,0,0,5,8690,54.42
25826,1,0,0,1,0,0,2,32,3.72
25827,1,0,2,1,0,0,4,4966,36.77
25828,1,1,1,1,0,0,4,4966,36.77
25829,1,0,1,1,0,0,3,1352,17.01
25830,1,0,4,2,3,0,10,16522,90.12
25831,1,0,1,1,0,2,5,8690,54.42
25832,1,0,1,1,0,0,3,1352,17.01
25833,1,3,0,1,0,0,5,8690,54.42
25834,1,1,2,1,0,4,9,15950,87.44
25835,1,3,0,1,0,0,5,8690,54.42
25836,1,0,0,1,0,0,2,32,3.72
25837,1,2,1,1,0,0,5,8690,54.42
25838,1,0,2,1,0,0,4,4966,36.77
25839,1,1,1,1,0,6,10,16522,90.12
25840,1,0,1,1,0,0,3,1352,17.01
25841,1,3,0,1,0,0,5,8690,54.42
25842,1,3,1,1,0,0,6,11521,68.36
25843,1,4,0,1,0,0,6,11521,68.36
25844,1,0,3,1,0,0,5,8690,54.42
25845,1,0,2,1,0,0,4,4966,36.77
25846,1,0,2,1,0,6,10,16522,90.12
25847,1,0,2,1,0,6,10,16522,90.12
25848,1,1,2,1,0,0,5,8690,54.42
25849,1,1,2,1,0,0,5,8690,54.42
25850,1,0,1,1,0,0,3,1352,17.01
25851,1,2,0,1,0,0,4,4966,36.77
25852,1,0,2,1,0,0,4,4966,36.77
25853,1,2,0,1,0,0,4,4966,36.77
25854,1,1,2,1,0,0,5,8690,54.42
25855,1,4,0,1,0,0,6,11521,68.36
25856,1,0,1,1,0,0,3,1352,17.01
25857,1,1,1,1,0,0,4,4966,36.77
25858,1,0,1,1,0,0,3,1352,17.01
25859,1,0,3,1,1,0,6,11521,68.36
25860,1,2,1,1,0,0,5,8690,54.42
25861,1,3,2,1,1,0,8,15186,83.84
25862,1,3,1,1,0,0,6,11521,68.36
25863,1,1,0,1,0,0,3,1352,17.01
25864,1,4,0,1,0,0,6,11521,68.36
25865,1,1,1,1,0,0,4,4966,36.77
25866,1,1,0,1,0,0,3,1352,17.01
25867,1,2,1,1,0,0,5,8690,54.42
25868,1,2,2,1,0,0,6,11521,68.36
25869,1,3,0,1,0,0,5,8690,54.42
25870,1,4,4,2,0,0,11,16947,91.91
25871,1,0,2,2,0,0,5,8690,54.42
25872,1,1,0,1,0,0,3,1352,17.01
25873,1,1,1,1,0,4,8,15186,83.84
25874,1,4,1,1,0,0,7,13868,78.23
25875,1,4,0,1,0,0,6,11521,68.36
25876,1,4,1,1,0,0,7,13868,78.23
25877,1,2,1,1,0,0,5,8690,54.42
25878,1,0,1,1,0,0,3,1352,17.01
25879,1,2,0,1,0,0,4,4966,36.77
25880,1,0,2,1,1,0,5,8690,54.42
25881,1,1,0,1,0,0,3,1352,17.01
25882,1,0,3,2,0,0,6,11521,68.36
25883,1,0,1,1,0,0,3,1352,17.01
25884,1,0,3,1,1,0,6,11521,68.36
25885,1,5,0,1,0,0,7,13868,78.23
25886,1,0,1,1,0,0,3,1352,17.01
25887,1,1,1,1,0,0,4,4966,36.77
25888,1,1,2,1,0,0,5,8690,54.42
25889,1,4,0,0,0,0,5,8690,54.42
25890,1,4,2,1,0,0,8,15186,83.84
25891,1,0,1,1,0,0,3,1352,17.01
25892,1,0,1,1,0,0,3,1352,17.01
25893,1,0,1,1,0,0,3,1352,17.01
25894,1,1,3,1,0,0,6,11521,68.36
25895,1,0,4,2,1,0,8,15186,83.84
25896,1,2,1,1,0,0,5,8690,54.42
25897,1,0,0,1,0,0,2,32,3.72
25898,4,0,5,2,5,0,16,18081,97.67
25899,3,1,5,2,2,0,13,17456,94.66
25900,3,0,5,2,5,4,19,18362,99.04
25901,1,0,0,1,0,0,2,32,3.72
25902,1,2,1,1,0,0,5,8690,54.42
25903,1,0,1,1,0,0,3,1352,17.01
25904,1,3,1,1,0,0,6,11521,68.36
25905,1,0,1,1,0,0,3,1352,17.01
25906,1,4,0,1,0,0,6,11521,68.36
25907,1,3,0,1,0,0,5,8690,54.42
25908,1,2,1,1,0,0,5,8690,54.42
25909,1,2,1,1,0,0,5,8690,54.42
25910,1,0,2,1,0,0,4,4966,36.77
25911,1,2,0,1,0,0,4,4966,36.77
25912,1,3,2,1,0,0,7,13868,78.23
25913,1,0,0,1,0,0,2,32,3.72
25914,1,0,1,1,0,6,9,15950,87.44
25915,1,1,1,1,0,0,4,4966,36.77
25916,1,0,1,1,0,0,3,1352,17.01
25917,1,1,0,1,0,0,3,1352,17.01
25918,1,2,0,1,0,0,4,4966,36.77
25919,1,3,1,1,2,0,8,15186,83.84
25920,1,0,2,1,0,0,4,4966,36.77
25921,1,0,1,1,0,0,3,1352,17.01
25922,1,0,1,1,0,0,3,1352,17.01
25923,1,0,1,1,0,0,3,1352,17.01
25924,1,1,1,1,0,0,4,4966,36.77
25925,1,1,0,1,0,0,3,1352,17.01
25926,1,0,0,1,0,0,2,32,3.72
25927,1,0,0,1,0,0,2,32,3.72
25928,1,4,0,1,0,0,6,11521,68.36
25929,1,0,0,1,0,0,2,32,3.72
25930,1,3,0,1,0,0,5,8690,54.42
25931,1,2,0,1,0,0,4,4966,36.77
25932,1,2,3,1,0,0,7,13868,78.23
25933,1,2,3,1,0,0,7,13868,78.23
25934,1,4,0,1,0,0,6,11521,68.36
25935,1,2,0,1,0,0,4,4966,36.77
25936,1,1,0,1,0,0,3,1352,17.01
25937,1,0,3,2,1,0,7,13868,78.23
25938,1,1,1,1,0,0,4,4966,36.77
25939,1,0,2,1,0,0,4,4966,36.77
25940,1,1,0,1,0,0,3,1352,17.01
25941,1,2,0,1,0,0,4,4966,36.77
25942,1,0,1,1,0,0,3,1352,17.01
25943,1,4,0,1,2,0,8,15186,83.84
25944,1,0,2,1,0,0,4,4966,36.77
25945,1,0,1,1,0,6,9,15950,87.44
25946,1,0,2,1,0,0,4,4966,36.77
25947,1,1,0,1,0,0,3,1352,17.01
25948,1,0,0,1,0,0,2,32,3.72
25949,1,0,0,1,0,0,2,32,3.72
25950,1,4,1,1,0,0,7,13868,78.23
25951,1,1,1,1,0,0,4,4966,36.77
25952,1,2,0,1,0,0,4,4966,36.77
25953,1,2,0,1,0,0,4,4966,36.77
25954,1,0,0,1,0,0,2,32,3.72
25955,1,0,2,1,0,0,4,4966,36.77
25956,1,0,2,1,0,6,10,16522,90.12
25957,1,3,0,1,0,0,5,8690,54.42
25958,3,0,5,2,2,0,12,17186,93.28
25959,1,0,0,1,0,0,2,32,3.72
25960,3,0,5,2,5,0,15,17888,96.85
25961,1,0,0,1,0,0,2,32,3.72
25962,1,0,0,1,0,0,2,32,3.72
25963,1,0,1,1,0,0,3,1352,17.01
25964,1,1,1,1,0,0,4,4966,36.77
25965,1,0,0,1,0,0,2,32,3.72
25966,1,1,0,1,0,0,3,1352,17.01
25967,1,0,1,1,0,0,3,1352,17.01
25968,1,4,0,1,0,0,6,11521,68.36
25969,1,0,0,0,0,0,1,1,0.08
25970,1,2,1,1,0,0,5,8690,54.42
25971,1,0,1,1,0,0,3,1352,17.01
25972,1,1,0,1,0,0,3,1352,17.01
25973,1,1,0,1,0,0,3,1352,17.01
25975,1,1,0,1,0,4,7,13868,78.23
25976,1,0,0,1,0,6,8,15186,83.84
25977,1,1,1,1,0,0,4,4966,36.77
25978,1,1,0,1,0,0,3,1352,17.01
25979,3,0,5,2,5,10,25,18550,99.91
25980,1,0,3,2,3,2,11,16947,91.91
25981,3,0,5,2,3,0,13,17456,94.66
25982,1,3,1,1,0,0,6,11521,68.36
25983,1,1,1,1,0,0,4,4966,36.77
25984,1,4,0,1,0,0,6,11521,68.36
25985,1,2,0,1,0,0,4,4966,36.77
25986,1,1,1,1,0,0,4,4966,36.77
25987,1,0,1,1,0,0,3,1352,17.01
25988,1,2,1,1,0,0,5,8690,54.42
25989,1,1,1,1,0,0,4,4966,36.77
25990,1,1,1,1,0,0,4,4966,36.77
25991,1,0,1,1,0,0,3,1352,17.01
25992,1,0,1,1,0,0,3,1352,17.01
25993,1,1,0,1,0,0,3,1352,17.01
25994,1,4,1,1,0,0,7,13868,78.23
25995,3,1,5,1,3,6,19,18362,99.04
25996,1,4,0,1,0,0,6,11521,68.36
25997,1,5,0,1,0,0,7,13868,78.23
25998,1,1,1,1,0,0,4,4966,36.77
25999,1,1,1,1,0,0,4,4966,36.77
26000,1,1,1,1,0,0,4,4966,36.77
26001,1,2,2,1,2,0,8,15186,83.84
26002,1,0,3,1,0,0,5,8690,54.42
26003,1,0,0,1,0,0,2,32,3.72
26004,1,4,2,1,0,0,8,15186,83.84
26005,1,4,0,1,0,0,6,11521,68.36
26006,1,1,0,1,0,0,3,1352,17.01
26007,1,0,1,1,0,0,3,1352,17.01
26008,1,1,0,1,0,0,3,1352,17.01
26009,1,1,0,1,0,0,3,1352,17.01
26010,1,0,0,1,0,0,2,32,3.72
26011,1,0,0,1,0,0,2,32,3.72
26012,1,0,1,1,0,0,3,1352,17.01
26013,1,0,1,1,0,0,3,1352,17.01
26014,1,2,0,1,0,0,4,4966,36.77
26015,1,0,2,1,0,0,4,4966,36.77
26016,1,2,2,1,0,0,6,11521,68.36
26017,1,4,0,1,0,0,6,11521,68.36
26018,1,2,0,1,0,0,4,4966,36.77
26019,1,0,1,1,0,0,3,1352,17.01
26020,1,1,1,1,0,0,4,4966,36.77
26021,1,0,3,2,1,0,7,13868,78.23
26022,1,0,3,1,0,0,5,8690,54.42
26023,3,1,4,2,2,0,12,17186,93.28
26024,3,1,5,2,3,0,14,17699,95.82
26025,3,0,5,2,2,0,12,17186,93.28
26026,1,1,1,1,0,0,4,4966,36.77
26027,1,4,1,1,0,0,7,13868,78.23
26028,1,0,0,0,1,10,12,17186,93.28
26029,1,3,0,1,0,0,5,8690,54.42
26030,1,0,3,2,1,0,7,13868,78.23
26031,1,0,0,1,0,0,2,32,3.72
26032,1,0,0,0,0,0,1,1,0.08
26033,1,2,1,1,0,0,5,8690,54.42
26034,1,0,1,1,0,0,3,1352,17.01
26035,1,1,0,1,0,0,3,1352,17.01
26036,1,0,1,1,3,0,6,11521,68.36
26037,1,4,1,1,0,0,7,13868,78.23
26038,1,1,0,1,0,0,3,1352,17.01
26039,1,0,0,1,0,0,2,32,3.72
26040,1,2,0,1,0,0,4,4966,36.77
26041,1,0,1,1,0,6,9,15950,87.44
26042,1,0,1,1,0,6,9,15950,87.44
26043,1,0,1,1,0,0,3,1352,17.01
26044,1,3,0,1,0,0,5,8690,54.42
26045,1,0,0,1,0,0,2,32,3.72
26046,1,0,0,1,0,0,2,32,3.72
26047,1,0,0,1,0,0,2,32,3.72
26048,1,1,1,1,0,2,6,11521,68.36
26049,1,2,0,1,0,0,4,4966,36.77
26050,1,0,4,2,2,0,9,15950,87.44
26051,1,4,1,1,0,0,7,13868,78.23
26052,1,0,1,1,0,0,3,1352,17.01
26053,1,2,0,1,0,0,4,4966,36.77
26054,1,1,1,1,0,0,4,4966,36.77
26055,1,0,4,1,0,0,6,11521,68.36
26056,1,0,2,1,1,0,5,8690,54.42
26057,1,0,1,1,0,0,3,1352,17.01
26058,1,1,0,1,0,0,3,1352,17.01
26059,1,0,2,1,0,2,6,11521,68.36
26060,1,1,1,1,0,0,4,4966,36.77
26061,1,4,0,1,0,0,6,11521,68.36
26062,1,1,0,1,0,0,3,1352,17.01
26063,1,0,1,1,0,0,3,1352,17.01
26064,1,3,0,1,0,0,5,8690,54.42
26065,1,0,0,1,0,0,2,32,3.72
26066,1,1,0,1,0,0,3,1352,17.01
26067,1,0,1,1,0,0,3,1352,17.01
26068,1,1,1,1,0,0,4,4966,36.77
26069,1,1,1,1,0,0,4,4966,36.77
26070,1,2,1,1,0,0,5,8690,54.42
26071,1,0,1,1,0,2,5,8690,54.42
26072,1,1,1,1,0,0,4,4966,36.77
26073,1,1,0,1,0,0,3,1352,17.01
26074,1,1,1,1,0,0,4,4966,36.77
26075,1,3,1,1,0,0,6,11521,68.36
26076,1,0,0,1,0,0,2,32,3.72
26077,1,0,0,1,0,0,2,32,3.72
26078,1,3,1,1,0,0,6,11521,68.36
26079,1,0,1,1,0,0,3,1352,17.01
26080,4,0,4,2,3,0,13,17456,94.66
26081,3,0,4,2,1,0,10,16522,90.12
26082,1,0,0,1,0,0,2,32,3.72
26083,1,1,1,1,0,0,4,4966,36.77
26084,1,3,1,1,0,0,6,11521,68.36
26085,3,1,4,2,3,0,13,17456,94.66
26086,1,3,1,1,0,0,6,11521,68.36
26087,1,0,1,1,0,2,5,8690,54.42
26088,1,1,0,1,0,0,3,1352,17.01
26089,1,2,1,1,0,0,5,8690,54.42
26090,1,2,1,1,0,0,5,8690,54.42
26091,1,1,1,1,0,0,4,4966,36.77
26092,1,0,2,1,0,0,4,4966,36.77
26093,1,4,0,1,0,0,6,11521,68.36
26094,1,4,0,1,0,0,6,11521,68.36
26095,1,2,1,1,0,0,5,8690,54.42
26096,1,0,1,1,0,0,3,1352,17.01
26098,1,0,1,1,0,0,3,1352,17.01
26099,1,3,0,1,0,0,5,8690,54.42
26100,1,0,0,1,0,0,2,32,3.72
26101,1,1,1,1,0,0,4,4966,36.77
26102,1,1,3,1,0,0,6,11521,68.36
26103,1,0,1,1,0,0,3,1352,17.01
26104,1,0,0,1,0,0,2,32,3.72
26105,1,4,4,1,0,0,10,16522,90.12
26106,1,3,1,1,0,0,6,11521,68.36
26107,1,0,1,1,0,0,3,1352,17.01
26108,1,1,0,1,0,0,3,1352,17.01
26109,1,1,0,1,0,0,3,1352,17.01
26110,1,2,0,1,0,0,4,4966,36.77
26111,1,0,2,1,1,0,5,8690,54.42
26112,1,1,1,1,0,0,4,4966,36.77
26113,1,0,0,1,0,0,2,32,3.72
26114,1,4,1,1,0,0,7,13868,78.23
26115,1,1,0,1,0,0,3,1352,17.01
26116,1,1,2,1,0,0,5,8690,54.42
26117,1,0,5,1,1,0,8,15186,83.84
26118,1,3,0,1,0,0,5,8690,54.42
26119,1,1,0,1,0,0,3,1352,17.01
26120,1,0,2,1,0,0,4,4966,36.77
26121,1,4,0,1,0,0,6,11521,68.36
26122,1,3,2,1,0,0,7,13868,78.23
26123,3,0,5,2,3,0,13,17456,94.66
26124,1,0,5,2,1,0,9,15950,87.44
26125,1,0,5,2,0,0,8,15186,83.84
26126,1,1,1,1,0,0,4,4966,36.77
26127,1,0,4,2,2,0,9,15950,87.44
26128,1,0,3,1,0,0,5,8690,54.42
26129,1,0,2,1,0,0,4,4966,36.77
26130,1,0,0,1,0,0,2,32,3.72
26131,1,3,0,1,0,0,5,8690,54.42
26132,1,5,0,1,0,0,7,13868,78.23
26133,1,0,1,1,0,0,3,1352,17.01
26134,1,1,1,1,0,0,4,4966,36.77
26135,1,0,1,1,0,0,3,1352,17.01
26136,1,2,0,1,0,0,4,4966,36.77
26137,1,1,1,1,0,0,4,4966,36.77
26138,1,3,1,1,0,0,6,11521,68.36
26139,1,2,1,1,0,0,5,8690,54.42
26140,1,0,2,1,0,0,4,4966,36.77
26141,1,3,0,1,0,0,5,8690,54.42
26142,1,2,1,1,0,0,5,8690,54.42
26143,1,4,0,1,0,0,6,11521,68.36
26144,1,0,1,1,0,0,3,1352,17.01
26145,1,2,0,1,0,0,4,4966,36.77
26146,1,0,1,1,0,4,7,13868,78.23
26147,1,1,0,1,0,0,3,1352,17.01
26148,1,1,0,1,0,0,3,1352,17.01
26149,1,1,1,1,0,0,4,4966,36.77
26150,1,1,0,1,0,0,3,1352,17.01
26151,1,5,0,1,0,0,7,13868,78.23
26152,1,0,1,1,0,0,3,1352,17.01
26153,1,0,1,1,0,0,3,1352,17.01
26154,1,2,1,1,0,0,5,8690,54.42
26155,1,0,1,1,0,0,3,1352,17.01
26156,1,0,2,1,0,4,8,15186,83.84
26157,1,0,3,1,1,0,6,11521,68.36
26158,1,0,4,1,2,10,18,18287,98.68
26159,1,1,0,1,0,0,3,1352,17.01
26160,1,3,0,1,0,0,5,8690,54.42
26161,1,1,0,1,0,0,3,1352,17.01
26162,1,0,2,1,0,0,4,4966,36.77
26163,1,3,0,1,0,0,5,8690,54.42
26164,1,0,1,1,0,0,3,1352,17.01
26165,1,1,0,0,0,0,2,32,3.72
26166,1,2,1,1,0,0,5,8690,54.42
26167,1,3,1,1,0,0,6,11521,68.36
26168,1,1,2,1,0,0,5,8690,54.42
26169,1,0,4,1,0,0,6,11521,68.36
26170,1,0,1,1,0,2,5,8690,54.42
26171,1,3,0,1,0,0,5,8690,54.42
26172,1,1,0,1,0,0,3,1352,17.01
26173,1,1,4,1,0,0,7,13868,78.23
26174,1,0,0,1,0,0,2,32,3.72
26175,1,1,0,1,0,0,3,1352,17.01
26176,1,0,0,1,0,0,2,32,3.72
26177,1,0,1,1,4,0,7,13868,78.23
26178,1,5,5,2,0,0,13,17456,94.66
26179,1,0,1,1,0,0,3,1352,17.01
26180,1,4,0,1,0,0,6,11521,68.36
26181,1,2,1,1,0,0,5,8690,54.42
26182,1,1,0,1,0,0,3,1352,17.01
26183,1,0,1,1,0,0,3,1352,17.01
26184,1,2,1,1,0,0,5,8690,54.42
26185,1,0,1,1,0,0,3,1352,17.01
26186,1,1,0,1,0,0,3,1352,17.01
26187,1,3,0,1,0,0,5,8690,54.42
26188,1,1,0,1,0,0,3,1352,17.01
26189,1,1,2,1,0,0,5,8690,54.42
26190,1,4,2,1,0,0,8,15186,83.84
26191,1,2,2,1,0,0,6,11521,68.36
26193,1,4,0,1,0,0,6,11521,68.36
26194,1,4,0,1,0,0,6,11521,68.36
26195,1,4,1,1,0,0,7,13868,78.23
26196,1,2,1,1,0,0,5,8690,54.42
26197,1,4,0,1,0,0,6,11521,68.36
26198,1,0,2,1,0,0,4,4966,36.77
26199,1,2,1,1,0,0,5,8690,54.42
26200,1,4,0,1,0,0,6,11521,68.36
26201,1,1,1,1,0,0,4,4966,36.77
26202,1,0,1,1,0,0,3,1352,17.01
26203,1,0,0,1,0,0,2,32,3.72
26204,1,0,0,1,0,0,2,32,3.72
26205,1,0,0,1,0,0,2,32,3.72
26207,1,1,2,2,0,0,6,11521,68.36
26208,1,0,4,2,0,0,7,13868,78.23
26209,1,4,2,1,0,0,8,15186,83.84
26210,1,1,0,1,0,0,3,1352,17.01
26211,1,4,0,1,0,0,6,11521,68.36
26212,1,4,0,1,0,0,6,11521,68.36
26213,1,2,0,1,0,0,4,4966,36.77
26214,1,0,0,1,0,0,2,32,3.72
26215,1,0,1,1,0,0,3,1352,17.01
26216,1,0,2,1,0,2,6,11521,68.36
26217,1,1,1,1,0,0,4,4966,36.77
26218,1,3,0,1,0,0,5,8690,54.42
26219,3,2,4,5,3,0,17,18193,98.23
26220,3,5,1,4,3,0,16,18081,97.67
26221,3,1,5,4,4,0,17,18193,98.23
26222,1,0,5,1,0,0,7,13868,78.23
26223,3,1,4,2,3,0,13,17456,94.66
26224,3,0,5,2,3,0,13,17456,94.66
26225,1,0,3,2,3,0,9,15950,87.44
26226,1,0,1,1,0,0,3,1352,17.01
26227,1,2,1,1,0,0,5,8690,54.42
26228,1,4,0,1,0,0,6,11521,68.36
26229,1,0,1,1,0,0,3,1352,17.01
26230,1,1,1,1,0,0,4,4966,36.77
26231,1,0,1,1,0,0,3,1352,17.01
26232,1,0,1,1,0,0,3,1352,17.01
26233,3,1,5,2,3,0,14,17699,95.82
26234,3,0,5,2,3,0,13,17456,94.66
26235,1,4,1,1,0,0,7,13868,78.23
26236,1,2,0,1,0,0,4,4966,36.77
26237,1,0,1,1,0,0,3,1352,17.01
26238,1,1,0,1,0,0,3,1352,17.01
26239,1,0,2,1,0,0,4,4966,36.77
26240,1,3,0,1,0,0,5,8690,54.42
26241,1,0,3,1,0,0,5,8690,54.42
26242,1,0,0,1,0,0,2,32,3.72
26243,1,0,1,1,0,0,3,1352,17.01
26244,1,1,0,1,0,0,3,1352,17.01
26245,1,1,1,1,0,0,4,4966,36.77
26246,1,1,1,1,0,0,4,4966,36.77
26247,3,0,5,2,1,0,11,16947,91.91
26248,3,0,5,2,3,6,19,18362,99.04
26249,1,0,3,1,1,10,16,18081,97.67
26250,1,1,1,1,0,0,4,4966,36.77
26251,1,0,0,1,0,0,2,32,3.72
26252,1,0,1,1,0,0,3,1352,17.01
26253,1,0,1,1,0,6,9,15950,87.44
26254,1,0,1,1,0,0,3,1352,17.01
26255,1,0,1,1,0,8,11,16947,91.91
26256,1,1,1,1,0,0,4,4966,36.77
26257,1,2,0,1,0,0,4,4966,36.77
26258,1,0,1,1,0,0,3,1352,17.01
26259,1,2,1,1,0,0,5,8690,54.42
26260,1,3,2,1,0,0,7,13868,78.23
26261,1,2,1,1,0,0,5,8690,54.42
26262,1,1,2,1,0,0,5,8690,54.42
26263,1,0,1,1,0,6,9,15950,87.44
26264,1,1,0,1,0,0,3,1352,17.01
26265,1,4,0,1,0,0,6,11521,68.36
26266,1,0,1,1,0,0,3,1352,17.01
26267,3,4,5,3,3,0,18,18287,98.68
26268,3,0,5,2,2,0,12,17186,93.28
26269,1,4,0,1,0,0,6,11521,68.36
26270,1,1,0,1,0,0,3,1352,17.01
26271,1,1,1,1,0,0,4,4966,36.77
26272,1,0,1,1,0,0,3,1352,17.01
26273,1,0,2,1,0,0,4,4966,36.77
26274,1,4,4,1,0,0,10,16522,90.12
26275,1,1,1,1,0,0,4,4966,36.77
26276,1,3,0,1,0,0,5,8690,54.42
26277,1,0,2,1,0,0,4,4966,36.77
26278,1,0,1,1,0,0,3,1352,17.01
26279,3,0,4,2,5,0,14,17699,95.82
26280,3,0,5,1,5,0,14,17699,95.82
26281,1,4,4,4,4,0,17,18193,98.23
26282,3,0,4,1,4,0,12,17186,93.28
26283,3,0,4,5,0,0,12,17186,93.28
26284,1,0,1,1,0,0,3,1352,17.01
26285,1,0,1,1,0,4,7,13868,78.23
26286,1,0,1,1,0,0,3,1352,17.01
26287,1,1,2,1,0,0,5,8690,54.42
26288,1,2,0,1,0,0,4,4966,36.77
26289,1,2,1,1,0,0,5,8690,54.42
26290,1,1,2,1,0,0,5,8690,54.42
26291,1,0,0,1,0,0,2,32,3.72
26292,1,0,2,1,1,0,5,8690,54.42
26293,1,4,0,1,0,0,6,11521,68.36
26294,1,3,0,2,0,0,6,11521,68.36
26295,1,3,0,1,0,0,5,8690,54.42
26296,1,2,1,1,0,0,5,8690,54.42
26297,1,1,0,1,0,0,3,1352,17.01
26298,1,4,4,2,2,0,13,17456,94.66
26299,1,1,0,1,0,4,7,13868,78.23
26300,1,4,0,1,0,0,6,11521,68.36
26301,1,3,0,1,0,0,5,8690,54.42
26302,1,0,1,1,2,0,5,8690,54.42
26303,1,0,1,1,0,0,3,1352,17.01
26304,3,0,5,1,3,4,16,18081,97.67
26305,1,2,1,1,0,0,5,8690,54.42
26306,1,0,3,1,1,6,12,17186,93.28
26307,1,5,0,1,0,0,7,13868,78.23
26308,1,0,1,1,0,0,3,1352,17.01
26309,1,0,1,1,3,6,12,17186,93.28
26310,1,2,0,1,0,0,4,4966,36.77
26311,1,4,0,1,0,0,6,11521,68.36
26312,1,2,1,1,2,0,7,13868,78.23
26313,1,2,1,1,0,0,5,8690,54.42
26314,1,0,2,1,0,0,4,4966,36.77
26315,1,0,1,1,0,0,3,1352,17.01
26316,1,0,1,1,0,0,3,1352,17.01
26317,1,1,2,1,0,0,5,8690,54.42
26318,1,0,3,1,0,0,5,8690,54.42
26319,1,0,0,1,0,0,2,32,3.72
26320,1,2,0,1,0,0,4,4966,36.77
26321,1,0,2,1,0,0,4,4966,36.77
26322,1,0,1,1,0,0,3,1352,17.01
26323,1,1,1,1,0,0,4,4966,36.77
26324,1,0,0,1,0,6,8,15186,83.84
26325,1,0,1,1,1,0,4,4966,36.77
26326,1,1,0,1,0,0,3,1352,17.01
26327,1,0,1,1,0,0,3,1352,17.01
26328,1,0,0,1,0,0,2,32,3.72
26329,1,0,1,1,0,0,3,1352,17.01
26330,1,0,2,1,0,0,4,4966,36.77
26331,1,2,1,1,0,0,5,8690,54.42
26332,1,1,1,1,0,0,4,4966,36.77
26333,1,0,0,1,0,0,2,32,3.72
26334,1,2,1,1,0,0,5,8690,54.42
26335,1,2,0,1,0,0,4,4966,36.77
26336,1,3,0,1,0,0,5,8690,54.42
26337,1,0,2,1,0,0,4,4966,36.77
26338,1,4,1,1,0,0,7,13868,78.23
26339,1,0,2,1,0,0,4,4966,36.77
26340,1,2,0,1,0,0,4,4966,36.77
26341,1,0,1,1,0,0,3,1352,17.01
26342,1,0,0,1,0,0,2,32,3.72
26343,1,0,1,1,0,0,3,1352,17.01
26344,1,0,0,1,0,0,2,32,3.72
26345,1,0,0,1,0,0,2,32,3.72
26346,1,0,0,1,0,0,2,32,3.72
26347,1,3,1,1,0,0,6,11521,68.36
26348,1,2,1,1,0,0,5,8690,54.42
26349,1,1,2,1,0,0,5,8690,54.42
26350,1,0,1,1,0,0,3,1352,17.01
26351,1,2,0,1,0,0,4,4966,36.77
26352,1,4,1,1,0,0,7,13868,78.23
26353,4,2,5,2,4,0,17,18193,98.23
26354,1,0,1,0,0,0,2,32,3.72
26355,1,1,2,1,1,0,6,11521,68.36
26356,3,0,5,2,2,0,12,17186,93.28
26357,3,0,5,1,2,0,11,16947,91.91
26358,1,4,0,1,0,0,6,11521,68.36
26359,1,0,3,1,1,6,12,17186,93.28
26360,1,0,2,0,0,0,3,1352,17.01
26361,1,1,0,1,0,0,3,1352,17.01
26362,1,0,0,1,0,0,2,32,3.72
26363,1,1,0,1,0,0,3,1352,17.01
26364,1,0,1,1,0,0,3,1352,17.01
26365,1,2,0,1,0,0,4,4966,36.77
26366,1,2,1,1,0,0,5,8690,54.42
26367,1,3,3,3,2,0,12,17186,93.28
26368,3,0,5,2,2,0,12,17186,93.28
26369,3,1,5,2,3,0,14,17699,95.82
26370,1,0,1,1,0,0,3,1352,17.01
26371,1,1,0,1,0,0,3,1352,17.01
26372,1,0,1,1,0,0,3,1352,17.01
26373,1,1,0,1,0,0,3,1352,17.01
26374,1,3,1,1,0,0,6,11521,68.36
26375,1,2,3,1,0,0,7,13868,78.23
26376,1,1,1,1,0,0,4,4966,36.77
26377,1,0,1,1,0,0,3,1352,17.01
26378,1,0,1,1,0,0,3,1352,17.01
26379,1,0,0,1,0,0,2,32,3.72
26380,1,1,0,1,0,0,3,1352,17.01
26381,1,3,0,1,0,0,5,8690,54.42
26382,1,2,1,1,0,0,5,8690,54.42
26383,1,1,2,1,0,0,5,8690,54.42
26384,1,2,3,1,0,0,7,13868,78.23
26385,1,1,4,1,0,0,7,13868,78.23
26386,1,2,0,1,0,0,4,4966,36.77
26387,1,0,1,1,0,0,3,1352,17.01
26388,1,0,1,1,0,0,3,1352,17.01
26389,1,0,1,1,0,0,3,1352,17.01
26390,1,0,1,1,0,0,3,1352,17.01
26391,1,2,1,1,0,0,5,8690,54.42
26392,1,0,1,1,0,0,3,1352,17.01
26393,1,1,1,1,0,0,4,4966,36.77
26394,1,2,0,1,0,0,4,4966,36.77
26395,4,0,5,2,5,0,16,18081,97.67
26396,3,0,5,1,3,0,12,17186,93.28
26397,2,0,5,1,0,0,8,15186,83.84
26398,1,1,1,1,0,0,4,4966,36.77
26399,3,1,5,2,3,0,14,17699,95.82
26400,3,1,5,2,3,0,14,17699,95.82
26401,1,0,2,1,0,6,10,16522,90.12
26402,1,0,2,1,0,0,4,4966,36.77
26403,1,0,2,1,0,6,10,16522,90.12
26404,1,0,0,1,0,0,2,32,3.72
26405,1,2,1,1,0,0,5,8690,54.42
26406,1,0,0,1,0,0,2,32,3.72
26407,1,1,1,1,0,0,4,4966,36.77
26408,1,5,0,1,0,0,7,13868,78.23
26409,1,0,1,1,0,0,3,1352,17.01
26410,3,1,3,1,2,0,10,16522,90.12
26411,1,2,0,1,0,0,4,4966,36.77
26412,1,1,1,1,0,0,4,4966,36.77
26413,1,0,2,1,0,0,4,4966,36.77
26414,1,2,1,1,0,0,5,8690,54.42
26415,1,0,3,2,2,6,14,17699,95.82
26416,1,1,0,1,0,0,3,1352,17.01
26417,1,1,0,1,0,0,3,1352,17.01
26418,1,1,1,1,0,0,4,4966,36.77
26419,1,0,2,1,0,0,4,4966,36.77
26420,1,3,0,1,0,0,5,8690,54.42
26421,1,0,1,1,0,0,3,1352,17.01
26422,1,0,1,1,0,4,7,13868,78.23
26423,1,1,1,1,0,0,4,4966,36.77
26424,1,0,2,1,0,0,4,4966,36.77
26425,1,0,2,1,0,0,4,4966,36.77
26426,1,0,1,1,0,0,3,1352,17.01
26427,1,3,1,1,0,0,6,11521,68.36
26428,1,0,2,1,0,2,6,11521,68.36
26429,1,0,0,1,0,0,2,32,3.72
26430,1,0,1,1,0,0,3,1352,17.01
26431,1,1,1,1,0,0,4,4966,36.77
26432,1,1,2,1,0,0,5,8690,54.42
26433,1,0,1,1,0,0,3,1352,17.01
26434,1,0,2,1,0,0,4,4966,36.77
26435,3,0,5,2,3,6,19,18362,99.04
26436,1,0,2,1,0,0,4,4966,36.77
26437,1,0,2,1,0,0,4,4966,36.77
26438,1,0,3,1,0,0,5,8690,54.42
26439,1,3,1,1,1,0,7,13868,78.23
26440,3,0,5,2,1,0,11,16947,91.91
26441,3,0,5,2,3,0,13,17456,94.66
26442,1,1,0,1,0,0,3,1352,17.01
26443,1,2,1,1,0,0,5,8690,54.42
26444,1,4,0,1,0,0,6,11521,68.36
26445,1,1,3,1,0,0,6,11521,68.36
26446,1,1,1,1,0,0,4,4966,36.77
26447,1,4,0,1,0,0,6,11521,68.36
26448,1,3,1,1,0,0,6,11521,68.36
26449,3,0,5,2,4,0,14,17699,95.82
26450,4,0,4,2,3,0,13,17456,94.66
26451,1,0,3,1,0,0,5,8690,54.42
26452,4,0,5,2,5,0,16,18081,97.67
26453,1,0,1,1,0,0,3,1352,17.01
26454,1,2,1,1,0,0,5,8690,54.42
26455,1,4,1,1,0,0,7,13868,78.23
26456,1,2,1,1,0,0,5,8690,54.42
26457,1,2,1,1,0,0,5,8690,54.42
26458,1,2,0,1,0,0,4,4966,36.77
26459,1,0,3,2,0,0,6,11521,68.36
26460,1,1,0,1,0,0,3,1352,17.01
26461,1,0,3,2,1,0,7,13868,78.23
26462,1,3,0,1,0,0,5,8690,54.42
26463,1,0,0,1,0,0,2,32,3.72
26464,1,1,0,0,0,0,2,32,3.72
26465,1,1,2,1,0,0,5,8690,54.42
26466,1,3,0,1,0,0,5,8690,54.42
26467,1,0,0,1,0,0,2,32,3.72
26468,1,0,3,1,0,2,7,13868,78.23
26469,1,0,1,1,0,0,3,1352,17.01
26470,1,0,1,1,0,0,3,1352,17.01
26471,1,3,0,1,0,0,5,8690,54.42
26472,1,3,0,1,0,0,5,8690,54.42
26473,1,2,2,1,0,0,6,11521,68.36
26474,1,2,2,1,0,0,6,11521,68.36
26475,1,1,1,1,0,0,4,4966,36.77
26476,1,2,1,1,0,0,5,8690,54.42
26477,1,0,1,1,0,0,3,1352,17.01
26478,1,0,1,1,0,2,5,8690,54.42
26479,1,3,4,1,0,0,9,15950,87.44
26480,1,3,1,1,0,0,6,11521,68.36
26481,1,2,1,1,0,0,5,8690,54.42
26482,1,1,1,1,0,0,4,4966,36.77
26483,1,3,0,1,0,0,5,8690,54.42
26484,1,0,1,1,0,0,3,1352,17.01
26485,1,4,1,1,0,0,7,13868,78.23
26486,1,0,0,1,0,0,2,32,3.72
26487,1,0,1,1,0,0,3,1352,17.01
26488,1,2,1,1,0,0,5,8690,54.42
26489,1,1,0,1,0,0,3,1352,17.01
26490,1,0,2,1,1,2,7,13868,78.23
26491,1,2,0,1,0,0,4,4966,36.77
26492,1,1,2,1,0,0,5,8690,54.42
26493,1,0,2,1,1,0,5,8690,54.42
26494,1,4,0,1,0,0,6,11521,68.36
26495,1,5,0,1,0,0,7,13868,78.23
26496,1,1,1,1,0,6,10,16522,90.12
26497,1,0,0,1,0,0,2,32,3.72
26498,1,2,0,1,0,0,4,4966,36.77
26499,1,1,4,1,0,0,7,13868,78.23
26500,1,0,0,1,0,0,2,32,3.72
26501,1,0,3,1,2,0,7,13868,78.23
26502,1,1,1,1,0,0,4,4966,36.77
26503,1,1,0,0,0,0,2,32,3.72
26504,1,0,1,1,0,0,3,1352,17.01
26505,1,1,1,1,0,0,4,4966,36.77
26506,1,1,2,1,0,0,5,8690,54.42
26507,1,3,1,1,0,0,6,11521,68.36
26508,1,4,1,1,0,0,7,13868,78.23
26509,1,0,1,1,0,0,3,1352,17.01
26510,1,0,1,1,0,0,3,1352,17.01
26511,1,1,1,1,0,0,4,4966,36.77
26512,1,4,0,1,0,0,6,11521,68.36
26513,1,0,0,1,0,0,2,32,3.72
26514,1,2,0,1,0,0,4,4966,36.77
26515,1,0,2,1,0,0,4,4966,36.77
26516,1,2,0,1,0,0,4,4966,36.77
26517,1,4,0,1,0,0,6,11521,68.36
26518,1,2,0,1,0,0,4,4966,36.77
26519,1,2,0,1,0,0,4,4966,36.77
26520,1,1,1,1,0,0,4,4966,36.77
26521,1,2,1,1,0,0,5,8690,54.42
26522,1,0,4,1,1,0,7,13868,78.23
26523,1,3,1,1,0,0,6,11521,68.36
26524,1,0,0,1,0,0,2,32,3.72
26525,1,1,1,1,0,0,4,4966,36.77
26526,1,1,1,1,0,4,8,15186,83.84
26527,1,0,0,1,1,0,3,1352,17.01
26528,1,1,1,1,0,4,8,15186,83.84
26529,1,0,1,1,0,0,3,1352,17.01
26530,1,0,1,1,0,0,3,1352,17.01
26531,1,3,1,2,0,0,7,13868,78.23
26532,1,2,0,1,0,0,4,4966,36.77
26533,1,0,1,1,0,8,11,16947,91.91
26534,1,0,2,1,0,6,10,16522,90.12
26535,1,0,1,1,0,0,3,1352,17.01
26536,1,3,0,1,0,0,5,8690,54.42
26537,1,1,1,1,0,6,10,16522,90.12
26538,1,1,0,1,0,0,3,1352,17.01
26539,1,1,1,1,0,0,4,4966,36.77
26540,1,0,0,1,0,0,2,32,3.72
26541,1,1,2,1,0,0,5,8690,54.42
26542,1,4,1,1,0,0,7,13868,78.23
26543,1,1,1,1,0,0,4,4966,36.77
26544,1,0,1,1,0,0,3,1352,17.01
26545,1,0,0,1,0,0,2,32,3.72
26546,1,1,1,1,0,0,4,4966,36.77
26547,1,0,1,1,0,6,9,15950,87.44
26548,1,0,0,1,0,0,2,32,3.72
26549,1,4,1,1,0,0,7,13868,78.23
26550,3,0,5,1,3,0,12,17186,93.28
26551,1,0,0,1,0,0,2,32,3.72
26552,1,0,1,1,0,0,3,1352,17.01
26553,1,0,0,1,0,0,2,32,3.72
26554,1,3,0,1,0,0,5,8690,54.42
26555,1,2,0,1,0,0,4,4966,36.77
26556,1,4,0,1,0,0,6,11521,68.36
26557,1,1,0,1,0,0,3,1352,17.01
26558,1,4,0,1,0,0,6,11521,68.36
26559,1,3,1,1,0,0,6,11521,68.36
26560,1,0,0,1,0,0,2,32,3.72
26561,1,4,1,1,0,0,7,13868,78.23
26562,1,4,1,1,0,0,7,13868,78.23
26563,1,0,0,1,0,0,2,32,3.72
26564,3,1,5,2,3,4,18,18287,98.68
26565,1,5,2,1,0,0,9,15950,87.44
26566,1,1,2,1,0,0,5,8690,54.42
26567,3,0,5,2,4,0,14,17699,95.82
26568,1,2,0,1,0,0,4,4966,36.77
26569,1,0,3,1,0,6,11,16947,91.91
26570,1,1,1,1,0,10,14,17699,95.82
26571,1,4,1,1,0,0,7,13868,78.23
26573,1,1,0,1,0,0,3,1352,17.01
26574,1,1,1,1,0,0,4,4966,36.77
26575,1,1,1,1,0,0,4,4966,36.77
26576,1,0,2,1,0,0,4,4966,36.77
26577,1,0,2,1,0,0,4,4966,36.77
26578,1,0,1,1,0,0,3,1352,17.01
26579,1,2,0,1,0,0,4,4966,36.77
26580,1,0,3,1,0,0,5,8690,54.42
26581,1,0,0,1,0,0,2,32,3.72
26582,1,1,2,1,0,0,5,8690,54.42
26583,1,0,2,1,0,8,12,17186,93.28
26584,1,0,2,1,0,0,4,4966,36.77
26585,1,1,3,1,0,0,6,11521,68.36
26586,1,1,1,1,0,0,4,4966,36.77
26587,1,3,1,1,0,0,6,11521,68.36
26588,1,0,1,1,0,0,3,1352,17.01
26589,1,2,0,1,0,0,4,4966,36.77
26590,1,1,1,1,0,0,4,4966,36.77
26591,1,0,2,1,0,0,4,4966,36.77
26592,1,2,1,1,0,0,5,8690,54.42
26593,1,0,0,1,0,0,2,32,3.72
26594,1,0,3,1,1,0,6,11521,68.36
26595,1,0,2,1,0,0,4,4966,36.77
26596,1,0,1,1,0,0,3,1352,17.01
26597,1,1,0,1,0,0,3,1352,17.01
26598,1,0,1,1,0,0,3,1352,17.01
26599,1,0,0,1,0,0,2,32,3.72
26600,1,2,2,1,0,0,6,11521,68.36
26601,1,2,2,1,0,0,6,11521,68.36
26602,1,5,3,1,0,0,10,16522,90.12
26603,1,0,0,1,0,0,2,32,3.72
26604,1,0,0,1,0,0,2,32,3.72
26605,1,0,5,1,2,0,9,15950,87.44
26606,1,1,2,1,0,0,5,8690,54.42
26607,1,1,0,1,0,0,3,1352,17.01
26608,1,0,3,1,0,0,5,8690,54.42
26609,3,2,5,3,3,0,16,18081,97.67
26610,1,1,1,1,0,0,4,4966,36.77
26611,1,4,2,1,0,0,8,15186,83.84
26612,1,0,2,1,0,0,4,4966,36.77
26613,1,0,0,1,0,0,2,32,3.72
26614,1,1,2,1,2,0,7,13868,78.23
26615,1,0,5,3,0,0,9,15950,87.44
26616,1,3,0,1,0,0,5,8690,54.42
26617,1,4,0,1,0,0,6,11521,68.36
26618,1,1,0,1,0,0,3,1352,17.01
26619,1,4,0,1,0,0,6,11521,68.36
26620,1,0,1,1,0,0,3,1352,17.01
26621,1,4,0,1,0,0,6,11521,68.36
26622,1,1,1,1,0,0,4,4966,36.77
26623,1,0,3,1,0,0,5,8690,54.42
26624,1,4,2,1,0,0,8,15186,83.84
26625,1,0,2,1,0,0,4,4966,36.77
26626,4,0,5,2,5,0,16,18081,97.67
26627,1,1,0,1,0,0,3,1352,17.01
26628,1,1,0,1,0,0,3,1352,17.01
26629,1,0,1,1,0,0,3,1352,17.01
26630,1,0,1,1,0,0,3,1352,17.01
26631,1,0,1,1,0,0,3,1352,17.01
26632,1,4,0,1,0,0,6,11521,68.36
26633,1,1,1,1,0,0,4,4966,36.77
26634,1,0,0,1,0,0,2,32,3.72
26635,1,1,1,1,0,4,8,15186,83.84
26636,1,0,1,1,0,6,9,15950,87.44
26637,1,1,2,1,0,0,5,8690,54.42
26638,1,0,3,1,0,0,5,8690,54.42
26639,1,1,3,3,2,0,10,16522,90.12
26640,3,0,5,2,2,0,12,17186,93.28
26641,1,1,1,1,0,0,4,4966,36.77
26642,1,0,1,1,0,0,3,1352,17.01
26643,1,0,1,1,0,0,3,1352,17.01
26644,1,0,1,1,0,0,3,1352,17.01
26645,1,0,1,1,0,0,3,1352,17.01
26646,1,0,1,1,0,0,3,1352,17.01
26647,1,0,2,1,0,0,4,4966,36.77
26648,1,2,0,1,0,0,4,4966,36.77
26649,1,1,2,1,0,0,5,8690,54.42
26650,1,1,0,1,0,0,3,1352,17.01
26651,1,4,0,1,0,0,6,11521,68.36
26652,1,0,2,1,0,0,4,4966,36.77
26653,1,1,0,1,0,0,3,1352,17.01
26654,1,0,0,1,0,0,2,32,3.72
26655,1,0,1,1,0,0,3,1352,17.01
26656,1,1,2,1,0,0,5,8690,54.42
26657,1,3,1,1,0,0,6,11521,68.36
26658,1,3,1,1,0,0,6,11521,68.36
26659,1,0,1,1,0,0,3,1352,17.01
26660,1,1,0,1,0,0,3,1352,17.01
26661,1,2,2,1,0,0,6,11521,68.36
26662,1,4,0,1,0,0,6,11521,68.36
26663,1,3,1,1,0,0,6,11521,68.36
26664,1,1,1,1,0,0,4,4966,36.77
26665,1,1,1,1,0,0,4,4966,36.77
26666,3,0,5,2,1,0,11,16947,91.91
26667,3,0,5,3,3,0,14,17699,95.82
26668,1,0,2,2,1,0,6,11521,68.36
26669,3,0,5,1,2,0,11,16947,91.91
26670,1,1,1,1,0,0,4,4966,36.77
26671,1,4,0,1,0,0,6,11521,68.36
26672,1,1,2,1,0,0,5,8690,54.42
26673,1,0,0,1,0,0,2,32,3.72
26674,1,4,0,1,0,0,6,11521,68.36
26675,1,0,0,1,0,0,2,32,3.72
26676,1,0,1,1,0,0,3,1352,17.01
26677,1,5,1,1,0,0,8,15186,83.84
26678,1,1,1,1,0,0,4,4966,36.77
26679,1,5,0,1,0,0,7,13868,78.23
26680,1,1,1,1,0,0,4,4966,36.77
26681,1,0,0,1,0,0,2,32,3.72
26682,1,4,1,1,0,0,7,13868,78.23
26683,1,2,2,1,0,0,6,11521,68.36
26684,1,0,5,1,0,0,7,13868,78.23
26685,1,2,2,1,0,0,6,11521,68.36
26686,1,2,1,1,0,0,5,8690,54.42
26687,1,1,2,1,0,0,5,8690,54.42
26688,1,0,1,1,0,0,3,1352,17.01
26689,1,5,2,1,0,0,9,15950,87.44
26690,1,1,2,1,0,0,5,8690,54.42
26691,1,0,1,1,0,0,3,1352,17.01
26692,1,3,1,1,0,0,6,11521,68.36
26693,1,1,3,2,0,0,7,13868,78.23
26694,1,1,0,1,0,0,3,1352,17.01
26695,3,0,5,2,2,6,18,18287,98.68
26696,3,0,5,2,3,0,13,17456,94.66
26697,1,0,0,1,0,0,2,32,3.72
26698,1,3,0,1,0,0,5,8690,54.42
26699,1,0,0,0,0,2,3,1352,17.01
26700,1,1,1,1,0,0,4,4966,36.77
26701,1,4,1,1,0,0,7,13868,78.23
26702,1,0,1,1,0,0,3,1352,17.01
26703,1,1,0,1,0,0,3,1352,17.01
26704,1,0,2,1,0,6,10,16522,90.12
26705,1,1,0,0,0,0,2,32,3.72
26706,1,0,1,1,0,0,3,1352,17.01
26707,1,0,1,1,0,0,3,1352,17.01
26708,1,0,0,1,0,0,2,32,3.72
26709,1,1,1,1,0,0,4,4966,36.77
26710,1,2,1,2,0,0,6,11521,68.36
26711,1,1,0,2,0,0,4,4966,36.77
26712,1,1,1,1,0,0,4,4966,36.77
26713,1,0,1,0,0,10,12,17186,93.28
26714,1,2,1,1,0,0,5,8690,54.42
26715,1,0,2,1,0,0,4,4966,36.77
26716,1,1,1,1,0,0,4,4966,36.77
26717,1,2,1,1,0,0,5,8690,54.42
26718,1,2,2,1,0,0,6,11521,68.36
26719,1,2,0,1,0,0,4,4966,36.77
26720,1,0,1,1,0,0,3,1352,17.01
26721,1,5,0,1,0,0,7,13868,78.23
26722,1,0,2,1,0,0,4,4966,36.77
26723,1,0,1,1,0,0,3,1352,17.01
26724,1,1,0,1,0,0,3,1352,17.01
26725,1,0,0,1,0,0,2,32,3.72
26726,1,1,1,1,0,0,4,4966,36.77
26727,1,0,1,1,0,0,3,1352,17.01
26728,1,4,2,1,1,0,9,15950,87.44
26729,3,1,5,2,4,0,15,17888,96.85
26730,1,0,1,1,0,0,3,1352,17.01
26731,1,0,2,1,0,0,4,4966,36.77
26732,1,0,0,1,1,4,7,13868,78.23
26733,1,0,2,1,0,0,4,4966,36.77
26734,1,0,0,1,0,0,2,32,3.72
26735,1,0,1,1,0,0,3,1352,17.01
26736,1,1,2,1,0,0,5,8690,54.42
26737,1,1,2,1,0,6,11,16947,91.91
26738,1,5,0,1,0,0,7,13868,78.23
26739,1,0,1,1,0,0,3,1352,17.01
26740,1,1,0,0,0,0,2,32,3.72
26741,1,0,1,1,0,0,3,1352,17.01
26742,1,0,2,1,0,0,4,4966,36.77
26743,1,0,1,1,0,0,3,1352,17.01
26744,4,0,5,2,5,4,20,18419,99.31
26745,1,1,0,1,0,0,3,1352,17.01
26746,1,4,1,1,0,0,7,13868,78.23
26747,2,0,4,2,2,0,10,16522,90.12
26748,1,0,1,1,0,0,3,1352,17.01
26749,1,0,2,1,0,0,4,4966,36.77
26750,1,0,0,1,0,0,2,32,3.72
26751,1,4,0,0,0,0,5,8690,54.42
26752,1,2,0,1,0,0,4,4966,36.77
26753,1,0,3,1,0,0,5,8690,54.42
26754,1,0,1,1,0,0,3,1352,17.01
26755,3,0,5,1,3,4,16,18081,97.67
26756,1,2,2,1,0,0,6,11521,68.36
26757,1,0,1,1,0,0,3,1352,17.01
26758,1,0,0,1,0,0,2,32,3.72
26759,1,2,2,1,0,0,6,11521,68.36
26760,1,2,1,1,0,0,5,8690,54.42
26761,1,3,1,1,0,0,6,11521,68.36
26762,1,2,0,1,0,0,4,4966,36.77
26763,1,1,0,1,0,0,3,1352,17.01
26764,1,4,0,1,0,0,6,11521,68.36
26765,1,1,1,1,0,0,4,4966,36.77
26766,1,1,1,1,0,0,4,4966,36.77
26767,1,1,1,1,0,0,4,4966,36.77
26768,1,0,1,1,0,4,7,13868,78.23
26769,1,1,2,1,0,0,5,8690,54.42
26770,1,4,1,1,0,0,7,13868,78.23
26771,1,1,1,1,0,0,4,4966,36.77
26772,1,4,0,1,0,0,6,11521,68.36
26773,1,3,0,1,0,0,5,8690,54.42
26774,1,0,3,1,1,6,12,17186,93.28
26775,1,1,1,1,0,0,4,4966,36.77
26776,1,1,1,1,0,0,4,4966,36.77
26777,1,1,1,1,0,0,4,4966,36.77
26778,1,2,1,1,0,0,5,8690,54.42
26779,1,2,1,1,0,0,5,8690,54.42
26780,1,2,1,1,0,0,5,8690,54.42
26781,1,4,0,1,0,0,6,11521,68.36
26782,1,3,1,1,0,0,6,11521,68.36
26783,1,1,0,1,0,0,3,1352,17.01
26784,3,0,5,2,0,0,10,16522,90.12
26785,1,0,1,1,0,2,5,8690,54.42
26786,3,1,5,2,3,6,20,18419,99.31
26787,4,3,5,2,3,0,17,18193,98.23
26788,3,0,5,2,1,0,11,16947,91.91
26789,1,1,2,1,0,0,5,8690,54.42
26790,1,2,0,1,0,0,4,4966,36.77
26791,1,3,1,1,0,0,6,11521,68.36
26792,1,2,1,1,0,0,5,8690,54.42
26793,1,0,1,1,0,0,3,1352,17.01
26794,1,1,1,1,0,0,4,4966,36.77
26795,1,3,1,1,0,0,6,11521,68.36
26796,1,3,0,1,0,0,5,8690,54.42
26797,1,0,1,1,0,0,3,1352,17.01
26798,1,0,0,1,0,0,2,32,3.72
26799,1,0,2,1,0,0,4,4966,36.77
26800,1,0,2,1,1,0,5,8690,54.42
26801,1,0,0,1,0,0,2,32,3.72
26802,1,0,2,1,0,0,4,4966,36.77
26803,1,3,0,0,0,0,4,4966,36.77
26804,1,0,1,1,0,0,3,1352,17.01
26805,1,1,1,1,0,0,4,4966,36.77
26806,1,1,1,1,0,0,4,4966,36.77
26807,1,4,4,1,0,0,10,16522,90.12
26808,1,3,0,1,0,0,5,8690,54.42
26809,1,1,1,1,0,0,4,4966,36.77
26810,1,0,2,1,0,0,4,4966,36.77
26811,1,3,0,1,0,0,5,8690,54.42
26812,1,1,1,1,0,0,4,4966,36.77
26813,1,0,0,1,0,0,2,32,3.72
26814,1,2,1,1,0,0,5,8690,54.42
26815,1,4,2,1,0,0,8,15186,83.84
26816,1,0,3,1,0,0,5,8690,54.42
26817,1,0,0,1,1,0,3,1352,17.01
26818,1,4,2,3,2,0,12,17186,93.28
26819,3,1,5,2,4,0,15,17888,96.85
26820,1,0,1,1,0,0,3,1352,17.01
26821,1,1,0,1,0,0,3,1352,17.01
26822,1,1,0,1,0,0,3,1352,17.01
26823,1,1,1,1,0,0,4,4966,36.77
26824,1,0,1,1,0,0,3,1352,17.01
26825,1,1,1,1,0,0,4,4966,36.77
26826,1,4,0,1,0,0,6,11521,68.36
26827,1,0,1,1,0,0,3,1352,17.01
26828,1,0,1,1,0,0,3,1352,17.01
26829,1,1,1,1,0,0,4,4966,36.77
26830,1,2,0,1,0,0,4,4966,36.77
26831,1,4,0,1,0,0,6,11521,68.36
26832,1,0,0,1,0,0,2,32,3.72
26833,1,0,0,1,0,0,2,32,3.72
26834,3,0,5,2,3,0,13,17456,94.66
26835,1,3,1,1,0,0,6,11521,68.36
26836,1,1,0,1,0,0,3,1352,17.01
26837,3,0,5,2,3,6,19,18362,99.04
26838,1,0,2,1,0,0,4,4966,36.77
26839,1,1,3,2,1,0,8,15186,83.84
26840,1,0,3,2,3,0,9,15950,87.44
26841,1,0,1,1,0,0,3,1352,17.01
26842,1,5,0,1,0,0,7,13868,78.23
26843,1,0,1,1,0,4,7,13868,78.23
26844,1,4,0,1,0,0,6,11521,68.36
26845,1,2,0,1,0,0,4,4966,36.77
26846,1,0,1,1,0,0,3,1352,17.01
26847,1,2,5,1,0,0,9,15950,87.44
26848,1,1,0,1,0,0,3,1352,17.01
26849,1,1,0,1,0,0,3,1352,17.01
26850,1,4,1,1,0,0,7,13868,78.23
26851,1,2,3,1,0,0,7,13868,78.23
26852,1,1,2,1,0,0,5,8690,54.42
26853,1,1,1,1,0,0,4,4966,36.77
26854,1,2,0,1,0,0,4,4966,36.77
26855,1,5,5,2,0,0,13,17456,94.66
26856,1,0,4,1,1,6,13,17456,94.66
26857,1,4,1,1,0,0,7,13868,78.23
26858,1,3,1,1,0,0,6,11521,68.36
26859,1,0,0,1,0,0,2,32,3.72
26860,1,0,2,1,0,0,4,4966,36.77
26861,1,3,0,1,0,0,5,8690,54.42
26862,1,0,2,1,0,0,4,4966,36.77
26863,1,0,2,1,1,0,5,8690,54.42
26864,1,0,3,1,0,0,5,8690,54.42
26865,1,0,0,1,0,0,2,32,3.72
26866,1,1,0,1,0,0,3,1352,17.01
26867,1,0,2,1,0,0,4,4966,36.77
26868,1,0,0,1,3,0,5,8690,54.42
26869,1,0,2,1,0,0,4,4966,36.77
26870,1,2,0,1,0,0,4,4966,36.77
26871,1,2,0,1,0,0,4,4966,36.77
26872,1,4,0,1,0,0,6,11521,68.36
26873,1,4,2,1,0,0,8,15186,83.84
26874,1,1,1,1,0,0,4,4966,36.77
26875,1,1,0,1,0,0,3,1352,17.01
26876,1,4,1,1,0,0,7,13868,78.23
26877,1,0,1,1,0,0,3,1352,17.01
26878,1,0,1,1,1,0,4,4966,36.77
26879,1,4,2,1,0,0,8,15186,83.84
26880,1,0,1,1,0,0,3,1352,17.01
26881,1,0,1,1,0,0,3,1352,17.01
26882,1,1,0,1,0,0,3,1352,17.01
26883,1,1,1,1,0,0,4,4966,36.77
26884,1,1,2,1,0,0,5,8690,54.42
26885,1,0,4,2,0,0,7,13868,78.23
26886,1,4,2,1,0,0,8,15186,83.84
26887,1,0,0,1,0,2,4,4966,36.77
26888,1,4,3,1,0,0,9,15950,87.44
26889,1,1,0,1,0,0,3,1352,17.01
26890,1,1,0,1,0,0,3,1352,17.01
26891,1,3,0,1,0,0,5,8690,54.42
26892,1,4,0,1,0,0,6,11521,68.36
26893,1,1,1,1,0,0,4,4966,36.77
26894,1,1,0,1,0,0,3,1352,17.01
26895,1,0,2,1,3,0,7,13868,78.23
26896,1,3,2,1,0,0,7,13868,78.23
26897,1,0,0,1,0,0,2,32,3.72
26898,1,0,1,1,0,0,3,1352,17.01
26899,1,1,1,1,0,0,4,4966,36.77
26900,1,1,1,1,0,0,4,4966,36.77
26901,1,2,0,1,0,0,4,4966,36.77
26902,1,0,1,1,0,0,3,1352,17.01
26903,1,0,0,1,0,0,2,32,3.72
26904,1,3,1,1,1,0,7,13868,78.23
26905,1,3,1,1,0,0,6,11521,68.36
26906,1,2,0,1,0,0,4,4966,36.77
26908,1,3,1,1,0,0,6,11521,68.36
26909,1,2,0,1,0,0,4,4966,36.77
26910,3,0,5,2,3,0,13,17456,94.66
26911,1,2,1,1,0,0,5,8690,54.42
26912,1,2,1,1,0,0,5,8690,54.42
26913,1,2,0,1,0,0,4,4966,36.77
26914,1,0,1,1,0,0,3,1352,17.01
26915,1,0,0,1,0,0,2,32,3.72
26916,1,4,0,1,0,0,6,11521,68.36
26917,1,1,1,1,0,0,4,4966,36.77
26918,1,2,1,1,0,0,5,8690,54.42
26919,1,0,2,1,0,0,4,4966,36.77
26920,1,1,1,1,0,0,4,4966,36.77
26921,1,1,1,1,0,0,4,4966,36.77
26922,1,4,0,1,0,0,6,11521,68.36
26923,1,4,1,1,0,0,7,13868,78.23
26924,3,1,5,2,3,0,14,17699,95.82
26925,1,2,3,1,0,0,7,13868,78.23
26926,1,4,0,1,0,0,6,11521,68.36
26927,3,0,5,2,3,0,13,17456,94.66
26928,1,1,0,1,0,0,3,1352,17.01
26929,1,1,1,1,0,0,4,4966,36.77
26930,1,3,1,1,0,0,6,11521,68.36
26931,1,0,2,1,0,0,4,4966,36.77
26932,1,2,0,1,0,0,4,4966,36.77
26933,1,4,0,1,0,0,6,11521,68.36
26934,1,0,1,1,0,6,9,15950,87.44
26935,1,0,1,1,0,0,3,1352,17.01
26936,1,1,1,1,0,0,4,4966,36.77
26937,1,0,1,1,0,0,3,1352,17.01
26938,1,2,1,1,0,0,5,8690,54.42
26939,1,0,1,1,0,0,3,1352,17.01
26940,1,0,2,1,1,0,5,8690,54.42
26941,3,3,5,2,4,0,17,18193,98.23
26942,1,2,3,1,0,0,7,13868,78.23
26943,1,1,1,1,0,0,4,4966,36.77
26944,3,1,5,2,3,0,14,17699,95.82
26945,1,2,1,1,0,0,5,8690,54.42
26946,1,1,0,1,0,0,3,1352,17.01
26947,1,0,3,2,3,0,9,15950,87.44
26948,1,1,1,1,0,0,4,4966,36.77
26949,1,4,0,1,0,0,6,11521,68.36
26950,1,1,2,1,0,0,5,8690,54.42
26951,1,0,1,1,0,4,7,13868,78.23
26952,1,1,0,1,0,0,3,1352,17.01
26953,1,1,0,1,0,4,7,13868,78.23
26954,1,0,1,1,0,0,3,1352,17.01
26955,1,0,2,1,3,0,7,13868,78.23
26956,1,1,0,1,0,0,3,1352,17.01
26957,1,2,3,1,0,0,7,13868,78.23
26958,1,1,1,1,0,0,4,4966,36.77
26959,1,0,0,1,0,0,2,32,3.72
26960,1,0,2,1,0,0,4,4966,36.77
26961,1,2,1,1,0,0,5,8690,54.42
26962,1,0,1,1,0,0,3,1352,17.01
26964,1,2,0,1,0,0,4,4966,36.77
26965,1,1,4,2,0,0,8,15186,83.84
26966,1,2,1,1,0,0,5,8690,54.42
26967,1,0,0,1,0,0,2,32,3.72
26968,1,3,1,1,0,0,6,11521,68.36
26969,1,3,0,1,0,0,5,8690,54.42
26970,1,1,1,1,0,0,4,4966,36.77
26971,1,0,2,1,0,0,4,4966,36.77
26972,1,0,2,1,0,0,4,4966,36.77
26973,1,2,2,1,1,0,7,13868,78.23
26974,1,1,0,1,0,0,3,1352,17.01
26975,1,0,1,1,0,0,3,1352,17.01
26976,1,0,1,1,0,0,3,1352,17.01
26977,1,1,1,1,0,0,4,4966,36.77
26978,1,2,0,1,0,0,4,4966,36.77
26979,1,0,0,1,0,0,2,32,3.72
26980,1,1,0,0,0,0,2,32,3.72
26981,1,1,1,1,0,0,4,4966,36.77
26982,1,1,1,1,0,0,4,4966,36.77
26983,1,1,2,1,0,0,5,8690,54.42
26984,1,4,0,1,0,0,6,11521,68.36
26985,1,0,1,1,0,0,3,1352,17.01
26986,1,0,1,1,0,0,3,1352,17.01
26987,1,3,0,1,0,0,5,8690,54.42
26988,1,1,0,1,0,0,3,1352,17.01
26989,1,1,0,1,0,0,3,1352,17.01
26990,1,0,1,1,0,0,3,1352,17.01
26991,1,0,2,1,0,0,4,4966,36.77
26992,1,4,0,1,0,0,6,11521,68.36
26993,1,0,1,1,0,4,7,13868,78.23
26994,1,0,1,1,0,0,3,1352,17.01
26995,1,0,1,1,0,6,9,15950,87.44
26996,3,0,5,2,5,0,15,17888,96.85
26997,3,0,5,2,3,0,13,17456,94.66
26998,1,3,0,1,0,0,5,8690,54.42
26999,1,0,0,1,0,0,2,32,3.72
27000,1,1,1,1,0,0,4,4966,36.77
27001,1,1,1,1,0,0,4,4966,36.77
27002,1,1,0,1,0,0,3,1352,17.01
27003,1,3,0,1,0,0,5,8690,54.42
27004,1,4,0,1,0,0,6,11521,68.36
27005,1,0,2,1,0,0,4,4966,36.77
27006,1,3,1,1,0,0,6,11521,68.36
27007,1,1,0,1,0,0,3,1352,17.01
27008,1,2,0,1,0,0,4,4966,36.77
27009,1,1,0,1,0,0,3,1352,17.01
27010,1,4,0,1,1,0,7,13868,78.23
27011,3,0,5,2,3,0,13,17456,94.66
27012,1,0,3,1,0,0,5,8690,54.42
27013,3,1,5,2,3,0,14,17699,95.82
27014,1,0,1,1,2,0,5,8690,54.42
27015,1,2,0,1,0,0,4,4966,36.77
27016,1,0,0,1,0,0,2,32,3.72
27017,1,2,0,1,0,0,4,4966,36.77
27018,1,0,1,1,0,0,3,1352,17.01
27019,1,2,1,1,0,0,5,8690,54.42
27020,1,3,0,1,0,0,5,8690,54.42
27021,1,0,0,1,0,0,2,32,3.72
27022,1,0,1,1,0,0,3,1352,17.01
27023,1,0,1,1,0,0,3,1352,17.01
27024,1,4,0,1,0,0,6,11521,68.36
27025,1,4,0,1,0,0,6,11521,68.36
27026,1,0,0,1,0,0,2,32,3.72
27027,1,5,3,1,0,0,10,16522,90.12
27028,1,1,0,1,0,0,3,1352,17.01
27029,1,0,2,1,0,0,4,4966,36.77
27030,1,0,1,1,0,0,3,1352,17.01
27032,1,2,0,1,0,0,4,4966,36.77
27033,1,2,2,1,0,0,6,11521,68.36
27034,1,1,1,1,0,0,4,4966,36.77
27035,1,3,2,1,0,0,7,13868,78.23
27036,1,0,1,1,0,0,3,1352,17.01
27037,1,0,2,1,0,0,4,4966,36.77
27038,1,0,1,1,1,2,6,11521,68.36
27039,1,1,2,1,0,0,5,8690,54.42
27040,1,0,1,1,0,0,3,1352,17.01
27041,1,1,1,1,0,0,4,4966,36.77
27042,1,0,1,1,0,0,3,1352,17.01
27043,1,0,1,1,0,0,3,1352,17.01
27044,1,0,0,1,0,0,2,32,3.72
27045,1,2,1,1,0,0,5,8690,54.42
27046,1,2,0,1,0,0,4,4966,36.77
27047,1,1,0,1,0,0,3,1352,17.01
27048,1,0,2,1,1,0,5,8690,54.42
27049,1,2,1,1,0,0,5,8690,54.42
27050,1,1,1,1,0,0,4,4966,36.77
27051,1,2,1,1,0,0,5,8690,54.42
27052,1,2,0,1,0,0,4,4966,36.77
27053,1,4,0,1,0,0,6,11521,68.36
27054,1,2,0,1,0,0,4,4966,36.77
27055,3,0,5,3,1,0,12,17186,93.28
27056,3,0,5,2,5,0,15,17888,96.85
27057,1,1,0,1,0,0,3,1352,17.01
27058,1,0,0,1,0,0,2,32,3.72
27059,1,0,3,1,1,4,10,16522,90.12
27060,1,1,2,1,1,0,6,11521,68.36
27061,1,0,1,1,0,0,3,1352,17.01
27062,1,1,1,1,0,0,4,4966,36.77
27063,1,1,1,1,0,0,4,4966,36.77
27064,1,1,0,1,0,0,3,1352,17.01
27065,1,0,1,1,0,0,3,1352,17.01
27066,1,4,0,1,0,0,6,11521,68.36
27067,1,0,5,1,1,0,8,15186,83.84
27068,1,0,3,1,0,0,5,8690,54.42
27069,1,3,0,1,0,0,5,8690,54.42
27070,1,1,3,1,0,0,6,11521,68.36
27071,1,1,0,1,0,0,3,1352,17.01
27072,1,3,0,1,0,0,5,8690,54.42
27073,1,4,0,1,0,0,6,11521,68.36
27074,1,0,1,1,0,0,3,1352,17.01
27075,1,1,0,1,1,0,4,4966,36.77
27076,1,0,1,1,0,0,3,1352,17.01
27077,3,0,4,1,3,10,21,18462,99.52
27078,1,1,1,1,0,0,4,4966,36.77
27079,1,1,1,1,0,0,4,4966,36.77
27080,1,1,1,1,0,0,4,4966,36.77
27081,1,0,2,1,0,0,4,4966,36.77
27082,1,1,1,1,0,0,4,4966,36.77
27083,1,1,1,1,0,0,4,4966,36.77
27084,1,2,0,1,0,0,4,4966,36.77
27085,1,0,1,1,0,0,3,1352,17.01
27086,1,0,1,1,0,0,3,1352,17.01
27087,1,0,3,1,2,10,17,18193,98.23
27088,1,1,2,1,0,0,5,8690,54.42
27089,1,0,3,2,0,0,6,11521,68.36
27090,1,0,1,1,0,6,9,15950,87.44
27091,3,1,5,2,2,0,13,17456,94.66
27092,1,1,0,1,0,0,3,1352,17.01
27093,1,0,1,1,0,0,3,1352,17.01
27094,1,4,1,1,0,0,7,13868,78.23
27095,1,0,1,1,0,10,13,17456,94.66
27096,1,0,1,1,0,0,3,1352,17.01
27097,1,5,0,1,0,0,7,13868,78.23
27098,1,0,2,1,0,0,4,4966,36.77
27099,1,2,0,1,0,0,4,4966,36.77
27100,1,1,1,1,0,0,4,4966,36.77
27101,1,0,1,1,0,0,3,1352,17.01
27102,1,0,1,1,0,0,3,1352,17.01
27103,1,0,0,1,0,0,2,32,3.72
27104,1,2,1,1,0,0,5,8690,54.42
27105,1,1,1,1,0,0,4,4966,36.77
27106,1,1,1,1,0,0,4,4966,36.77
27107,1,2,1,1,0,0,5,8690,54.42
27108,1,0,0,1,0,0,2,32,3.72
27109,1,2,0,1,0,0,4,4966,36.77
27110,1,0,1,1,0,0,3,1352,17.01
27111,1,0,1,1,0,0,3,1352,17.01
27112,1,0,1,1,0,0,3,1352,17.01
27113,1,1,1,1,0,0,4,4966,36.77
27114,1,0,0,1,0,0,2,32,3.72
27115,1,4,0,1,0,0,6,11521,68.36
27116,1,0,2,1,0,0,4,4966,36.77
27117,1,3,1,1,0,0,6,11521,68.36
27118,1,0,0,1,0,0,2,32,3.72
27119,1,0,1,1,0,0,3,1352,17.01
27120,1,1,1,1,0,0,4,4966,36.77
27121,1,4,0,1,0,0,6,11521,68.36
27122,1,3,1,1,0,0,6,11521,68.36
27123,1,1,0,1,0,0,3,1352,17.01
27124,1,1,1,1,0,0,4,4966,36.77
27125,1,0,2,1,0,0,4,4966,36.77
27126,1,0,1,1,0,0,3,1352,17.01
27127,1,0,2,1,1,0,5,8690,54.42
27128,1,2,2,1,0,0,6,11521,68.36
27129,1,1,1,1,0,0,4,4966,36.77
27130,1,0,3,1,1,0,6,11521,68.36
27131,1,4,0,1,0,0,6,11521,68.36
27132,1,0,1,1,0,0,3,1352,17.01
27133,1,2,0,1,0,0,4,4966,36.77
27134,1,0,1,1,0,0,3,1352,17.01
27135,1,0,0,1,0,4,6,11521,68.36
27136,1,0,4,1,0,0,6,11521,68.36
27137,1,0,1,1,0,0,3,1352,17.01
27138,1,1,0,1,0,0,3,1352,17.01
27139,1,1,2,1,0,0,5,8690,54.42
27140,1,0,1,1,0,0,3,1352,17.01
27141,1,0,0,1,0,0,2,32,3.72
27142,1,0,0,1,0,0,2,32,3.72
27143,3,1,5,2,3,0,14,17699,95.82
27144,4,1,5,2,4,0,16,18081,97.67
27145,4,0,5,2,5,0,16,18081,97.67
27146,1,0,2,1,0,0,4,4966,36.77
27147,1,5,3,1,0,0,10,16522,90.12
27148,1,0,1,1,0,0,3,1352,17.01
27149,3,0,4,2,2,0,11,16947,91.91
27150,1,2,2,1,0,0,6,11521,68.36
27151,1,0,1,1,0,0,3,1352,17.01
27152,1,1,0,1,0,0,3,1352,17.01
27153,1,4,0,1,0,0,6,11521,68.36
27154,1,0,1,1,0,0,3,1352,17.01
27155,1,1,0,1,0,0,3,1352,17.01
27156,1,1,0,1,0,0,3,1352,17.01
27157,1,1,0,1,0,0,3,1352,17.01
27158,1,3,2,1,0,0,7,13868,78.23
27159,1,1,1,1,0,0,4,4966,36.77
27160,1,0,3,1,0,0,5,8690,54.42
27161,1,4,0,1,0,0,6,11521,68.36
27162,1,0,1,1,0,0,3,1352,17.01
27163,1,4,0,1,0,0,6,11521,68.36
27164,1,0,1,1,0,6,9,15950,87.44
27165,1,2,1,1,0,0,5,8690,54.42
27166,1,1,0,1,0,0,3,1352,17.01
27167,1,1,1,1,0,0,4,4966,36.77
27168,1,0,3,2,1,0,7,13868,78.23
27169,1,2,1,1,0,0,5,8690,54.42
27170,1,2,1,1,0,0,5,8690,54.42
27171,1,0,1,1,0,0,3,1352,17.01
27172,1,1,1,1,0,6,10,16522,90.12
27173,1,0,3,1,1,0,6,11521,68.36
27174,1,1,0,1,0,0,3,1352,17.01
27175,1,2,1,1,0,0,5,8690,54.42
27176,1,0,0,1,0,0,2,32,3.72
27177,1,1,0,1,0,0,3,1352,17.01
27178,3,0,5,1,1,6,16,18081,97.67
27179,1,1,1,1,0,0,4,4966,36.77
27180,3,0,4,1,1,6,15,17888,96.85
27181,1,0,1,1,0,0,3,1352,17.01
27183,1,0,0,1,0,2,4,4966,36.77
27184,1,0,1,1,0,0,3,1352,17.01
27185,1,0,5,1,2,0,9,15950,87.44
27186,1,1,0,1,0,0,3,1352,17.01
27187,1,1,1,1,0,0,4,4966,36.77
27188,1,3,0,1,3,0,8,15186,83.84
27189,1,0,0,1,0,0,2,32,3.72
27190,1,1,1,1,0,0,4,4966,36.77
27191,1,1,0,1,0,0,3,1352,17.01
27192,3,4,4,4,4,0,19,18362,99.04
27193,3,0,4,2,3,0,12,17186,93.28
27194,3,2,5,5,0,0,15,17888,96.85
27195,1,1,2,1,0,0,5,8690,54.42
27196,3,0,5,1,1,6,16,18081,97.67
27197,3,0,4,2,2,2,13,17456,94.66
27198,1,0,1,1,0,0,3,1352,17.01
27199,1,0,1,1,0,0,3,1352,17.01
27200,1,1,1,1,0,0,4,4966,36.77
27201,1,0,4,1,1,0,7,13868,78.23
27202,1,0,2,1,0,6,10,16522,90.12
27203,1,1,3,2,0,0,7,13868,78.23
27204,1,0,0,1,0,0,2,32,3.72
27205,1,2,1,1,0,0,5,8690,54.42
27206,1,1,0,1,0,0,3,1352,17.01
27207,1,2,1,1,0,0,5,8690,54.42
27208,1,4,0,1,0,0,6,11521,68.36
27209,1,1,0,1,0,0,3,1352,17.01
27210,1,0,2,1,0,0,4,4966,36.77
27211,3,0,5,1,1,0,10,16522,90.12
27212,1,2,0,1,0,0,4,4966,36.77
27213,1,1,0,1,0,0,3,1352,17.01
27214,1,0,0,1,0,0,2,32,3.72
27215,1,0,0,1,0,0,2,32,3.72
27216,1,0,2,1,0,0,4,4966,36.77
27217,1,0,3,1,0,0,5,8690,54.42
27218,1,2,0,1,0,0,4,4966,36.77
27219,1,0,1,1,0,0,3,1352,17.01
27220,1,1,0,1,0,0,3,1352,17.01
27221,1,1,1,0,0,6,9,15950,87.44
27222,1,0,1,1,0,2,5,8690,54.42
27223,1,1,1,1,0,0,4,4966,36.77
27224,1,0,1,1,0,0,3,1352,17.01
27225,1,0,1,1,0,0,3,1352,17.01
27226,1,0,1,1,0,0,3,1352,17.01
27227,3,0,4,2,3,10,22,18498,99.73
27228,1,0,2,1,0,0,4,4966,36.77
27229,1,0,2,1,1,4,9,15950,87.44
27230,1,1,1,1,0,0,4,4966,36.77
27231,3,0,5,4,5,2,19,18362,99.04
27232,3,0,5,1,1,6,16,18081,97.67
27233,1,0,2,1,0,0,4,4966,36.77
27234,1,2,1,1,0,0,5,8690,54.42
27235,1,3,0,1,0,0,5,8690,54.42
27236,1,4,1,1,0,0,7,13868,78.23
27237,1,0,0,1,0,0,2,32,3.72
27238,1,3,2,2,0,0,8,15186,83.84
27239,1,1,1,1,0,0,4,4966,36.77
27240,1,0,2,1,0,0,4,4966,36.77
27241,3,0,5,2,2,6,18,18287,98.68
27242,3,0,5,2,1,0,11,16947,91.91
27243,1,0,0,1,0,0,2,32,3.72
27244,1,0,2,1,0,0,4,4966,36.77
27245,3,0,5,2,3,0,13,17456,94.66
27246,1,2,1,1,0,0,5,8690,54.42
27247,3,0,5,1,5,0,14,17699,95.82
27248,1,0,5,1,0,0,7,13868,78.23
27249,1,0,2,1,0,0,4,4966,36.77
27250,1,1,1,1,0,0,4,4966,36.77
27251,1,4,0,1,0,0,6,11521,68.36
27252,1,2,1,1,0,0,5,8690,54.42
27253,1,0,1,1,0,2,5,8690,54.42
27254,1,0,2,1,0,0,4,4966,36.77
27255,1,1,1,1,0,0,4,4966,36.77
27256,1,0,1,1,0,0,3,1352,17.01
27257,1,0,1,1,0,6,9,15950,87.44
27258,1,0,3,1,0,6,11,16947,91.91
27259,3,4,4,2,1,0,14,17699,95.82
27260,1,0,0,1,0,0,2,32,3.72
27262,1,0,2,1,0,0,4,4966,36.77
27263,1,0,2,1,1,0,5,8690,54.42
27264,1,0,1,1,0,0,3,1352,17.01
27265,1,2,0,1,0,0,4,4966,36.77
27266,1,1,1,1,0,0,4,4966,36.77
27267,1,0,1,1,0,0,3,1352,17.01
27268,1,1,2,1,0,0,5,8690,54.42
27269,1,3,0,1,0,0,5,8690,54.42
27270,1,2,0,1,0,0,4,4966,36.77
27271,1,0,2,1,0,6,10,16522,90.12
27272,1,0,1,1,0,0,3,1352,17.01
27273,3,0,4,2,3,0,12,17186,93.28
27274,3,0,5,2,3,0,13,17456,94.66
27275,1,1,1,1,0,0,4,4966,36.77
27276,1,1,2,1,0,0,5,8690,54.42
27277,1,0,0,1,0,0,2,32,3.72
27278,1,1,0,1,0,0,3,1352,17.01
27279,1,0,0,1,0,0,2,32,3.72
27280,1,4,0,1,0,0,6,11521,68.36
27281,1,1,0,1,0,0,3,1352,17.01
27282,1,0,1,1,3,0,6,11521,68.36
27283,1,1,0,1,0,0,3,1352,17.01
27284,1,2,0,1,3,0,7,13868,78.23
27285,1,2,1,1,0,0,5,8690,54.42
27286,1,0,3,2,1,0,7,13868,78.23
27287,1,5,0,1,0,0,7,13868,78.23
27288,1,4,0,1,0,0,6,11521,68.36
27289,1,4,0,1,0,0,6,11521,68.36
27291,3,0,5,2,3,6,19,18362,99.04
27292,3,0,5,2,2,8,20,18419,99.31
27293,3,0,5,1,1,0,10,16522,90.12
27294,1,1,0,1,0,6,9,15950,87.44
27295,1,1,1,1,0,0,4,4966,36.77
27296,1,3,1,1,0,0,6,11521,68.36
27297,1,2,0,1,0,0,4,4966,36.77
27298,1,3,0,1,0,0,5,8690,54.42
27299,1,0,2,1,0,0,4,4966,36.77
27300,1,4,0,1,1,0,7,13868,78.23
27301,1,1,1,1,0,0,4,4966,36.77
27302,1,2,1,1,0,0,5,8690,54.42
27303,1,2,1,1,0,0,5,8690,54.42
27304,1,4,2,1,0,0,8,15186,83.84
27305,1,2,1,1,0,0,5,8690,54.42
27306,1,1,0,1,0,0,3,1352,17.01
27307,1,3,0,1,0,0,5,8690,54.42
27308,1,3,0,1,0,0,5,8690,54.42
27309,1,1,0,1,0,0,3,1352,17.01
27310,1,3,1,1,0,0,6,11521,68.36
27311,1,0,2,1,1,0,5,8690,54.42
27312,1,4,0,1,0,0,6,11521,68.36
27313,1,0,1,1,0,0,3,1352,17.01
27314,1,2,0,1,0,0,4,4966,36.77
27315,1,4,0,1,0,0,6,11521,68.36
27316,1,0,2,1,0,0,4,4966,36.77
27317,1,1,1,1,0,0,4,4966,36.77
27318,1,2,0,1,2,0,6,11521,68.36
27319,1,2,0,1,0,0,4,4966,36.77
27320,1,2,1,1,0,0,5,8690,54.42
27321,1,2,0,1,0,0,4,4966,36.77
27322,1,1,2,1,0,0,5,8690,54.42
27323,1,1,0,1,0,0,3,1352,17.01
27324,1,0,1,1,0,0,3,1352,17.01
27325,1,4,0,1,0,0,6,11521,68.36
27326,1,0,1,1,0,0,3,1352,17.01
27327,1,2,0,1,0,0,4,4966,36.77
27328,3,0,5,1,2,6,17,18193,98.23
27329,1,4,0,1,0,0,6,11521,68.36
27330,1,4,2,1,0,0,8,15186,83.84
27331,1,2,0,1,0,0,4,4966,36.77
27332,1,1,0,1,0,0,3,1352,17.01
27333,1,0,4,2,1,0,8,15186,83.84
27334,1,1,1,1,0,0,4,4966,36.77
27335,1,0,2,1,0,6,10,16522,90.12
27336,1,2,1,1,0,0,5,8690,54.42
27337,1,0,1,1,0,0,3,1352,17.01
27338,1,1,0,1,0,0,3,1352,17.01
27339,1,1,1,1,0,0,4,4966,36.77
27340,1,0,4,1,0,0,6,11521,68.36
27341,1,4,0,1,0,0,6,11521,68.36
27342,3,0,5,1,1,6,16,18081,97.67
27343,3,0,5,2,3,6,19,18362,99.04
27344,3,0,4,2,3,0,12,17186,93.28
27345,1,0,3,1,0,0,5,8690,54.42
27346,1,2,1,1,0,0,5,8690,54.42
27347,3,1,4,3,1,0,12,17186,93.28
27348,1,0,4,1,0,0,6,11521,68.36
27349,1,1,1,1,0,6,10,16522,90.12
27350,1,0,1,1,0,0,3,1352,17.01
27351,1,4,1,1,0,0,7,13868,78.23
27352,1,1,1,1,0,0,4,4966,36.77
27353,1,0,2,1,0,0,4,4966,36.77
27354,1,0,1,1,0,6,9,15950,87.44
27355,1,2,0,1,0,0,4,4966,36.77
27356,1,1,1,1,0,4,8,15186,83.84
27357,1,1,2,1,1,0,6,11521,68.36
27358,1,0,3,1,1,0,6,11521,68.36
27359,1,0,2,1,0,0,4,4966,36.77
27360,1,3,0,1,0,0,5,8690,54.42
27361,1,0,1,1,0,0,3,1352,17.01
27362,3,0,4,2,5,0,14,17699,95.82
27363,1,0,0,1,0,0,2,32,3.72
27364,1,5,0,1,0,0,7,13868,78.23
27365,1,2,1,1,0,0,5,8690,54.42
27366,1,0,1,1,0,0,3,1352,17.01
27367,1,1,1,1,0,0,4,4966,36.77
27368,1,0,1,1,0,0,3,1352,17.01
27369,1,0,1,1,0,0,3,1352,17.01
27370,1,2,1,1,0,0,5,8690,54.42
27371,1,0,2,1,0,0,4,4966,36.77
27372,1,0,2,1,1,0,5,8690,54.42
27373,1,1,2,1,0,0,5,8690,54.42
27374,1,0,0,0,0,10,11,16947,91.91
27375,1,0,2,0,0,10,13,17456,94.66
27376,1,4,1,1,0,0,7,13868,78.23
27378,1,4,0,1,0,0,6,11521,68.36
27379,1,1,1,1,0,0,4,4966,36.77
27380,1,0,1,1,0,0,3,1352,17.01
27381,1,0,1,1,0,0,3,1352,17.01
27382,1,4,0,1,0,0,6,11521,68.36
27383,1,2,1,1,0,0,5,8690,54.42
27384,1,0,2,1,0,6,10,16522,90.12
27385,1,0,0,1,0,0,2,32,3.72
27386,1,0,2,1,1,0,5,8690,54.42
27387,1,1,2,1,0,0,5,8690,54.42
27388,1,1,2,1,0,0,5,8690,54.42
27389,1,0,2,1,0,10,14,17699,95.82
27390,1,2,2,1,0,0,6,11521,68.36
27391,1,0,1,1,0,0,3,1352,17.01
27392,1,5,3,1,0,0,10,16522,90.12
27393,1,2,1,1,0,0,5,8690,54.42
27394,1,3,1,1,0,0,6,11521,68.36
27395,1,0,0,1,0,0,2,32,3.72
27396,1,1,0,1,0,0,3,1352,17.01
27397,1,1,2,1,0,0,5,8690,54.42
27398,1,0,2,1,0,0,4,4966,36.77
27399,1,1,2,1,0,0,5,8690,54.42
27400,1,3,2,1,0,0,7,13868,78.23
27401,1,0,2,1,1,0,5,8690,54.42
27402,1,4,0,1,0,0,6,11521,68.36
27403,1,0,2,1,0,0,4,4966,36.77
27404,1,0,2,1,0,0,4,4966,36.77
27405,1,3,1,1,3,0,9,15950,87.44
27406,1,2,0,1,0,0,4,4966,36.77
27407,1,1,1,1,0,0,4,4966,36.77
27408,1,0,0,1,0,0,2,32,3.72
27409,1,1,0,1,0,0,3,1352,17.01
27410,1,0,1,1,0,0,3,1352,17.01
27411,1,0,0,1,0,0,2,32,3.72
27412,1,1,0,1,0,0,3,1352,17.01
27413,1,0,0,1,0,0,2,32,3.72
27414,1,2,1,1,0,0,5,8690,54.42
27415,1,0,1,1,0,0,3,1352,17.01
27416,1,0,1,1,2,0,5,8690,54.42
27417,3,0,5,1,3,2,14,17699,95.82
27418,3,0,5,1,3,4,16,18081,97.67
27419,1,0,3,1,0,0,5,8690,54.42
27420,3,1,5,2,1,0,12,17186,93.28
27421,3,4,5,2,1,0,15,17888,96.85
27422,3,0,4,1,2,0,10,16522,90.12
27423,1,3,0,1,0,0,5,8690,54.42
27424,1,2,0,1,0,0,4,4966,36.77
27425,1,1,0,1,0,0,3,1352,17.01
27426,1,1,2,1,0,0,5,8690,54.42
27427,1,3,1,1,0,0,6,11521,68.36
27428,1,0,1,1,0,6,9,15950,87.44
27429,1,0,1,1,0,0,3,1352,17.01
27430,1,1,0,1,0,0,3,1352,17.01
27431,1,1,3,2,0,0,7,13868,78.23
27432,1,0,2,1,1,0,5,8690,54.42
27433,1,0,2,1,1,6,11,16947,91.91
27434,1,0,2,1,0,0,4,4966,36.77
27435,1,4,3,1,0,0,9,15950,87.44
27436,1,1,2,1,0,0,5,8690,54.42
27437,1,1,1,1,0,0,4,4966,36.77
27438,1,0,1,1,0,0,3,1352,17.01
27439,1,1,0,1,0,0,3,1352,17.01
27440,1,0,1,1,0,0,3,1352,17.01
27441,1,1,1,1,0,0,4,4966,36.77
27442,3,0,5,2,3,0,13,17456,94.66
27443,3,0,4,2,3,0,12,17186,93.28
27444,1,0,0,1,1,2,5,8690,54.42
27445,1,2,1,1,0,0,5,8690,54.42
27446,1,1,0,1,0,0,3,1352,17.01
27447,1,4,2,1,0,0,8,15186,83.84
27448,3,0,5,1,1,0,10,16522,90.12
27449,3,0,4,1,1,0,9,15950,87.44
27450,1,2,0,1,0,0,4,4966,36.77
27451,3,0,4,1,4,0,12,17186,93.28
27452,3,4,5,5,5,0,22,18498,99.73
27453,3,0,5,1,3,10,22,18498,99.73
27454,1,3,1,1,0,0,6,11521,68.36
27455,1,0,1,1,0,0,3,1352,17.01
27456,1,4,1,1,0,0,7,13868,78.23
27457,1,0,1,1,0,0,3,1352,17.01
27458,1,0,3,2,0,0,6,11521,68.36
27459,1,0,1,1,0,0,3,1352,17.01
27460,1,0,2,1,0,0,4,4966,36.77
27461,1,1,0,1,0,0,3,1352,17.01
27462,1,2,0,1,0,0,4,4966,36.77
27463,1,3,0,1,0,0,5,8690,54.42
27464,1,2,0,1,0,0,4,4966,36.77
27465,1,0,5,1,0,0,7,13868,78.23
27466,1,2,0,1,0,0,4,4966,36.77
27467,1,0,1,1,0,0,3,1352,17.01
27468,1,1,2,1,0,0,5,8690,54.42
27469,1,0,0,1,0,0,2,32,3.72
27470,1,1,2,1,0,0,5,8690,54.42
27471,1,2,0,1,0,0,4,4966,36.77
27472,1,0,1,1,0,0,3,1352,17.01
27473,1,1,1,1,0,0,4,4966,36.77
27474,1,2,0,1,0,0,4,4966,36.77
27475,1,0,2,1,0,0,4,4966,36.77
27476,1,1,2,1,0,0,5,8690,54.42
27477,1,1,0,1,0,0,3,1352,17.01
27478,1,4,1,1,0,0,7,13868,78.23
27479,1,0,0,1,0,0,2,32,3.72
27480,1,0,2,1,0,0,4,4966,36.77
27481,1,0,1,1,0,0,3,1352,17.01
27482,1,2,1,1,0,0,5,8690,54.42
27483,1,1,1,1,0,0,4,4966,36.77
27484,1,1,0,1,0,0,3,1352,17.01
27485,1,1,0,1,0,0,3,1352,17.01
27486,1,1,1,1,0,10,14,17699,95.82
27487,1,1,1,1,0,0,4,4966,36.77
27488,1,0,1,1,0,0,3,1352,17.01
27489,1,0,0,1,0,0,2,32,3.72
27491,1,1,0,1,0,0,3,1352,17.01
27492,1,1,0,1,0,0,3,1352,17.01
27493,1,1,0,1,0,0,3,1352,17.01
27494,1,4,0,1,0,0,6,11521,68.36
27495,1,1,1,1,0,0,4,4966,36.77
27496,1,3,0,1,0,0,5,8690,54.42
27497,1,1,0,1,0,0,3,1352,17.01
27498,1,0,1,1,0,0,3,1352,17.01
27499,1,0,1,1,0,0,3,1352,17.01
27500,1,0,0,1,0,0,2,32,3.72
27501,3,0,4,2,2,0,11,16947,91.91
27502,3,2,3,2,0,0,10,16522,90.12
27503,3,2,4,1,1,0,11,16947,91.91
27504,3,1,5,2,3,6,20,18419,99.31
27505,1,1,0,1,0,0,3,1352,17.01
27506,1,1,1,1,0,0,4,4966,36.77
27508,1,0,0,1,0,0,2,32,3.72
27509,1,1,1,1,0,0,4,4966,36.77
27510,1,4,0,1,0,0,6,11521,68.36
27511,1,0,0,1,0,0,2,32,3.72
27512,1,0,1,1,0,0,3,1352,17.01
27513,1,2,0,0,0,0,3,1352,17.01
27514,1,1,0,1,0,0,3,1352,17.01
27515,1,0,0,1,0,0,2,32,3.72
27516,1,0,0,1,2,6,10,16522,90.12
27517,1,4,2,2,0,0,9,15950,87.44
27518,1,2,4,1,0,0,8,15186,83.84
27519,3,0,5,1,2,0,11,16947,91.91
27520,3,0,5,2,3,6,19,18362,99.04
27521,3,0,5,2,2,0,12,17186,93.28
27522,1,1,0,1,0,6,9,15950,87.44
27523,1,1,0,1,0,0,3,1352,17.01
27524,1,0,0,1,0,0,2,32,3.72
27525,1,0,1,1,0,0,3,1352,17.01
27526,1,2,2,1,0,0,6,11521,68.36
27527,1,0,2,1,0,0,4,4966,36.77
27528,1,0,2,1,0,0,4,4966,36.77
27529,1,0,0,1,0,6,8,15186,83.84
27530,1,5,2,1,0,0,9,15950,87.44
27531,1,5,2,1,0,0,9,15950,87.44
27532,3,0,4,2,3,0,12,17186,93.28
27533,3,1,4,2,2,0,12,17186,93.28
27534,3,0,4,2,3,0,12,17186,93.28
27535,1,4,0,1,0,0,6,11521,68.36
27536,1,1,0,1,0,0,3,1352,17.01
27537,1,4,0,1,0,0,6,11521,68.36
27538,1,1,2,1,0,0,5,8690,54.42
27539,1,0,1,1,0,0,3,1352,17.01
27540,1,2,3,1,0,0,7,13868,78.23
27541,1,1,0,1,0,0,3,1352,17.01
27542,1,4,1,1,0,0,7,13868,78.23
27543,1,2,0,1,0,0,4,4966,36.77
27544,1,0,4,2,2,6,15,17888,96.85
27545,1,0,2,1,0,0,4,4966,36.77
27546,1,0,3,1,1,6,12,17186,93.28
27547,1,3,3,1,0,0,8,15186,83.84
27548,3,0,5,1,2,0,11,16947,91.91
27549,1,0,1,1,0,0,3,1352,17.01
27550,1,0,0,1,0,0,2,32,3.72
27551,1,5,1,1,0,0,8,15186,83.84
27552,1,2,0,1,0,0,4,4966,36.77
27553,1,4,0,1,0,0,6,11521,68.36
27554,1,0,1,1,0,0,3,1352,17.01
27555,1,0,1,1,0,0,3,1352,17.01
27556,1,0,1,1,0,0,3,1352,17.01
27557,1,1,1,1,0,0,4,4966,36.77
27558,1,1,1,1,0,0,4,4966,36.77
27559,3,0,5,2,3,0,13,17456,94.66
27560,1,1,2,1,0,0,5,8690,54.42
27561,3,0,5,2,2,10,22,18498,99.73
27562,1,5,0,1,0,0,7,13868,78.23
27563,1,4,0,0,0,0,5,8690,54.42
27564,1,2,1,1,0,0,5,8690,54.42
27565,1,0,1,1,0,6,9,15950,87.44
27566,1,1,1,1,0,0,4,4966,36.77
27567,1,2,2,1,0,0,6,11521,68.36
27568,1,0,1,1,0,0,3,1352,17.01
27569,1,0,1,1,0,0,3,1352,17.01
27570,1,1,0,1,0,0,3,1352,17.01
27571,1,3,1,1,0,0,6,11521,68.36
27572,1,1,1,1,1,0,5,8690,54.42
27573,1,0,0,1,0,0,2,32,3.72
27574,1,0,1,1,3,0,6,11521,68.36
27575,1,0,1,1,0,0,3,1352,17.01
27576,1,0,1,1,0,0,3,1352,17.01
27577,1,3,3,1,0,0,8,15186,83.84
27578,3,1,5,2,3,6,20,18419,99.31
27579,3,0,4,1,3,0,11,16947,91.91
27580,1,5,3,1,0,0,10,16522,90.12
27581,1,0,1,1,0,0,3,1352,17.01
27582,1,1,0,0,0,0,2,32,3.72
27583,1,1,0,1,0,0,3,1352,17.01
27584,1,2,0,1,0,0,4,4966,36.77
27585,1,0,1,1,0,6,9,15950,87.44
27586,1,2,0,1,0,0,4,4966,36.77
27587,3,0,5,2,2,0,12,17186,93.28
27588,1,0,1,1,0,0,3,1352,17.01
27589,1,2,0,1,0,0,4,4966,36.77
27590,1,3,0,1,0,0,5,8690,54.42
27591,1,2,0,1,0,0,4,4966,36.77
27592,1,1,1,1,0,0,4,4966,36.77
27593,1,0,3,1,0,0,5,8690,54.42
27594,1,0,1,1,0,0,3,1352,17.01
27595,1,2,0,1,0,0,4,4966,36.77
27596,1,4,0,1,0,0,6,11521,68.36
27597,1,1,1,1,0,0,4,4966,36.77
27598,1,0,4,2,0,0,7,13868,78.23
27599,1,0,1,1,0,0,3,1352,17.01
27600,1,3,1,1,0,0,6,11521,68.36
27601,1,0,0,1,0,0,2,32,3.72
27602,1,4,1,1,0,0,7,13868,78.23
27604,1,1,0,1,0,0,3,1352,17.01
27605,1,1,1,1,0,0,4,4966,36.77
27606,1,4,1,1,0,0,7,13868,78.23
27607,1,0,2,1,0,0,4,4966,36.77
27608,1,0,4,1,0,0,6,11521,68.36
27609,1,2,0,1,0,0,4,4966,36.77
27610,1,2,1,1,0,0,5,8690,54.42
27611,1,0,1,1,0,0,3,1352,17.01
27612,1,3,0,1,0,0,5,8690,54.42
27613,1,1,1,1,0,0,4,4966,36.77
27614,1,3,1,1,0,0,6,11521,68.36
27615,1,4,0,1,0,0,6,11521,68.36
27616,1,4,0,1,0,0,6,11521,68.36
27617,1,3,0,1,0,0,5,8690,54.42
27618,1,0,1,1,0,0,3,1352,17.01
27619,1,4,2,1,0,0,8,15186,83.84
27620,1,0,0,1,0,0,2,32,3.72
27621,1,2,0,1,0,0,4,4966,36.77
27622,1,1,0,1,0,0,3,1352,17.01
27623,1,0,1,1,0,2,5,8690,54.42
27624,1,1,3,1,0,0,6,11521,68.36
27625,1,1,1,1,0,0,4,4966,36.77
27626,1,1,1,1,0,0,4,4966,36.77
27627,1,2,0,1,0,0,4,4966,36.77
27628,1,1,0,1,0,0,3,1352,17.01
27629,1,4,2,1,0,0,8,15186,83.84
27630,1,0,1,1,0,0,3,1352,17.01
27631,1,3,0,1,0,0,5,8690,54.42
27632,1,1,1,1,0,0,4,4966,36.77
27633,1,0,0,1,0,0,2,32,3.72
27634,3,0,5,2,3,8,21,18462,99.52
27635,1,0,2,1,0,0,4,4966,36.77
27636,1,5,2,1,0,0,9,15950,87.44
27637,3,0,5,2,5,8,23,18538,99.86
27638,1,0,1,1,0,0,3,1352,17.01
27639,1,4,0,1,0,0,6,11521,68.36
27640,1,1,1,1,0,0,4,4966,36.77
27641,1,2,0,1,0,0,4,4966,36.77
27642,1,0,2,1,0,0,4,4966,36.77
27643,1,1,0,1,0,0,3,1352,17.01
27644,1,3,0,1,0,0,5,8690,54.42
27645,1,1,1,1,0,0,4,4966,36.77
27646,1,3,0,1,0,0,5,8690,54.42
27647,1,2,0,1,0,0,4,4966,36.77
27648,1,1,0,1,0,0,3,1352,17.01
27649,1,2,2,1,0,0,6,11521,68.36
27650,3,0,5,2,2,2,14,17699,95.82
27651,1,2,2,1,0,0,6,11521,68.36
27652,1,4,2,1,0,0,8,15186,83.84
27653,1,0,4,1,0,2,8,15186,83.84
27654,1,0,4,1,0,2,8,15186,83.84
27655,3,0,3,2,2,0,10,16522,90.12
27656,1,1,2,1,0,0,5,8690,54.42
27657,1,3,2,1,0,0,7,13868,78.23
27658,1,1,0,1,0,0,3,1352,17.01
27659,1,0,1,1,0,0,3,1352,17.01
27660,1,1,4,2,0,0,8,15186,83.84
27661,1,2,0,1,0,0,4,4966,36.77
27662,1,0,2,1,0,0,4,4966,36.77
27663,1,0,0,1,0,0,2,32,3.72
27664,1,2,1,1,0,0,5,8690,54.42
27666,1,2,3,2,0,0,8,15186,83.84
27667,3,0,4,2,1,10,20,18419,99.31
27668,1,0,0,1,0,0,2,32,3.72
27669,1,0,1,1,0,0,3,1352,17.01
27670,1,0,1,1,0,0,3,1352,17.01
27671,1,0,1,1,0,0,3,1352,17.01
27672,1,1,1,1,0,0,4,4966,36.77
27673,1,4,5,1,0,0,11,16947,91.91
27674,1,2,0,1,0,0,4,4966,36.77
27675,1,1,2,1,0,0,5,8690,54.42
27676,1,0,1,1,0,0,3,1352,17.01
27677,1,0,3,1,0,0,5,8690,54.42
27678,1,0,1,1,0,6,9,15950,87.44
27679,1,1,4,2,1,0,9,15950,87.44
27680,1,0,3,1,0,10,15,17888,96.85
27681,1,3,0,1,0,0,5,8690,54.42
27682,1,1,1,1,0,6,10,16522,90.12
27683,1,0,1,1,0,0,3,1352,17.01
27684,1,1,1,1,0,0,4,4966,36.77
27685,1,0,0,1,0,0,2,32,3.72
27686,1,1,0,1,0,0,3,1352,17.01
27687,1,0,1,1,0,0,3,1352,17.01
27688,1,0,1,1,0,0,3,1352,17.01
27689,1,0,0,1,0,0,2,32,3.72
27690,1,5,3,1,0,0,10,16522,90.12
27691,1,3,1,1,0,0,6,11521,68.36
27692,1,4,0,1,0,0,6,11521,68.36
27693,1,0,0,1,0,0,2,32,3.72
27694,1,4,3,1,0,0,9,15950,87.44
27695,3,2,5,5,0,0,15,17888,96.85
27696,1,0,0,1,0,0,2,32,3.72
27697,3,0,5,1,1,0,10,16522,90.12
27698,3,1,5,1,3,2,15,17888,96.85
27699,1,0,2,1,0,0,4,4966,36.77
27700,1,5,1,1,0,0,8,15186,83.84
27701,1,0,1,1,0,0,3,1352,17.01
27702,1,1,0,1,0,0,3,1352,17.01
27703,1,0,1,1,0,0,3,1352,17.01
27704,1,4,0,1,0,0,6,11521,68.36
27705,1,1,1,1,0,0,4,4966,36.77
27706,1,0,1,1,0,0,3,1352,17.01
27707,1,1,1,1,0,0,4,4966,36.77
27708,1,1,2,1,0,0,5,8690,54.42
27709,1,0,2,1,0,0,4,4966,36.77
27710,1,0,1,1,0,0,3,1352,17.01
27711,3,0,5,1,1,6,16,18081,97.67
27712,3,4,3,2,0,0,12,17186,93.28
27713,1,1,1,1,0,0,4,4966,36.77
27714,1,3,0,1,0,0,5,8690,54.42
27715,1,2,0,1,0,0,4,4966,36.77
27716,1,0,2,1,0,0,4,4966,36.77
27717,1,1,1,1,0,0,4,4966,36.77
27718,1,0,5,1,0,0,7,13868,78.23
27719,1,1,5,2,0,0,9,15950,87.44
27720,1,0,4,2,0,0,7,13868,78.23
27721,1,1,4,2,0,0,8,15186,83.84
27722,1,1,5,2,1,0,10,16522,90.12
27723,1,5,5,2,0,0,13,17456,94.66
27724,1,1,1,1,0,0,4,4966,36.77
27725,1,0,0,1,0,0,2,32,3.72
27726,1,0,1,0,0,2,4,4966,36.77
27727,1,5,0,1,0,0,7,13868,78.23
27728,1,0,3,1,1,0,6,11521,68.36
27729,1,2,1,1,0,0,5,8690,54.42
27730,1,0,1,1,0,0,3,1352,17.01
27731,1,0,2,1,0,0,4,4966,36.77
27732,1,5,2,1,0,0,9,15950,87.44
27733,1,4,0,1,0,0,6,11521,68.36
27734,1,3,0,1,0,0,5,8690,54.42
27735,1,1,1,1,0,0,4,4966,36.77
27736,3,0,4,1,2,6,16,18081,97.67
27737,1,3,2,1,0,0,7,13868,78.23
27738,1,0,1,1,0,0,3,1352,17.01
27739,1,1,1,1,0,0,4,4966,36.77
27740,1,1,1,1,0,0,4,4966,36.77
27741,1,1,0,1,0,0,3,1352,17.01
27742,1,1,0,1,0,0,3,1352,17.01
27743,1,1,1,1,0,0,4,4966,36.77
27744,1,0,2,1,0,0,4,4966,36.77
27745,1,2,1,1,0,8,13,17456,94.66
27746,1,0,1,1,0,0,3,1352,17.01
27747,1,4,0,1,0,0,6,11521,68.36
27748,1,3,0,1,0,0,5,8690,54.42
27749,1,1,1,1,0,0,4,4966,36.77
27750,1,0,1,1,2,2,7,13868,78.23
27751,1,0,1,1,0,0,3,1352,17.01
27752,3,0,5,2,2,8,20,18419,99.31
27753,3,1,3,2,3,0,12,17186,93.28
27754,1,1,0,1,0,0,3,1352,17.01
27755,1,1,1,1,0,0,4,4966,36.77
27756,1,1,1,1,0,0,4,4966,36.77
27757,1,1,2,1,0,0,5,8690,54.42
27758,1,0,1,1,0,0,3,1352,17.01
27759,1,2,0,1,0,0,4,4966,36.77
27760,1,3,0,1,0,0,5,8690,54.42
27761,1,1,2,1,0,0,5,8690,54.42
27762,1,0,2,1,0,0,4,4966,36.77
27763,1,1,1,1,0,0,4,4966,36.77
27764,1,1,0,1,0,2,5,8690,54.42
27765,1,2,1,1,0,0,5,8690,54.42
27766,1,0,2,1,0,0,4,4966,36.77
27767,1,0,1,1,0,0,3,1352,17.01
27768,1,4,1,1,0,0,7,13868,78.23
27769,1,0,1,1,0,0,3,1352,17.01
27770,1,3,0,1,0,0,5,8690,54.42
27771,1,0,2,1,0,6,10,16522,90.12
27772,1,4,0,1,0,0,6,11521,68.36
27773,1,4,4,2,0,0,11,16947,91.91
27774,1,1,1,1,1,0,5,8690,54.42
27775,4,0,3,1,3,6,17,18193,98.23
27776,1,0,1,1,0,0,3,1352,17.01
27777,1,4,2,1,0,0,8,15186,83.84
27778,1,0,2,1,0,6,10,16522,90.12
27779,1,0,2,1,0,0,4,4966,36.77
27780,3,2,3,4,4,0,16,18081,97.67
27781,3,3,4,4,4,0,18,18287,98.68
27782,1,0,1,1,0,0,3,1352,17.01
27783,1,0,1,1,0,0,3,1352,17.01
27784,1,2,2,1,0,0,6,11521,68.36
27785,1,0,1,1,0,0,3,1352,17.01
27786,1,2,1,1,0,0,5,8690,54.42
27787,1,3,4,2,0,0,10,16522,90.12
27788,1,0,1,1,0,6,9,15950,87.44
27789,1,0,1,1,0,6,9,15950,87.44
27790,1,0,3,1,0,0,5,8690,54.42
27791,1,0,2,1,0,6,10,16522,90.12
27792,1,0,1,1,0,6,9,15950,87.44
27793,1,0,1,1,0,0,3,1352,17.01
27794,1,0,0,1,0,0,2,32,3.72
27795,1,2,1,1,0,0,5,8690,54.42
27796,1,3,0,1,0,0,5,8690,54.42
27797,1,0,2,1,0,4,8,15186,83.84
27798,1,1,0,1,0,0,3,1352,17.01
27799,1,4,1,1,0,0,7,13868,78.23
27800,1,1,1,1,0,0,4,4966,36.77
27801,1,0,1,1,0,0,3,1352,17.01
27802,1,0,3,2,0,0,6,11521,68.36
27803,1,0,1,1,0,6,9,15950,87.44
27804,1,0,2,1,0,0,4,4966,36.77
27805,1,4,1,1,0,0,7,13868,78.23
27806,1,0,2,1,0,0,4,4966,36.77
27807,1,0,1,1,0,0,3,1352,17.01
27808,1,3,1,1,0,0,6,11521,68.36
27809,1,2,1,1,0,0,5,8690,54.42
27810,1,1,1,1,0,0,4,4966,36.77
27811,1,0,2,1,0,0,4,4966,36.77
27812,1,3,1,1,0,0,6,11521,68.36
27813,1,3,1,1,0,0,6,11521,68.36
27815,1,2,1,1,0,0,5,8690,54.42
27816,1,1,1,1,0,0,4,4966,36.77
27817,1,2,1,1,0,0,5,8690,54.42
27818,1,0,1,2,0,0,4,4966,36.77
27819,1,0,2,1,0,0,4,4966,36.77
27820,1,0,2,1,0,6,10,16522,90.12
27821,1,2,1,1,0,6,11,16947,91.91
27822,1,4,0,1,0,0,6,11521,68.36
27823,1,3,1,1,0,0,6,11521,68.36
27824,1,0,1,1,4,0,7,13868,78.23
27825,1,4,1,1,4,0,11,16947,91.91
27826,3,1,5,2,1,0,12,17186,93.28
27827,1,0,3,2,0,0,6,11521,68.36
27828,1,2,0,1,0,0,4,4966,36.77
27829,1,3,1,1,0,0,6,11521,68.36
27830,1,0,1,1,0,0,3,1352,17.01
27831,1,0,1,1,0,0,3,1352,17.01
27832,1,5,0,1,0,0,7,13868,78.23
27833,1,1,1,1,0,0,4,4966,36.77
27834,1,0,2,1,0,0,4,4966,36.77
27835,1,1,0,1,0,0,3,1352,17.01
27836,1,0,0,1,0,0,2,32,3.72
27837,1,1,1,1,0,0,4,4966,36.77
27838,1,0,1,1,0,10,13,17456,94.66
27839,1,1,0,1,0,0,3,1352,17.01
27840,1,0,1,1,0,0,3,1352,17.01
27841,1,1,1,1,0,0,4,4966,36.77
27842,1,3,0,1,0,0,5,8690,54.42
27843,1,0,3,1,1,0,6,11521,68.36
27844,1,1,0,1,0,0,3,1352,17.01
27845,1,1,4,1,0,0,7,13868,78.23
27846,1,4,1,1,0,0,7,13868,78.23
27847,1,0,2,1,0,10,14,17699,95.82
27848,3,0,5,2,3,6,19,18362,99.04
27849,3,0,5,2,3,10,23,18538,99.86
27850,3,1,5,1,1,0,11,16947,91.91
27851,1,3,0,1,0,0,5,8690,54.42
27852,1,0,1,1,2,6,11,16947,91.91
27853,1,0,0,1,0,0,2,32,3.72
27854,1,2,1,1,0,0,5,8690,54.42
27855,1,1,1,1,0,0,4,4966,36.77
27856,1,2,1,1,0,0,5,8690,54.42
27857,1,4,0,1,0,0,6,11521,68.36
27858,1,0,4,2,3,0,10,16522,90.12
27859,1,2,0,1,0,0,4,4966,36.77
27860,1,0,1,1,0,6,9,15950,87.44
27861,1,0,1,1,0,0,3,1352,17.01
27862,1,0,2,1,0,0,4,4966,36.77
27863,1,3,2,1,0,0,7,13868,78.23
27864,1,1,2,1,0,0,5,8690,54.42
27865,3,0,5,1,3,6,18,18287,98.68
27866,3,1,3,2,4,0,13,17456,94.66
27867,3,0,3,2,3,0,11,16947,91.91
27868,3,0,5,1,2,6,17,18193,98.23
27869,1,1,1,1,0,0,4,4966,36.77
27871,1,1,1,1,0,0,4,4966,36.77
27872,1,0,1,1,0,0,3,1352,17.01
27873,1,0,1,1,0,0,3,1352,17.01
27874,1,0,3,1,0,0,5,8690,54.42
27875,1,1,0,1,0,0,3,1352,17.01
27876,1,4,0,1,0,0,6,11521,68.36
27877,1,0,1,1,0,0,3,1352,17.01
27878,1,1,1,1,0,0,4,4966,36.77
27879,1,1,0,1,0,0,3,1352,17.01
27880,3,4,5,2,1,0,15,17888,96.85
27881,1,1,1,1,0,0,4,4966,36.77
27882,1,1,0,2,0,0,4,4966,36.77
27883,1,0,2,1,0,0,4,4966,36.77
27884,1,1,2,1,0,0,5,8690,54.42
27885,1,0,1,1,0,0,3,1352,17.01
27886,3,0,2,1,3,6,15,17888,96.85
27887,1,3,0,1,0,0,5,8690,54.42
27888,1,0,3,2,3,0,9,15950,87.44
27889,1,1,1,1,0,0,4,4966,36.77
27890,1,3,1,1,0,0,6,11521,68.36
27891,1,0,2,1,0,0,4,4966,36.77
27892,1,0,3,2,1,0,7,13868,78.23
27893,1,0,3,2,4,6,16,18081,97.67
27894,1,3,1,1,0,0,6,11521,68.36
27895,1,3,0,1,0,0,5,8690,54.42
27896,1,0,0,1,0,0,2,32,3.72
27897,1,2,0,1,0,0,4,4966,36.77
27898,1,4,0,1,0,0,6,11521,68.36
27899,1,0,0,1,0,0,2,32,3.72
27900,1,0,1,1,0,0,3,1352,17.01
27901,1,5,1,1,0,0,8,15186,83.84
27902,1,3,1,1,0,0,6,11521,68.36
27903,1,0,1,1,0,0,3,1352,17.01
27904,1,1,1,1,0,0,4,4966,36.77
27905,1,0,1,1,0,0,3,1352,17.01
27906,1,1,2,1,0,0,5,8690,54.42
27907,1,4,0,1,0,0,6,11521,68.36
27908,1,0,1,0,0,0,2,32,3.72
27909,1,0,1,1,2,0,5,8690,54.42
27910,1,0,2,1,0,0,4,4966,36.77
27911,1,4,0,1,0,0,6,11521,68.36
27912,1,0,1,1,3,0,6,11521,68.36
27913,1,1,0,1,0,0,3,1352,17.01
27914,1,1,1,1,0,0,4,4966,36.77
27915,1,1,1,1,0,0,4,4966,36.77
27916,1,4,0,1,0,0,6,11521,68.36
27917,1,1,0,1,0,0,3,1352,17.01
27918,1,1,0,1,0,0,3,1352,17.01
27919,1,1,0,1,0,0,3,1352,17.01
27920,1,0,1,1,0,0,3,1352,17.01
27921,1,1,1,1,0,0,4,4966,36.77
27922,1,0,1,1,0,0,3,1352,17.01
27923,1,0,2,1,0,0,4,4966,36.77
27924,1,0,0,1,0,0,2,32,3.72
27925,1,4,0,1,0,0,6,11521,68.36
27926,1,0,3,1,0,0,5,8690,54.42
27927,1,1,0,1,0,0,3,1352,17.01
27928,1,1,0,1,0,0,3,1352,17.01
27929,1,4,3,1,0,0,9,15950,87.44
27930,1,4,0,1,0,0,6,11521,68.36
27931,1,0,3,2,0,0,6,11521,68.36
27932,3,0,5,1,3,0,12,17186,93.28
27933,1,0,1,1,0,0,3,1352,17.01
27934,1,0,2,1,1,0,5,8690,54.42
27935,3,0,5,2,3,2,15,17888,96.85
27936,1,1,2,1,1,0,6,11521,68.36
27937,1,0,0,1,0,0,2,32,3.72
27938,3,0,5,1,1,0,10,16522,90.12
27939,1,4,0,1,2,0,8,15186,83.84
27940,1,0,2,1,0,0,4,4966,36.77
27941,1,2,1,1,0,0,5,8690,54.42
27942,1,0,1,1,0,0,3,1352,17.01
27943,1,0,1,1,0,0,3,1352,17.01
27944,1,2,1,1,0,0,5,8690,54.42
27945,1,0,0,1,0,0,2,32,3.72
27946,1,0,4,1,0,0,6,11521,68.36
27947,1,1,1,1,0,6,10,16522,90.12
27949,1,2,1,1,0,0,5,8690,54.42
27950,1,0,1,1,1,0,4,4966,36.77
27951,1,0,1,1,0,0,3,1352,17.01
27952,1,0,2,1,0,0,4,4966,36.77
27953,1,0,2,1,0,6,10,16522,90.12
27954,1,1,0,1,0,0,3,1352,17.01
27955,3,1,5,1,2,0,12,17186,93.28
27956,3,0,5,1,2,0,11,16947,91.91
27957,3,0,5,1,3,10,22,18498,99.73
27958,3,0,5,1,2,6,17,18193,98.23
27959,1,1,1,1,0,0,4,4966,36.77
27960,1,1,1,1,0,0,4,4966,36.77
27961,1,1,1,1,0,0,4,4966,36.77
27962,1,0,1,1,0,0,3,1352,17.01
27963,1,3,0,1,0,0,5,8690,54.42
27964,1,0,1,1,0,0,3,1352,17.01
27965,1,0,1,1,0,0,3,1352,17.01
27966,3,0,4,1,2,0,10,16522,90.12
27967,1,1,1,1,0,0,4,4966,36.77
27969,1,3,0,1,0,0,5,8690,54.42
27970,1,4,2,1,0,0,8,15186,83.84
27971,3,0,5,2,2,0,12,17186,93.28
27972,1,1,1,1,0,0,4,4966,36.77
27973,3,0,5,1,3,6,18,18287,98.68
27974,3,0,5,2,3,0,13,17456,94.66
27975,1,2,0,1,0,0,4,4966,36.77
27976,1,0,2,1,0,0,4,4966,36.77
27977,1,0,3,2,1,0,7,13868,78.23
27978,1,4,0,1,0,0,6,11521,68.36
27979,1,1,1,1,0,0,4,4966,36.77
27980,1,3,0,1,0,0,5,8690,54.42
27981,1,3,2,1,0,0,7,13868,78.23
27982,1,0,3,1,0,0,5,8690,54.42
27983,3,0,5,1,2,6,17,18193,98.23
27984,3,0,4,1,1,6,15,17888,96.85
27985,3,0,3,2,3,0,11,16947,91.91
27986,3,0,5,2,2,0,12,17186,93.28
27987,1,0,1,1,0,0,3,1352,17.01
27988,1,0,1,1,0,0,3,1352,17.01
27989,1,4,0,1,0,0,6,11521,68.36
27990,1,0,2,1,1,0,5,8690,54.42
27991,1,0,1,1,0,0,3,1352,17.01
27992,1,1,0,1,0,0,3,1352,17.01
27994,1,1,1,1,1,6,11,16947,91.91
27995,1,0,1,1,0,0,3,1352,17.01
27996,1,1,1,1,0,0,4,4966,36.77
27997,1,0,0,1,0,2,4,4966,36.77
27998,1,0,1,1,0,0,3,1352,17.01
27999,1,1,3,2,0,0,7,13868,78.23
28000,1,2,1,1,1,0,6,11521,68.36
28001,1,0,4,1,0,0,6,11521,68.36
28002,1,0,0,1,0,0,2,32,3.72
28003,1,3,1,1,0,0,6,11521,68.36
28004,1,4,0,1,0,0,6,11521,68.36
28005,1,1,0,1,0,0,3,1352,17.01
28006,3,0,2,1,2,6,14,17699,95.82
28007,1,4,0,1,0,0,6,11521,68.36
28008,1,2,1,1,0,0,5,8690,54.42
28009,1,0,1,1,0,0,3,1352,17.01
28010,1,0,1,1,0,2,5,8690,54.42
28011,1,0,1,1,0,0,3,1352,17.01
28012,3,0,5,2,3,0,13,17456,94.66
28013,1,5,3,1,0,0,10,16522,90.12
28014,1,1,3,1,0,0,6,11521,68.36
28015,3,4,4,2,1,0,14,17699,95.82
28016,1,0,3,1,1,4,10,16522,90.12
28017,1,4,4,4,0,0,13,17456,94.66
28018,3,0,5,1,2,6,17,18193,98.23
28019,1,0,0,1,0,0,2,32,3.72
28020,1,1,1,1,0,0,4,4966,36.77
28021,1,0,1,1,0,0,3,1352,17.01
28022,1,0,0,1,0,0,2,32,3.72
28023,1,0,1,1,0,0,3,1352,17.01
28024,1,1,1,1,0,4,8,15186,83.84
28025,1,2,0,1,0,0,4,4966,36.77
28026,1,3,0,1,0,0,5,8690,54.42
28027,1,3,0,1,0,0,5,8690,54.42
28028,1,0,1,1,0,0,3,1352,17.01
28029,1,0,1,1,0,0,3,1352,17.01
28030,1,0,3,2,3,0,9,15950,87.44
28031,1,0,2,1,0,0,4,4966,36.77
28032,1,1,1,1,0,0,4,4966,36.77
28033,1,0,2,1,0,0,4,4966,36.77
28034,1,2,1,1,0,6,11,16947,91.91
28035,1,3,0,1,0,0,5,8690,54.42
28036,1,4,1,1,0,0,7,13868,78.23
28037,1,0,1,1,0,0,3,1352,17.01
28038,1,1,0,1,0,0,3,1352,17.01
28039,1,3,1,1,0,6,12,17186,93.28
28040,1,0,3,1,0,10,15,17888,96.85
28041,1,1,0,1,0,0,3,1352,17.01
28042,1,2,0,1,0,0,4,4966,36.77
28043,1,4,1,1,0,0,7,13868,78.23
28044,1,2,0,1,0,0,4,4966,36.77
28045,1,1,2,1,0,0,5,8690,54.42
28046,1,0,2,1,0,0,4,4966,36.77
28047,1,0,1,1,0,0,3,1352,17.01
28048,1,0,1,1,0,0,3,1352,17.01
28049,1,1,2,1,0,0,5,8690,54.42
28050,1,0,1,1,1,4,8,15186,83.84
28051,1,1,2,1,0,0,5,8690,54.42
28052,1,2,1,1,0,0,5,8690,54.42
28053,1,4,1,1,0,0,7,13868,78.23
28054,1,0,2,1,1,0,5,8690,54.42
28055,1,0,0,1,0,6,8,15186,83.84
28056,1,1,3,1,0,0,6,11521,68.36
28057,1,1,1,1,1,0,5,8690,54.42
28058,1,1,1,1,0,0,4,4966,36.77
28059,1,1,1,1,0,0,4,4966,36.77
28060,1,4,0,1,0,0,6,11521,68.36
28062,1,1,1,1,0,0,4,4966,36.77
28063,1,0,0,1,0,10,12,17186,93.28
28064,1,4,0,1,0,0,6,11521,68.36
28065,1,1,1,1,0,0,4,4966,36.77
28066,1,0,2,1,0,0,4,4966,36.77
28067,1,1,1,1,0,0,4,4966,36.77
28068,1,0,0,0,0,0,1,1,0.08
28069,1,3,0,1,0,0,5,8690,54.42
28070,1,1,0,0,0,0,2,32,3.72
28071,1,0,0,1,0,0,2,32,3.72
28072,1,0,0,1,0,0,2,32,3.72
28073,1,2,1,1,0,0,5,8690,54.42
28074,3,0,3,1,1,0,8,15186,83.84
28075,1,1,1,1,0,0,4,4966,36.77
28076,1,1,0,1,0,0,3,1352,17.01
28077,1,1,1,1,0,0,4,4966,36.77
28078,1,1,1,1,0,0,4,4966,36.77
28079,1,2,1,1,0,0,5,8690,54.42
28080,1,3,1,1,0,0,6,11521,68.36
28081,1,0,1,1,0,0,3,1352,17.01
28082,1,1,1,1,0,0,4,4966,36.77
28083,1,1,3,2,1,0,8,15186,83.84
28084,1,1,3,1,1,0,7,13868,78.23
28085,1,4,0,1,0,0,6,11521,68.36
28086,1,3,2,2,0,0,8,15186,83.84
28087,3,0,5,1,2,0,11,16947,91.91
28088,1,2,2,1,0,0,6,11521,68.36
28089,1,0,1,1,0,0,3,1352,17.01
28090,1,0,2,1,1,0,5,8690,54.42
28091,1,3,0,1,0,0,5,8690,54.42
28092,1,4,0,1,0,0,6,11521,68.36
28093,1,0,2,1,0,0,4,4966,36.77
28094,1,1,1,1,0,2,6,11521,68.36
28095,1,1,0,1,0,0,3,1352,17.01
28096,1,0,1,1,0,0,3,1352,17.01
28097,1,0,0,1,0,0,2,32,3.72
28098,1,4,0,1,0,0,6,11521,68.36
28099,1,2,0,1,0,0,4,4966,36.77
28100,1,0,1,1,0,2,5,8690,54.42
28101,1,3,2,2,0,0,8,15186,83.84
28102,1,1,0,1,0,0,3,1352,17.01
28103,1,3,0,1,0,0,5,8690,54.42
28104,1,0,1,1,0,0,3,1352,17.01
28105,1,3,3,2,0,0,9,15950,87.44
28106,1,2,0,1,0,0,4,4966,36.77
28107,1,1,1,1,0,0,4,4966,36.77
28108,1,0,0,1,0,0,2,32,3.72
28109,1,0,1,1,0,0,3,1352,17.01
28110,1,5,0,1,0,0,7,13868,78.23
28111,1,0,0,1,0,0,2,32,3.72
28112,1,2,1,1,0,0,5,8690,54.42
28113,1,0,1,1,0,0,3,1352,17.01
28114,1,0,1,1,0,0,3,1352,17.01
28116,1,0,2,1,0,0,4,4966,36.77
28117,1,1,2,1,0,0,5,8690,54.42
28118,3,0,5,2,1,0,11,16947,91.91
28119,3,0,5,2,1,0,11,16947,91.91
28120,3,0,4,2,1,0,10,16522,90.12
28122,1,1,0,1,0,0,3,1352,17.01
28123,1,0,2,1,0,0,4,4966,36.77
28124,1,2,1,1,0,0,5,8690,54.42
28125,1,0,1,1,0,0,3,1352,17.01
28126,1,1,0,1,0,0,3,1352,17.01
28127,1,0,0,1,0,0,2,32,3.72
28128,1,0,1,1,0,0,3,1352,17.01
28129,1,1,1,1,0,0,4,4966,36.77
28130,1,0,2,1,1,0,5,8690,54.42
28131,1,0,1,1,0,2,5,8690,54.42
28132,1,3,1,1,0,0,6,11521,68.36
28133,1,1,2,1,0,0,5,8690,54.42
28134,3,0,5,1,3,0,12,17186,93.28
28135,1,0,1,1,0,0,3,1352,17.01
28136,3,1,5,1,2,0,12,17186,93.28
28137,3,0,5,1,2,0,11,16947,91.91
28138,1,0,1,1,0,2,5,8690,54.42
28140,1,0,2,1,0,0,4,4966,36.77
28141,1,1,1,1,0,0,4,4966,36.77
28142,1,4,0,1,0,0,6,11521,68.36
28143,1,1,1,1,0,0,4,4966,36.77
28144,1,4,0,1,0,0,6,11521,68.36
28145,1,0,2,1,0,0,4,4966,36.77
28146,1,1,2,1,0,0,5,8690,54.42
28147,1,1,1,1,0,0,4,4966,36.77
28148,3,0,5,1,3,0,12,17186,93.28
28149,3,1,5,1,3,0,13,17456,94.66
28150,3,0,5,1,3,0,12,17186,93.28
28151,1,0,1,1,0,0,3,1352,17.01
28152,1,2,1,1,0,2,7,13868,78.23
28153,1,1,1,1,0,0,4,4966,36.77
28154,1,1,1,1,0,0,4,4966,36.77
28155,1,2,1,1,0,0,5,8690,54.42
28156,1,3,0,1,0,0,5,8690,54.42
28157,1,2,0,1,0,0,4,4966,36.77
28158,1,1,1,1,0,0,4,4966,36.77
28159,1,0,0,1,0,0,2,32,3.72
28160,1,1,2,1,1,0,6,11521,68.36
28161,1,0,2,1,0,0,4,4966,36.77
28162,1,1,0,1,0,0,3,1352,17.01
28163,1,0,0,1,0,0,2,32,3.72
28164,3,1,5,4,5,0,18,18287,98.68
28165,3,5,1,4,3,0,16,18081,97.67
28166,1,1,1,1,0,0,4,4966,36.77
28167,1,0,1,1,0,0,3,1352,17.01
28168,1,1,1,1,0,0,4,4966,36.77
28169,1,0,1,1,0,0,3,1352,17.01
28170,1,0,0,1,0,0,2,32,3.72
28171,1,2,1,1,0,0,5,8690,54.42
28172,1,2,1,1,0,0,5,8690,54.42
28173,1,1,1,1,0,0,4,4966,36.77
28174,1,1,1,1,0,0,4,4966,36.77
28175,1,3,3,1,0,0,8,15186,83.84
28176,3,3,5,4,4,0,19,18362,99.04
28177,1,1,1,1,0,0,4,4966,36.77
28178,1,2,0,1,0,0,4,4966,36.77
28179,1,0,0,1,0,0,2,32,3.72
28180,1,1,0,1,0,0,3,1352,17.01
28181,1,3,1,1,0,0,6,11521,68.36
28182,1,4,3,1,0,0,9,15950,87.44
28183,1,0,1,1,0,0,3,1352,17.01
28184,1,0,3,1,0,0,5,8690,54.42
28185,1,0,1,1,0,0,3,1352,17.01
28186,1,1,1,1,0,0,4,4966,36.77
28187,1,1,0,1,0,0,3,1352,17.01
28188,1,0,1,1,0,0,3,1352,17.01
28189,1,0,1,1,0,0,3,1352,17.01
28190,1,0,1,1,0,0,3,1352,17.01
28191,1,3,1,1,0,0,6,11521,68.36
28192,1,5,2,2,0,0,10,16522,90.12
28193,1,0,3,1,0,0,5,8690,54.42
28194,1,0,3,1,0,0,5,8690,54.42
28195,1,1,2,1,0,0,5,8690,54.42
28196,1,0,1,1,0,6,9,15950,87.44
28197,1,3,3,1,0,0,8,15186,83.84
28198,3,2,5,4,3,0,17,18193,98.23
28199,3,0,5,1,3,0,12,17186,93.28
28200,1,1,1,1,0,0,4,4966,36.77
28201,1,1,0,1,0,0,3,1352,17.01
28202,1,0,1,1,0,6,9,15950,87.44
28203,1,2,0,1,0,0,4,4966,36.77
28204,1,0,2,1,0,0,4,4966,36.77
28205,1,0,2,1,0,0,4,4966,36.77
28206,3,0,5,1,3,0,12,17186,93.28
28207,3,0,5,1,3,6,18,18287,98.68
28208,1,0,4,1,1,0,7,13868,78.23
28209,1,2,0,1,0,0,4,4966,36.77
28210,1,4,0,1,0,0,6,11521,68.36
28211,1,3,1,1,0,0,6,11521,68.36
28212,1,0,1,1,0,0,3,1352,17.01
28213,1,0,1,1,0,0,3,1352,17.01
28214,1,0,3,1,0,0,5,8690,54.42
28215,1,1,1,1,1,0,5,8690,54.42
28216,1,0,1,1,0,2,5,8690,54.42
28217,1,0,1,1,0,0,3,1352,17.01
28218,1,0,1,1,0,0,3,1352,17.01
28219,1,1,1,1,0,0,4,4966,36.77
28220,1,0,1,1,0,0,3,1352,17.01
28221,1,1,1,1,0,0,4,4966,36.77
28222,1,0,3,2,0,0,6,11521,68.36
28223,1,1,4,2,0,0,8,15186,83.84
28224,3,1,4,1,1,0,10,16522,90.12
28225,1,0,2,1,0,0,4,4966,36.77
28226,3,0,5,1,1,0,10,16522,90.12
28227,1,1,1,1,0,0,4,4966,36.77
28228,1,2,0,1,0,0,4,4966,36.77
28229,1,0,1,1,0,6,9,15950,87.44
28230,1,2,0,1,0,0,4,4966,36.77
28231,1,1,2,1,0,0,5,8690,54.42
28232,1,0,0,1,0,0,2,32,3.72
28233,1,1,0,1,0,0,3,1352,17.01
28234,1,0,0,1,0,0,2,32,3.72
28235,1,1,0,1,0,0,3,1352,17.01
28236,3,1,5,4,3,0,16,18081,97.67
28237,1,0,0,1,0,6,8,15186,83.84
28238,1,2,1,1,0,0,5,8690,54.42
28239,1,1,1,1,0,0,4,4966,36.77
28240,1,0,1,1,0,0,3,1352,17.01
28241,1,2,0,1,0,0,4,4966,36.77
28242,1,0,0,1,0,0,2,32,3.72
28243,1,1,1,1,0,0,4,4966,36.77
28244,1,4,1,1,0,0,7,13868,78.23
28245,1,4,0,1,0,0,6,11521,68.36
28246,1,1,1,1,0,0,4,4966,36.77
28247,1,4,1,1,0,0,7,13868,78.23
28248,1,1,1,1,0,6,10,16522,90.12
28249,1,0,2,1,0,0,4,4966,36.77
28250,1,0,2,1,0,0,4,4966,36.77
28251,1,2,1,1,0,0,5,8690,54.42
28252,1,1,2,1,0,0,5,8690,54.42
28253,1,4,4,2,0,0,11,16947,91.91
28254,1,2,1,1,0,0,5,8690,54.42
28255,1,1,1,1,0,0,4,4966,36.77
28256,1,1,4,2,3,0,11,16947,91.91
28257,1,2,1,1,0,0,5,8690,54.42
28258,1,0,1,1,0,0,3,1352,17.01
28259,1,1,0,1,0,0,3,1352,17.01
28260,1,1,0,1,0,0,3,1352,17.01
28261,1,1,1,1,0,0,4,4966,36.77
28262,1,1,1,1,0,0,4,4966,36.77
28263,1,0,0,1,0,0,2,32,3.72
28264,1,0,0,1,0,10,12,17186,93.28
28265,1,4,2,1,0,0,8,15186,83.84
28266,3,0,5,1,0,0,9,15950,87.44
28267,1,0,2,1,0,0,4,4966,36.77
28268,1,0,1,1,0,0,3,1352,17.01
28269,1,5,0,1,0,0,7,13868,78.23
28270,3,1,5,1,3,6,19,18362,99.04
28271,1,0,1,1,0,0,3,1352,17.01
28272,1,0,0,1,0,0,2,32,3.72
28273,1,0,3,1,0,0,5,8690,54.42
28274,1,2,1,1,0,0,5,8690,54.42
28275,1,0,1,1,0,0,3,1352,17.01
28276,1,2,0,1,0,0,4,4966,36.77
28277,1,1,2,1,0,0,5,8690,54.42
28278,1,0,0,1,0,0,2,32,3.72
28279,1,0,1,1,0,0,3,1352,17.01
28280,1,5,1,1,0,0,8,15186,83.84
28281,1,4,1,1,0,0,7,13868,78.23
28282,1,0,1,1,0,0,3,1352,17.01
28283,1,0,1,1,0,0,3,1352,17.01
28284,1,1,1,1,0,6,10,16522,90.12
28285,1,2,0,1,0,0,4,4966,36.77
28286,1,2,1,1,0,0,5,8690,54.42
28287,1,1,1,1,0,0,4,4966,36.77
28288,1,4,1,1,0,0,7,13868,78.23
28289,1,0,1,1,0,0,3,1352,17.01
28290,1,4,0,1,0,0,6,11521,68.36
28291,1,0,0,1,0,0,2,32,3.72
28292,3,0,4,1,2,4,14,17699,95.82
28293,3,0,5,2,1,0,11,16947,91.91
28294,3,0,5,2,5,0,15,17888,96.85
28295,3,0,5,2,1,0,11,16947,91.91
28296,3,0,4,2,1,0,10,16522,90.12
28297,1,4,0,1,0,0,6,11521,68.36
28298,1,1,2,1,0,4,9,15950,87.44
28299,1,0,0,1,0,0,2,32,3.72
28300,1,0,4,1,0,0,6,11521,68.36
28301,1,2,1,1,0,0,5,8690,54.42
28302,1,1,1,1,0,6,10,16522,90.12
28303,1,0,1,1,0,0,3,1352,17.01
28304,1,5,0,2,0,0,8,15186,83.84
28305,1,0,1,1,0,0,3,1352,17.01
28306,1,0,1,1,0,0,3,1352,17.01
28307,1,1,0,1,0,0,3,1352,17.01
28308,3,2,4,5,1,0,15,17888,96.85
28309,3,0,4,1,4,0,12,17186,93.28
28310,1,4,1,1,0,0,7,13868,78.23
28311,1,0,3,2,1,0,7,13868,78.23
28312,1,0,3,2,1,4,11,16947,91.91
28313,1,2,0,1,0,0,4,4966,36.77
28314,1,0,1,1,0,0,3,1352,17.01
28315,1,4,1,1,0,0,7,13868,78.23
28316,1,1,1,1,0,0,4,4966,36.77
28317,1,0,0,1,0,0,2,32,3.72
28318,1,0,1,1,0,0,3,1352,17.01
28319,1,2,0,1,0,0,4,4966,36.77
28320,1,1,0,1,0,0,3,1352,17.01
28321,1,1,2,1,0,0,5,8690,54.42
28322,1,0,1,1,0,0,3,1352,17.01
28323,1,4,3,1,0,0,9,15950,87.44
28325,1,0,3,1,3,0,8,15186,83.84
28326,1,5,3,1,0,0,10,16522,90.12
28327,1,0,3,1,0,0,5,8690,54.42
28328,1,0,3,1,0,6,11,16947,91.91
28329,1,2,0,1,0,0,4,4966,36.77
28330,1,0,3,2,1,0,7,13868,78.23
28331,1,0,1,1,0,0,3,1352,17.01
28332,1,0,4,2,0,0,7,13868,78.23
28333,1,3,1,1,0,0,6,11521,68.36
28334,1,1,1,1,0,0,4,4966,36.77
28335,1,4,0,1,0,0,6,11521,68.36
28336,1,1,0,1,0,0,3,1352,17.01
28337,1,3,1,1,3,0,9,15950,87.44
28341,1,4,4,1,0,0,10,16522,90.12
28342,1,1,1,1,0,4,8,15186,83.84
28343,1,0,2,1,0,4,8,15186,83.84
28344,1,5,2,1,0,0,9,15950,87.44
28345,3,0,4,1,3,8,19,18362,99.04
28346,1,0,0,1,0,0,2,32,3.72
28347,1,2,1,1,0,0,5,8690,54.42
28348,1,4,1,1,0,0,7,13868,78.23
28349,1,0,2,1,0,0,4,4966,36.77
28350,1,2,0,1,0,0,4,4966,36.77
28351,1,0,1,1,0,6,9,15950,87.44
28352,1,0,1,1,0,0,3,1352,17.01
28353,3,0,5,2,2,0,12,17186,93.28
28354,3,0,5,2,1,0,11,16947,91.91
28355,1,0,1,1,0,0,3,1352,17.01
28356,1,1,1,1,0,0,4,4966,36.77
28357,1,1,1,1,0,0,4,4966,36.77
28358,1,0,1,1,0,0,3,1352,17.01
28359,1,2,1,1,0,0,5,8690,54.42
28360,1,4,0,1,0,0,6,11521,68.36
28361,1,1,2,1,0,0,5,8690,54.42
28362,1,2,0,1,0,0,4,4966,36.77
28364,1,0,0,1,0,0,2,32,3.72
28365,1,0,2,1,0,10,14,17699,95.82
28366,1,0,1,1,1,6,10,16522,90.12
28367,3,0,5,1,0,0,9,15950,87.44
28368,1,0,3,1,0,0,5,8690,54.42
28369,1,2,3,1,0,0,7,13868,78.23
28370,3,0,5,5,5,0,18,18287,98.68
28371,3,1,5,1,2,0,12,17186,93.28
28372,3,0,5,1,2,0,11,16947,91.91
28373,1,1,2,1,0,0,5,8690,54.42
28374,1,3,3,1,0,0,8,15186,83.84
28375,1,3,0,1,0,0,5,8690,54.42
28376,1,0,1,1,0,0,3,1352,17.01
28377,1,0,3,2,0,0,6,11521,68.36
28378,1,1,0,1,0,0,3,1352,17.01
28379,1,0,2,1,0,0,4,4966,36.77
28380,1,0,2,1,0,0,4,4966,36.77
28381,3,0,5,1,3,4,16,18081,97.67
28382,1,4,2,1,0,0,8,15186,83.84
28383,1,0,0,1,0,0,2,32,3.72
28384,1,0,1,1,0,0,3,1352,17.01
28385,1,4,3,1,0,0,9,15950,87.44
28386,1,0,1,1,0,0,3,1352,17.01
28387,1,4,0,1,0,0,6,11521,68.36
28388,1,0,2,1,0,0,4,4966,36.77
28389,1,2,2,2,0,0,7,13868,78.23
28390,1,1,2,1,0,4,9,15950,87.44
28391,1,1,1,1,0,4,8,15186,83.84
28392,1,2,0,1,0,0,4,4966,36.77
28393,1,0,3,2,2,0,8,15186,83.84
28394,1,2,2,1,0,0,6,11521,68.36
28395,1,0,2,1,0,0,4,4966,36.77
28396,1,0,1,1,0,0,3,1352,17.01
28397,1,0,1,1,0,0,3,1352,17.01
28398,1,2,3,2,0,0,8,15186,83.84
28399,1,3,2,2,0,0,8,15186,83.84
28400,1,2,1,1,0,0,5,8690,54.42
28401,1,0,2,1,0,0,4,4966,36.77
28402,1,1,1,1,0,0,4,4966,36.77
28403,1,0,2,1,0,0,4,4966,36.77
28404,1,1,1,1,0,2,6,11521,68.36
28405,1,0,4,1,0,0,6,11521,68.36
28406,1,0,1,1,0,0,3,1352,17.01
28407,1,0,1,1,0,0,3,1352,17.01
28408,1,4,2,1,1,0,9,15950,87.44
28409,1,0,2,1,0,0,4,4966,36.77
28410,1,2,3,2,1,0,9,15950,87.44
28411,1,3,1,1,0,0,6,11521,68.36
28412,1,0,1,1,0,0,3,1352,17.01
28413,1,0,0,1,0,0,2,32,3.72
28414,1,1,1,1,0,0,4,4966,36.77
28415,1,0,1,1,0,0,3,1352,17.01
28416,1,0,0,1,0,0,2,32,3.72
28417,1,3,0,1,0,0,5,8690,54.42
28418,1,1,0,1,0,0,3,1352,17.01
28419,1,0,0,1,0,0,2,32,3.72
28420,1,0,3,1,2,0,7,13868,78.23
28421,1,4,2,2,0,0,9,15950,87.44
28422,1,1,1,1,0,0,4,4966,36.77
28423,1,2,0,1,0,0,4,4966,36.77
28424,3,0,5,1,2,0,11,16947,91.91
28425,1,4,2,1,0,0,8,15186,83.84
28426,3,0,5,1,3,0,12,17186,93.28
28427,1,4,0,1,0,0,6,11521,68.36
28428,1,3,0,1,0,0,5,8690,54.42
28429,3,0,5,1,3,6,18,18287,98.68
28430,1,0,0,1,0,0,2,32,3.72
28431,1,0,4,1,0,0,6,11521,68.36
28432,1,0,3,1,0,0,5,8690,54.42
28433,1,0,0,1,0,0,2,32,3.72
28434,1,0,2,1,0,0,4,4966,36.77
28435,1,0,4,2,3,4,14,17699,95.82
28436,1,2,0,1,0,0,4,4966,36.77
28437,1,1,0,1,0,0,3,1352,17.01
28438,1,0,5,1,2,0,9,15950,87.44
28439,1,0,4,1,1,0,7,13868,78.23
28440,1,1,2,1,0,0,5,8690,54.42
28441,3,0,5,1,3,6,18,18287,98.68
28442,1,1,3,1,2,0,8,15186,83.84
28443,1,0,3,1,2,4,11,16947,91.91
28444,1,0,2,1,0,0,4,4966,36.77
28445,1,0,4,1,2,0,8,15186,83.84
28446,1,1,1,1,0,0,4,4966,36.77
28447,1,0,1,1,0,0,3,1352,17.01
28448,1,0,1,1,0,0,3,1352,17.01
28449,1,0,2,1,0,0,4,4966,36.77
28450,1,4,0,0,0,0,5,8690,54.42
28451,1,0,1,1,0,0,3,1352,17.01
28452,1,2,1,1,0,0,5,8690,54.42
28453,1,0,2,1,0,4,8,15186,83.84
28454,1,0,2,1,1,0,5,8690,54.42
28455,1,0,2,1,0,0,4,4966,36.77
28456,1,1,1,1,0,0,4,4966,36.77
28457,1,4,1,1,0,0,7,13868,78.23
28458,1,0,1,1,0,0,3,1352,17.01
28459,1,0,0,1,0,0,2,32,3.72
28461,1,0,2,2,3,0,8,15186,83.84
28462,1,4,4,2,0,0,11,16947,91.91
28463,1,4,1,1,0,0,7,13868,78.23
28464,1,0,1,1,0,2,5,8690,54.42
28465,1,1,1,1,0,0,4,4966,36.77
28466,1,1,1,1,0,0,4,4966,36.77
28467,1,0,0,1,0,0,2,32,3.72
28468,3,0,5,2,1,0,11,16947,91.91
28469,1,4,3,4,4,0,16,18081,97.67
28470,1,0,2,1,1,6,11,16947,91.91
28471,3,1,1,1,3,0,9,15950,87.44
28472,1,2,1,1,0,4,9,15950,87.44
28473,3,2,5,4,3,0,17,18193,98.23
28474,3,0,5,2,1,0,11,16947,91.91
28475,1,3,0,0,0,0,4,4966,36.77
28476,1,3,2,1,0,0,7,13868,78.23
28477,1,0,1,1,0,0,3,1352,17.01
28478,1,0,1,1,0,0,3,1352,17.01
28479,1,2,0,1,0,0,4,4966,36.77
28480,1,0,5,1,0,0,7,13868,78.23
28481,1,0,0,1,0,0,2,32,3.72
28482,1,3,0,1,0,0,5,8690,54.42
28483,1,2,2,1,0,0,6,11521,68.36
28484,1,0,4,1,2,0,8,15186,83.84
28485,1,1,4,1,2,0,9,15950,87.44
28486,3,4,5,5,0,0,17,18193,98.23
28487,1,1,1,1,0,0,4,4966,36.77
28488,1,2,0,1,0,0,4,4966,36.77
28489,1,1,0,1,0,0,3,1352,17.01
28490,1,1,1,1,0,0,4,4966,36.77
28491,1,3,1,1,0,0,6,11521,68.36
28492,1,4,1,1,0,0,7,13868,78.23
28493,1,3,1,1,0,0,6,11521,68.36
28494,1,1,0,1,0,0,3,1352,17.01
28495,1,4,0,1,0,0,6,11521,68.36
28496,1,0,1,1,0,0,3,1352,17.01
28497,1,0,0,1,0,2,4,4966,36.77
28498,1,4,0,1,0,0,6,11521,68.36
28499,1,0,2,1,0,0,4,4966,36.77
28500,1,1,2,1,0,0,5,8690,54.42
28501,1,1,1,1,0,0,4,4966,36.77
28502,1,0,1,1,0,0,3,1352,17.01
28503,1,1,0,1,0,0,3,1352,17.01
28504,1,4,0,1,0,0,6,11521,68.36
28505,1,0,1,1,0,0,3,1352,17.01
28506,1,0,1,1,0,4,7,13868,78.23
28507,1,4,0,1,0,0,6,11521,68.36
28508,1,0,1,1,0,0,3,1352,17.01
28509,1,1,0,1,0,0,3,1352,17.01
28510,1,0,1,1,0,0,3,1352,17.01
28511,1,1,1,1,0,0,4,4966,36.77
28512,1,0,1,1,0,0,3,1352,17.01
28513,1,2,1,1,0,0,5,8690,54.42
28514,1,3,1,1,0,0,6,11521,68.36
28515,1,3,0,1,2,0,7,13868,78.23
28516,1,1,0,1,0,0,3,1352,17.01
28517,1,0,1,1,0,0,3,1352,17.01
28518,1,1,0,1,0,0,3,1352,17.01
28519,1,0,1,1,0,2,5,8690,54.42
28520,1,1,1,1,0,0,4,4966,36.77
28521,1,1,1,1,0,0,4,4966,36.77
28522,1,0,1,1,0,0,3,1352,17.01
28523,1,0,3,1,0,0,5,8690,54.42
28524,1,3,0,1,0,0,5,8690,54.42
28525,1,2,0,1,0,0,4,4966,36.77
28526,1,1,0,0,0,0,2,32,3.72
28527,1,1,0,1,0,0,3,1352,17.01
28528,1,2,1,1,0,0,5,8690,54.42
28529,1,4,2,1,0,0,8,15186,83.84
28530,3,0,5,2,1,0,11,16947,91.91
28531,3,0,4,2,1,0,10,16522,90.12
28532,1,0,1,1,0,0,3,1352,17.01
28533,3,0,5,2,2,0,12,17186,93.28
28534,3,0,5,2,1,0,11,16947,91.91
28535,1,3,0,1,0,0,5,8690,54.42
28536,1,1,0,1,0,6,9,15950,87.44
28537,1,0,1,1,0,0,3,1352,17.01
28538,1,2,0,1,0,0,4,4966,36.77
28539,1,4,1,1,0,0,7,13868,78.23
28540,1,2,1,1,0,0,5,8690,54.42
28541,1,1,2,1,0,0,5,8690,54.42
28542,3,1,5,1,1,0,11,16947,91.91
28543,1,4,0,1,0,0,6,11521,68.36
28544,1,0,4,1,0,0,6,11521,68.36
28545,3,2,4,5,2,0,16,18081,97.67
28546,1,0,1,1,0,0,3,1352,17.01
28547,1,4,1,1,0,0,7,13868,78.23
28548,1,2,0,1,0,0,4,4966,36.77
28549,1,0,3,1,0,0,5,8690,54.42
28550,1,2,1,1,0,0,5,8690,54.42
28551,1,1,1,1,0,0,4,4966,36.77
28552,1,0,2,1,0,0,4,4966,36.77
28554,1,1,0,1,0,0,3,1352,17.01
28555,1,0,0,1,0,6,8,15186,83.84
28556,1,0,3,1,0,0,5,8690,54.42
28557,1,2,0,1,0,0,4,4966,36.77
28558,1,1,2,1,0,0,5,8690,54.42
28559,1,2,0,1,0,0,4,4966,36.77
28560,1,1,0,1,0,0,3,1352,17.01
28561,1,0,1,1,0,0,3,1352,17.01
28562,1,0,0,1,0,0,2,32,3.72
28563,1,2,1,1,0,0,5,8690,54.42
28564,1,1,2,1,0,0,5,8690,54.42
28565,1,3,1,1,0,0,6,11521,68.36
28566,1,2,1,1,0,0,5,8690,54.42
28567,1,0,2,1,0,0,4,4966,36.77
28568,1,4,1,1,0,0,7,13868,78.23
28569,1,0,2,1,0,0,4,4966,36.77
28570,1,1,1,2,1,0,6,11521,68.36
28571,3,0,5,1,1,6,16,18081,97.67
28572,1,0,1,1,0,0,3,1352,17.01
28573,1,2,0,1,0,0,4,4966,36.77
28574,1,3,0,1,0,0,5,8690,54.42
28575,1,0,3,1,1,0,6,11521,68.36
28576,1,1,1,1,0,0,4,4966,36.77
28577,1,0,0,1,0,0,2,32,3.72
28578,1,2,2,1,0,0,6,11521,68.36
28579,1,0,1,1,0,0,3,1352,17.01
28580,1,0,0,1,0,0,2,32,3.72
28581,1,0,3,1,2,0,7,13868,78.23
28582,1,0,3,1,0,0,5,8690,54.42
28583,3,0,5,2,3,0,13,17456,94.66
28584,1,1,0,1,0,0,3,1352,17.01
28585,1,0,0,1,0,0,2,32,3.72
28586,1,1,1,1,0,0,4,4966,36.77
28587,1,0,0,1,0,0,2,32,3.72
28588,1,0,0,1,0,0,2,32,3.72
28589,1,0,1,1,0,0,3,1352,17.01
28590,1,0,1,1,0,0,3,1352,17.01
28591,1,3,0,1,0,0,5,8690,54.42
28592,1,2,0,1,0,0,4,4966,36.77
28593,1,1,2,1,0,0,5,8690,54.42
28594,1,2,0,1,0,0,4,4966,36.77
28595,1,0,1,1,0,0,3,1352,17.01
28596,1,0,3,1,0,0,5,8690,54.42
28597,1,0,1,1,0,0,3,1352,17.01
28598,3,0,5,1,3,6,18,18287,98.68
28599,3,0,5,1,2,0,11,16947,91.91
28600,3,1,5,1,3,0,13,17456,94.66
28601,1,0,1,1,0,0,3,1352,17.01
28602,3,0,5,1,3,0,12,17186,93.28
28603,3,0,5,1,5,0,14,17699,95.82
28604,1,2,1,1,0,0,5,8690,54.42
28605,1,1,0,1,0,0,3,1352,17.01
28606,1,1,1,1,0,0,4,4966,36.77
28607,1,1,1,1,0,0,4,4966,36.77
28608,3,0,5,1,2,0,11,16947,91.91
28609,1,1,2,1,0,0,5,8690,54.42
28610,1,1,0,1,0,0,3,1352,17.01
28611,1,2,2,1,0,0,6,11521,68.36
28612,1,1,0,1,0,0,3,1352,17.01
28613,1,0,3,1,0,0,5,8690,54.42
28614,1,4,0,1,0,0,6,11521,68.36
28615,1,2,0,1,0,0,4,4966,36.77
28616,1,1,1,1,0,4,8,15186,83.84
28617,1,1,0,1,0,0,3,1352,17.01
28618,1,2,2,1,0,0,6,11521,68.36
28619,1,4,0,1,0,0,6,11521,68.36
28620,1,3,1,1,0,0,6,11521,68.36
28621,1,2,0,1,0,0,4,4966,36.77
28622,1,1,0,1,0,0,3,1352,17.01
28623,1,4,0,1,0,0,6,11521,68.36
28624,1,1,2,1,0,0,5,8690,54.42
28625,1,0,4,1,0,0,6,11521,68.36
28626,1,3,2,1,0,0,7,13868,78.23
28627,1,0,3,1,1,0,6,11521,68.36
28628,1,2,1,1,0,0,5,8690,54.42
28629,1,0,1,1,0,0,3,1352,17.01
28630,1,0,0,1,0,0,2,32,3.72
28631,1,1,0,1,1,0,4,4966,36.77
28632,1,1,0,1,0,6,9,15950,87.44
28633,1,0,0,1,0,0,2,32,3.72
28634,1,2,0,1,0,0,4,4966,36.77
28635,1,2,2,1,0,0,6,11521,68.36
28636,1,2,0,1,0,0,4,4966,36.77
28637,1,4,2,1,0,0,8,15186,83.84
28638,1,2,2,1,0,0,6,11521,68.36
28639,1,2,1,1,0,0,5,8690,54.42
28640,1,0,1,1,0,0,3,1352,17.01
28641,1,2,2,1,0,0,6,11521,68.36
28642,1,1,0,1,0,0,3,1352,17.01
28643,1,1,1,1,0,0,4,4966,36.77
28644,1,0,0,1,0,0,2,32,3.72
28645,1,2,0,1,0,0,4,4966,36.77
28646,1,0,0,1,0,0,2,32,3.72
28647,1,0,0,1,0,0,2,32,3.72
28648,1,3,1,1,0,0,6,11521,68.36
28649,1,1,0,0,0,0,2,32,3.72
28650,1,0,2,1,0,0,4,4966,36.77
28651,1,0,3,1,1,0,6,11521,68.36
28652,1,1,1,1,0,0,4,4966,36.77
28653,1,3,0,1,0,0,5,8690,54.42
28654,1,4,0,1,0,0,6,11521,68.36
28655,1,0,3,1,2,4,11,16947,91.91
28656,1,1,1,1,0,0,4,4966,36.77
28657,1,0,0,1,0,4,6,11521,68.36
28658,4,0,5,1,3,4,17,18193,98.23
28659,1,1,4,2,0,0,8,15186,83.84
28660,1,1,2,1,0,0,5,8690,54.42
28661,1,0,3,1,0,0,5,8690,54.42
28662,3,0,5,1,0,0,9,15950,87.44
28663,1,4,3,1,0,0,9,15950,87.44
28664,1,2,0,1,0,0,4,4966,36.77
28665,1,2,0,1,0,0,4,4966,36.77
28666,1,4,1,1,0,0,7,13868,78.23
28667,1,0,1,1,0,0,3,1352,17.01
28668,1,4,0,1,0,0,6,11521,68.36
28669,1,0,3,2,1,0,7,13868,78.23
28670,1,0,2,1,0,0,4,4966,36.77
28671,1,3,1,1,0,0,6,11521,68.36
28672,1,1,2,1,0,0,5,8690,54.42
28673,1,2,0,1,0,0,4,4966,36.77
28674,1,3,0,1,0,0,5,8690,54.42
28675,1,0,1,1,0,0,3,1352,17.01
28676,3,2,3,2,3,0,13,17456,94.66
28677,3,4,5,2,1,0,15,17888,96.85
28678,1,1,2,1,0,0,5,8690,54.42
28679,3,0,3,2,3,0,11,16947,91.91
28680,1,0,0,1,0,0,2,32,3.72
28681,1,0,1,1,0,0,3,1352,17.01
28682,1,0,1,1,0,0,3,1352,17.01
28683,1,1,1,1,0,0,4,4966,36.77
28684,1,0,0,1,0,6,8,15186,83.84
28685,1,2,1,1,0,0,5,8690,54.42
28686,1,1,0,1,0,0,3,1352,17.01
28687,3,0,5,2,2,0,12,17186,93.28
28688,1,3,1,1,0,6,12,17186,93.28
28689,1,3,1,1,0,0,6,11521,68.36
28690,3,0,4,2,2,0,11,16947,91.91
28691,3,0,5,2,1,0,11,16947,91.91
28692,1,4,0,1,0,0,6,11521,68.36
28693,1,0,1,1,0,0,3,1352,17.01
28694,1,0,3,1,1,0,6,11521,68.36
28695,1,3,0,1,0,0,5,8690,54.42
28696,1,0,1,1,0,2,5,8690,54.42
28697,1,0,1,1,0,0,3,1352,17.01
28698,1,0,1,1,0,6,9,15950,87.44
28699,1,2,1,1,0,0,5,8690,54.42
28700,1,2,1,1,0,0,5,8690,54.42
28701,1,1,1,1,0,0,4,4966,36.77
28702,1,1,2,1,0,0,5,8690,54.42
28703,1,2,2,1,1,0,7,13868,78.23
28704,1,2,3,1,0,2,9,15950,87.44
28705,1,0,5,1,0,0,7,13868,78.23
28706,1,0,2,1,0,0,4,4966,36.77
28707,1,1,2,1,0,0,5,8690,54.42
28708,1,3,3,1,0,0,8,15186,83.84
28709,1,1,1,1,0,0,4,4966,36.77
28710,1,0,0,1,0,0,2,32,3.72
28711,1,0,1,1,0,0,3,1352,17.01
28712,1,1,1,1,0,0,4,4966,36.77
28713,1,2,0,1,0,0,4,4966,36.77
28714,1,0,1,1,0,0,3,1352,17.01
28715,1,0,1,1,0,0,3,1352,17.01
28716,1,0,3,1,0,0,5,8690,54.42
28717,1,2,1,1,0,0,5,8690,54.42
28718,1,2,2,1,0,0,6,11521,68.36
28719,1,1,2,1,0,0,5,8690,54.42
28720,3,0,5,1,2,6,17,18193,98.23
28721,1,1,1,1,0,0,4,4966,36.77
28722,1,0,1,1,0,0,3,1352,17.01
28723,1,1,1,1,0,0,4,4966,36.77
28724,1,4,0,1,0,0,6,11521,68.36
28725,1,0,1,1,0,0,3,1352,17.01
28726,1,1,1,1,0,0,4,4966,36.77
28727,1,1,0,1,0,0,3,1352,17.01
28728,1,2,2,1,0,0,6,11521,68.36
28729,1,0,2,1,0,4,8,15186,83.84
28730,3,0,5,1,2,6,17,18193,98.23
28731,3,1,5,2,3,0,14,17699,95.82
28732,3,0,5,1,1,6,16,18081,97.67
28733,3,0,5,1,1,0,10,16522,90.12
28734,1,0,1,1,0,0,3,1352,17.01
28735,1,2,0,1,0,0,4,4966,36.77
28736,1,0,0,1,0,0,2,32,3.72
28737,1,1,1,1,0,0,4,4966,36.77
28738,1,1,1,1,0,0,4,4966,36.77
28739,1,0,3,1,1,0,6,11521,68.36
28740,1,0,1,1,0,0,3,1352,17.01
28741,1,3,0,1,0,0,5,8690,54.42
28742,1,2,0,1,0,0,4,4966,36.77
28743,1,3,0,1,0,0,5,8690,54.42
28744,1,1,2,1,0,0,5,8690,54.42
28745,1,2,1,2,0,0,6,11521,68.36
28746,1,1,1,1,0,0,4,4966,36.77
28747,3,0,5,1,3,0,12,17186,93.28
28748,3,1,5,1,3,0,13,17456,94.66
28749,1,3,1,1,0,0,6,11521,68.36
28750,1,2,1,1,0,0,5,8690,54.42
28751,1,1,0,1,0,0,3,1352,17.01
28752,1,2,1,1,0,0,5,8690,54.42
28753,1,2,0,1,0,0,4,4966,36.77
28754,1,2,0,1,0,0,4,4966,36.77
28755,1,1,1,1,0,0,4,4966,36.77
28756,1,1,1,1,0,0,4,4966,36.77
28757,1,2,0,1,0,0,4,4966,36.77
28758,1,2,1,1,0,0,5,8690,54.42
28759,3,0,5,5,5,0,18,18287,98.68
28760,1,0,1,1,0,6,9,15950,87.44
28761,3,0,5,1,4,0,13,17456,94.66
28762,1,0,1,1,0,0,3,1352,17.01
28763,1,0,1,1,0,0,3,1352,17.01
28764,1,4,1,1,0,0,7,13868,78.23
28765,1,2,1,1,0,0,5,8690,54.42
28766,1,1,2,1,0,0,5,8690,54.42
28767,1,0,0,1,0,0,2,32,3.72
28768,1,2,1,1,0,0,5,8690,54.42
28769,1,0,1,1,0,0,3,1352,17.01
28770,1,3,0,1,0,0,5,8690,54.42
28771,1,1,0,1,0,0,3,1352,17.01
28772,1,2,1,1,0,0,5,8690,54.42
28773,1,0,2,1,0,0,4,4966,36.77
28774,1,0,3,1,0,0,5,8690,54.42
28775,1,2,1,1,0,0,5,8690,54.42
28776,1,0,0,1,1,6,9,15950,87.44
28777,1,0,3,1,0,0,5,8690,54.42
28778,1,5,3,1,0,0,10,16522,90.12
28779,3,0,5,1,3,0,12,17186,93.28
28780,1,4,1,2,0,0,8,15186,83.84
28781,1,2,1,1,0,0,5,8690,54.42
28782,1,4,1,1,0,0,7,13868,78.23
28783,1,2,2,1,0,0,6,11521,68.36
28784,1,1,1,1,0,0,4,4966,36.77
28785,1,2,0,1,0,0,4,4966,36.77
28786,1,0,2,1,0,0,4,4966,36.77
28787,1,1,1,1,0,0,4,4966,36.77
28788,1,1,2,1,0,0,5,8690,54.42
28789,1,0,2,1,1,0,5,8690,54.42
28790,3,0,5,1,3,0,12,17186,93.28
28791,3,0,4,2,2,0,11,16947,91.91
28792,1,2,1,1,0,6,11,16947,91.91
28793,1,2,1,1,0,0,5,8690,54.42
28794,1,0,2,1,0,0,4,4966,36.77
28795,1,0,1,1,0,0,3,1352,17.01
28796,1,1,1,1,0,0,4,4966,36.77
28797,1,1,1,1,0,0,4,4966,36.77
28798,1,0,1,1,0,0,3,1352,17.01
28799,3,0,5,1,2,0,11,16947,91.91
28800,3,0,5,1,0,0,9,15950,87.44
28801,1,3,1,2,0,0,7,13868,78.23
28802,1,1,1,1,0,0,4,4966,36.77
28803,1,2,1,1,0,0,5,8690,54.42
28804,1,0,2,1,0,0,4,4966,36.77
28805,1,3,0,1,0,0,5,8690,54.42
28806,1,4,0,1,0,0,6,11521,68.36
28807,1,1,0,1,0,0,3,1352,17.01
28808,1,0,0,1,4,0,6,11521,68.36
28809,1,4,0,1,0,0,6,11521,68.36
28810,1,1,0,1,0,0,3,1352,17.01
28811,1,3,0,1,0,0,5,8690,54.42
28812,1,0,0,1,0,0,2,32,3.72
28813,1,1,0,1,0,0,3,1352,17.01
28814,1,1,0,1,0,0,3,1352,17.01
28815,1,1,2,1,0,0,5,8690,54.42
28816,1,4,4,1,0,0,10,16522,90.12
28817,3,2,5,5,3,0,18,18287,98.68
28818,3,4,3,4,3,0,17,18193,98.23
28819,1,2,0,1,0,0,4,4966,36.77
28820,1,2,0,1,0,0,4,4966,36.77
28821,1,0,1,1,0,0,3,1352,17.01
28822,1,0,1,1,0,0,3,1352,17.01
28823,1,1,1,1,0,0,4,4966,36.77
28824,1,0,2,1,0,0,4,4966,36.77
28825,1,0,1,1,0,0,3,1352,17.01
28826,1,0,4,1,1,0,7,13868,78.23
28827,1,0,1,1,0,0,3,1352,17.01
28828,1,1,1,1,0,0,4,4966,36.77
28829,1,4,1,1,0,0,7,13868,78.23
28830,1,2,1,1,0,0,5,8690,54.42
28831,1,1,2,1,0,0,5,8690,54.42
28832,1,1,1,1,0,0,4,4966,36.77
28833,1,0,3,1,1,0,6,11521,68.36
28834,1,0,1,1,0,4,7,13868,78.23
28835,1,1,2,1,0,0,5,8690,54.42
28836,1,2,1,1,0,0,5,8690,54.42
28837,1,0,4,2,0,0,7,13868,78.23
28838,1,2,1,1,0,0,5,8690,54.42
28839,1,3,0,1,0,0,5,8690,54.42
28840,1,2,0,1,0,0,4,4966,36.77
28841,1,2,1,1,0,0,5,8690,54.42
28842,1,1,2,1,0,0,5,8690,54.42
28843,1,3,1,1,0,0,6,11521,68.36
28844,1,3,3,1,0,0,8,15186,83.84
28845,1,4,0,1,0,0,6,11521,68.36
28846,3,2,5,3,5,0,18,18287,98.68
28847,1,2,0,1,0,0,4,4966,36.77
28848,1,0,0,1,0,0,2,32,3.72
28849,1,1,1,1,0,0,4,4966,36.77
28850,1,1,1,1,0,0,4,4966,36.77
28851,1,1,0,1,0,0,3,1352,17.01
28852,1,0,0,1,0,0,2,32,3.72
28853,1,1,0,1,0,4,7,13868,78.23
28854,1,0,3,2,0,0,6,11521,68.36
28855,1,0,1,1,0,0,3,1352,17.01
28856,1,4,0,1,0,0,6,11521,68.36
28857,1,4,0,1,0,0,6,11521,68.36
28858,1,0,0,1,0,0,2,32,3.72
28859,1,0,1,1,0,0,3,1352,17.01
28860,1,0,0,1,0,0,2,32,3.72
28861,1,0,1,1,0,0,3,1352,17.01
28862,1,0,2,1,1,2,7,13868,78.23
28863,1,0,0,1,0,0,2,32,3.72
28864,1,1,2,1,0,0,5,8690,54.42
28865,1,1,2,1,0,0,5,8690,54.42
28866,1,0,1,1,0,0,3,1352,17.01
28867,1,4,0,1,0,0,6,11521,68.36
28868,1,2,2,1,0,0,6,11521,68.36
28869,1,4,1,1,0,0,7,13868,78.23
28870,1,1,1,1,0,0,4,4966,36.77
28871,1,3,0,1,0,0,5,8690,54.42
28872,1,3,0,1,0,0,5,8690,54.42
28873,1,3,0,1,0,0,5,8690,54.42
28874,1,0,2,1,1,0,5,8690,54.42
28875,1,1,1,1,0,0,4,4966,36.77
28876,1,1,1,1,0,0,4,4966,36.77
28877,1,2,0,1,0,0,4,4966,36.77
28878,1,2,1,1,0,0,5,8690,54.42
28879,1,1,2,1,0,0,5,8690,54.42
28880,1,2,1,1,0,0,5,8690,54.42
28881,1,0,1,1,0,0,3,1352,17.01
28882,1,2,1,1,0,0,5,8690,54.42
28883,1,1,0,1,0,0,3,1352,17.01
28884,1,2,1,1,0,0,5,8690,54.42
28885,1,3,0,1,0,0,5,8690,54.42
28886,1,1,1,1,0,0,4,4966,36.77
28887,1,3,0,1,0,0,5,8690,54.42
28888,1,0,4,1,0,0,6,11521,68.36
28889,1,0,1,1,0,0,3,1352,17.01
28890,1,1,1,1,0,0,4,4966,36.77
28891,3,4,4,4,4,0,19,18362,99.04
28892,3,0,5,2,2,0,12,17186,93.28
28893,1,1,0,1,0,0,3,1352,17.01
28894,1,4,0,1,0,0,6,11521,68.36
28895,1,0,1,1,0,6,9,15950,87.44
28896,1,3,1,1,0,0,6,11521,68.36
28897,1,1,1,1,0,0,4,4966,36.77
28898,1,0,2,2,1,0,6,11521,68.36
28899,1,0,1,1,0,0,3,1352,17.01
28900,1,0,1,1,0,0,3,1352,17.01
28901,1,4,1,1,0,0,7,13868,78.23
28902,1,0,1,1,0,6,9,15950,87.44
28903,1,1,0,1,0,0,3,1352,17.01
28904,1,2,0,1,0,0,4,4966,36.77
28905,1,4,1,1,0,0,7,13868,78.23
28906,1,2,2,1,0,0,6,11521,68.36
28907,1,0,1,1,0,0,3,1352,17.01
28908,1,4,0,1,0,0,6,11521,68.36
28909,1,3,0,1,0,0,5,8690,54.42
28910,1,0,1,1,0,4,7,13868,78.23
28911,1,0,0,1,0,0,2,32,3.72
28912,1,0,0,1,0,0,2,32,3.72
28913,1,0,1,1,0,0,3,1352,17.01
28914,3,3,4,5,2,0,17,18193,98.23
28915,1,0,4,2,0,0,7,13868,78.23
28916,1,0,1,1,0,0,3,1352,17.01
28917,1,0,1,1,0,0,3,1352,17.01
28918,1,2,1,1,0,0,5,8690,54.42
28919,1,1,0,1,0,0,3,1352,17.01
28920,1,1,2,2,1,0,7,13868,78.23
28921,1,2,4,1,0,0,8,15186,83.84
28922,1,1,2,1,0,0,5,8690,54.42
28923,1,2,0,1,0,0,4,4966,36.77
28924,1,2,0,1,1,0,5,8690,54.42
28925,1,1,2,1,0,0,5,8690,54.42
28926,1,0,1,1,0,0,3,1352,17.01
28927,1,0,2,1,0,0,4,4966,36.77
28928,1,3,2,1,0,0,7,13868,78.23
28929,1,1,3,1,0,0,6,11521,68.36
28930,1,0,2,1,0,6,10,16522,90.12
28931,1,0,1,1,0,0,3,1352,17.01
28932,3,0,5,1,3,0,12,17186,93.28
28933,1,5,2,1,0,0,9,15950,87.44
28934,1,1,1,1,0,6,10,16522,90.12
28935,1,4,1,1,0,0,7,13868,78.23
28936,1,1,2,1,0,0,5,8690,54.42
28937,1,0,1,1,0,0,3,1352,17.01
28938,1,0,3,2,0,0,6,11521,68.36
28939,1,1,1,1,0,0,4,4966,36.77
28940,1,3,0,1,0,0,5,8690,54.42
28941,1,4,0,1,0,0,6,11521,68.36
28942,1,2,1,1,0,0,5,8690,54.42
28943,1,1,1,1,0,0,4,4966,36.77
28944,1,0,1,1,0,0,3,1352,17.01
28945,1,0,1,1,0,0,3,1352,17.01
28946,1,0,1,1,1,0,4,4966,36.77
28947,1,4,0,1,1,0,7,13868,78.23
28948,1,0,1,1,0,0,3,1352,17.01
28949,1,4,2,1,0,0,8,15186,83.84
28950,1,1,0,1,0,0,3,1352,17.01
28951,1,0,1,1,2,0,5,8690,54.42
28952,1,0,1,1,0,0,3,1352,17.01
28953,1,0,2,1,0,0,4,4966,36.77
28954,1,2,1,1,0,0,5,8690,54.42
28955,1,0,1,1,0,0,3,1352,17.01
28956,1,2,1,1,0,0,5,8690,54.42
28957,1,0,0,1,0,0,2,32,3.72
28958,1,0,1,1,0,0,3,1352,17.01
28959,3,3,4,3,2,0,15,17888,96.85
28960,1,1,1,1,0,0,4,4966,36.77
28961,1,3,2,2,0,0,8,15186,83.84
28962,1,0,0,1,0,0,2,32,3.72
28964,1,1,2,1,0,0,5,8690,54.42
28965,1,3,0,1,0,0,5,8690,54.42
28966,1,0,1,1,0,2,5,8690,54.42
28967,1,1,2,1,0,6,11,16947,91.91
28968,1,3,2,1,0,0,7,13868,78.23
28969,1,0,3,1,0,0,5,8690,54.42
28970,1,1,1,1,0,0,4,4966,36.77
28971,1,0,1,1,0,0,3,1352,17.01
28972,1,2,0,1,0,0,4,4966,36.77
28973,1,0,3,2,0,0,6,11521,68.36
28974,1,1,2,1,0,0,5,8690,54.42
28975,1,3,0,1,0,0,5,8690,54.42
28976,1,0,0,1,0,0,2,32,3.72
28977,1,3,0,1,0,0,5,8690,54.42
28978,1,2,0,1,0,0,4,4966,36.77
28979,1,3,0,0,0,0,4,4966,36.77
28980,1,0,3,1,0,10,15,17888,96.85
28981,1,0,1,1,0,0,3,1352,17.01
28982,1,3,2,1,0,0,7,13868,78.23
28983,1,2,1,1,0,0,5,8690,54.42
28984,1,5,0,2,0,0,8,15186,83.84
28985,1,2,1,1,0,0,5,8690,54.42
28986,1,1,1,1,0,0,4,4966,36.77
28987,1,2,1,1,0,0,5,8690,54.42
28988,1,1,1,1,0,0,4,4966,36.77
28989,1,2,1,1,0,0,5,8690,54.42
28990,1,0,0,1,0,10,12,17186,93.28
28991,1,4,3,1,0,0,9,15950,87.44
28992,1,3,0,1,0,0,5,8690,54.42
28993,1,0,0,1,0,0,2,32,3.72
28994,1,0,2,1,0,0,4,4966,36.77
28995,1,0,0,1,0,0,2,32,3.72
28996,1,4,0,1,0,0,6,11521,68.36
28997,1,0,1,1,0,0,3,1352,17.01
28998,1,0,1,1,0,0,3,1352,17.01
28999,1,0,1,1,0,0,3,1352,17.01
29000,1,1,1,1,0,0,4,4966,36.77
29001,1,1,1,1,0,0,4,4966,36.77
29002,1,0,2,1,0,0,4,4966,36.77
29003,1,1,0,1,0,0,3,1352,17.01
29004,1,1,1,1,0,0,4,4966,36.77
29005,1,2,0,1,0,0,4,4966,36.77
29006,1,4,0,1,0,0,6,11521,68.36
29007,1,1,1,1,0,4,8,15186,83.84
29008,3,0,5,2,1,6,17,18193,98.23
29009,1,1,0,1,0,0,3,1352,17.01
29010,1,0,1,1,0,0,3,1352,17.01
29011,1,1,1,1,0,2,6,11521,68.36
29012,1,0,1,1,0,0,3,1352,17.01
29013,1,1,0,1,0,0,3,1352,17.01
29014,1,1,1,1,0,0,4,4966,36.77
29015,1,1,1,1,0,0,4,4966,36.77
29016,1,0,1,1,0,0,3,1352,17.01
29017,1,1,1,1,0,0,4,4966,36.77
29018,1,1,1,1,0,0,4,4966,36.77
29019,1,0,2,1,0,6,10,16522,90.12
29020,1,1,1,1,0,0,4,4966,36.77
29021,1,3,0,1,0,0,5,8690,54.42
29022,3,4,5,5,0,0,17,18193,98.23
29023,3,0,5,4,1,2,15,17888,96.85
29024,3,0,3,1,3,2,12,17186,93.28
29025,1,0,3,1,1,0,6,11521,68.36
29026,1,2,0,0,0,0,3,1352,17.01
29027,1,3,0,1,0,0,5,8690,54.42
29028,1,1,1,1,0,0,4,4966,36.77
29029,1,1,1,1,0,0,4,4966,36.77
29030,1,2,1,1,0,0,5,8690,54.42
29031,1,4,0,1,0,0,6,11521,68.36
29032,1,0,3,1,0,0,5,8690,54.42
29033,1,0,2,1,0,0,4,4966,36.77
29034,1,1,0,1,0,0,3,1352,17.01
29035,1,0,2,1,0,0,4,4966,36.77
29036,1,4,1,1,0,0,7,13868,78.23
29037,1,1,0,1,0,0,3,1352,17.01
29038,1,0,1,1,0,0,3,1352,17.01
29039,1,2,0,1,0,0,4,4966,36.77
29040,1,1,1,1,0,4,8,15186,83.84
29041,1,2,1,1,0,0,5,8690,54.42
29042,1,0,0,1,0,0,2,32,3.72
29043,1,3,0,1,0,0,5,8690,54.42
29044,1,0,0,1,0,0,2,32,3.72
29045,1,1,1,1,0,4,8,15186,83.84
29046,1,0,3,1,0,0,5,8690,54.42
29047,3,0,3,2,4,0,12,17186,93.28
29048,1,0,2,1,0,10,14,17699,95.82
29049,3,0,3,1,2,10,19,18362,99.04
29050,3,0,4,2,5,0,14,17699,95.82
29051,1,1,1,1,0,0,4,4966,36.77
29052,1,0,1,1,0,0,3,1352,17.01
29053,1,0,3,1,0,0,5,8690,54.42
29054,1,1,1,1,0,0,4,4966,36.77
29055,1,4,4,1,0,0,10,16522,90.12
29056,1,2,0,1,0,0,4,4966,36.77
29057,1,0,4,2,0,0,7,13868,78.23
29058,1,0,3,1,0,0,5,8690,54.42
29059,1,0,2,1,1,6,11,16947,91.91
29060,1,3,1,1,0,0,6,11521,68.36
29061,1,1,2,1,0,0,5,8690,54.42
29062,1,3,1,1,0,0,6,11521,68.36
29063,1,3,2,1,0,0,7,13868,78.23
29064,1,0,1,1,0,6,9,15950,87.44
29065,1,2,2,1,0,0,6,11521,68.36
29066,1,0,2,1,0,0,4,4966,36.77
29067,3,1,4,2,2,0,12,17186,93.28
29068,1,0,1,1,0,2,5,8690,54.42
29069,1,2,0,1,0,0,4,4966,36.77
29070,1,2,1,1,0,0,5,8690,54.42
29071,1,0,4,2,2,0,9,15950,87.44
29072,1,0,2,1,0,0,4,4966,36.77
29073,1,4,0,1,0,0,6,11521,68.36
29074,1,3,0,1,1,0,6,11521,68.36
29075,1,1,2,1,0,6,11,16947,91.91
29076,3,1,4,5,2,0,15,17888,96.85
29077,3,3,4,5,2,0,17,18193,98.23
29078,1,3,0,1,0,0,5,8690,54.42
29079,1,1,0,1,0,0,3,1352,17.01
29080,1,2,1,1,0,0,5,8690,54.42
29081,1,3,4,2,0,0,10,16522,90.12
29082,1,0,2,1,0,0,4,4966,36.77
29083,1,4,0,1,0,0,6,11521,68.36
29084,1,3,1,1,0,0,6,11521,68.36
29085,1,0,1,1,0,0,3,1352,17.01
29086,1,0,0,1,0,0,2,32,3.72
29087,1,4,0,1,0,0,6,11521,68.36
29088,1,0,3,1,1,0,6,11521,68.36
29089,1,0,3,1,1,0,6,11521,68.36
29090,1,0,2,1,1,0,5,8690,54.42
29091,1,0,0,1,0,10,12,17186,93.28
29092,1,5,0,1,0,0,7,13868,78.23
29093,1,2,0,1,0,6,10,16522,90.12
29094,1,1,1,1,0,0,4,4966,36.77
29095,1,0,1,1,0,0,3,1352,17.01
29096,1,0,1,1,0,0,3,1352,17.01
29097,1,3,0,1,0,0,5,8690,54.42
29098,1,1,1,1,0,0,4,4966,36.77
29099,1,0,2,1,0,0,4,4966,36.77
29100,1,1,2,1,0,0,5,8690,54.42
29101,1,1,2,1,1,0,6,11521,68.36
29102,1,1,1,1,0,0,4,4966,36.77
29103,3,0,4,4,5,0,16,18081,97.67
29104,1,0,1,1,0,0,3,1352,17.01
29105,1,2,2,1,0,0,6,11521,68.36
29106,1,1,0,1,0,0,3,1352,17.01
29107,1,2,1,1,0,0,5,8690,54.42
29108,1,0,0,1,0,0,2,32,3.72
29109,1,1,0,1,0,6,9,15950,87.44
29110,1,0,1,1,0,0,3,1352,17.01
29111,1,1,0,1,0,0,3,1352,17.01
29112,1,5,2,2,0,0,10,16522,90.12
29113,1,2,0,1,0,0,4,4966,36.77
29114,1,2,1,1,0,0,5,8690,54.42
29115,1,1,1,1,0,0,4,4966,36.77
29116,1,3,0,1,0,0,5,8690,54.42
29117,1,3,0,1,0,0,5,8690,54.42
29118,1,0,1,1,0,0,3,1352,17.01
29119,1,3,0,1,0,0,5,8690,54.42
29120,1,0,0,1,0,0,2,32,3.72
29121,1,0,2,1,0,0,4,4966,36.77
29122,1,1,1,1,0,0,4,4966,36.77
29123,1,0,2,1,0,0,4,4966,36.77
29124,1,1,1,1,0,0,4,4966,36.77
29125,1,3,1,1,0,0,6,11521,68.36
29126,1,0,1,1,0,0,3,1352,17.01
29128,1,5,1,1,0,0,8,15186,83.84
29129,1,1,2,1,0,6,11,16947,91.91
29130,1,3,0,1,0,0,5,8690,54.42
29131,1,1,1,1,0,0,4,4966,36.77
29132,1,1,2,1,0,0,5,8690,54.42
29133,1,0,1,1,0,0,3,1352,17.01
29134,1,2,1,1,0,0,5,8690,54.42
29135,1,4,1,1,0,0,7,13868,78.23
29136,1,3,0,1,0,0,5,8690,54.42
29137,1,1,1,1,0,0,4,4966,36.77
29138,1,0,0,1,0,0,2,32,3.72
29139,1,2,0,1,0,0,4,4966,36.77
29140,1,1,1,1,0,0,4,4966,36.77
29141,1,4,2,2,0,0,9,15950,87.44
29142,1,2,0,1,0,0,4,4966,36.77
29143,1,1,0,1,0,0,3,1352,17.01
29144,1,3,0,1,0,0,5,8690,54.42
29145,1,1,2,1,0,0,5,8690,54.42
29146,1,0,3,1,0,0,5,8690,54.42
29147,1,1,0,1,0,0,3,1352,17.01
29148,1,3,0,1,0,0,5,8690,54.42
29149,1,1,1,1,0,0,4,4966,36.77
29150,1,1,0,1,0,0,3,1352,17.01
29151,1,2,1,1,0,0,5,8690,54.42
29152,1,1,1,1,0,6,10,16522,90.12
29153,1,0,1,1,0,0,3,1352,17.01
29154,1,1,1,1,0,6,10,16522,90.12
29155,1,0,0,1,0,0,2,32,3.72
29156,3,1,4,3,1,0,12,17186,93.28
29157,1,2,0,1,0,0,4,4966,36.77
29158,1,4,0,1,0,0,6,11521,68.36
29159,1,1,2,1,0,0,5,8690,54.42
29160,1,2,0,1,0,0,4,4966,36.77
29161,1,2,1,1,0,0,5,8690,54.42
29162,1,0,1,1,0,0,3,1352,17.01
29163,1,3,1,1,0,0,6,11521,68.36
29164,1,1,1,1,0,0,4,4966,36.77
29165,1,1,0,1,0,0,3,1352,17.01
29166,3,0,3,1,1,0,8,15186,83.84
29167,1,0,1,1,0,0,3,1352,17.01
29168,1,0,2,1,0,4,8,15186,83.84
29169,1,3,1,1,0,0,6,11521,68.36
29170,1,4,1,1,0,0,7,13868,78.23
29171,1,4,0,1,0,0,6,11521,68.36
29172,1,4,0,1,0,0,6,11521,68.36
29173,3,0,5,2,5,0,15,17888,96.85
29174,1,2,4,1,0,0,8,15186,83.84
29175,1,0,0,1,0,0,2,32,3.72
29176,1,3,0,1,0,0,5,8690,54.42
29177,1,1,1,1,0,0,4,4966,36.77
29178,1,0,0,1,0,0,2,32,3.72
29179,1,4,0,1,0,0,6,11521,68.36
29180,1,1,1,1,0,0,4,4966,36.77
29181,1,0,0,1,0,10,12,17186,93.28
29182,1,0,0,1,0,10,12,17186,93.28
29183,1,0,2,1,0,0,4,4966,36.77
29184,3,3,5,5,0,0,16,18081,97.67
29185,1,1,2,1,0,4,9,15950,87.44
29186,1,0,1,1,2,0,5,8690,54.42
29187,1,2,1,1,0,0,5,8690,54.42
29188,1,5,4,2,0,0,12,17186,93.28
29189,1,0,0,1,0,0,2,32,3.72
29190,1,3,0,1,0,0,5,8690,54.42
29191,1,1,1,1,0,0,4,4966,36.77
29192,1,1,0,1,0,0,3,1352,17.01
29193,1,0,0,1,0,0,2,32,3.72
29194,1,1,1,1,0,0,4,4966,36.77
29195,1,2,2,1,0,0,6,11521,68.36
29196,1,0,1,1,0,0,3,1352,17.01
29197,1,1,0,1,0,0,3,1352,17.01
29198,1,2,1,1,0,0,5,8690,54.42
29199,1,1,5,1,0,0,8,15186,83.84
29200,1,0,1,1,0,2,5,8690,54.42
29201,1,2,0,0,0,0,3,1352,17.01
29202,1,0,0,1,0,0,2,32,3.72
29203,1,0,0,1,0,0,2,32,3.72
29204,1,0,0,1,0,2,4,4966,36.77
29205,1,1,1,1,0,0,4,4966,36.77
29206,1,0,3,1,0,0,5,8690,54.42
29207,1,0,2,1,0,0,4,4966,36.77
29208,1,0,1,1,0,0,3,1352,17.01
29209,1,0,0,1,0,0,2,32,3.72
29210,1,0,1,1,0,0,3,1352,17.01
29211,1,2,3,1,0,0,7,13868,78.23
29212,1,1,1,1,0,0,4,4966,36.77
29213,1,0,3,1,1,6,12,17186,93.28
29214,1,1,0,1,0,0,3,1352,17.01
29215,1,1,0,1,0,0,3,1352,17.01
29216,1,2,2,1,0,0,6,11521,68.36
29217,1,3,1,1,0,0,6,11521,68.36
29218,1,1,1,1,0,0,4,4966,36.77
29219,1,0,1,1,1,0,4,4966,36.77
29220,1,3,1,1,0,0,6,11521,68.36
29221,1,1,0,1,0,0,3,1352,17.01
29223,1,0,1,1,0,0,3,1352,17.01
29224,1,0,0,1,0,0,2,32,3.72
29225,1,1,1,1,0,0,4,4966,36.77
29226,1,1,1,1,0,0,4,4966,36.77
29227,1,3,0,1,0,0,5,8690,54.42
29228,1,4,4,1,0,0,10,16522,90.12
29229,1,0,0,1,0,0,2,32,3.72
29230,1,0,1,1,0,0,3,1352,17.01
29231,1,0,1,1,0,0,3,1352,17.01
29232,1,3,0,1,0,0,5,8690,54.42
29233,1,2,0,1,0,0,4,4966,36.77
29234,1,3,2,1,0,0,7,13868,78.23
29235,1,1,0,1,0,8,11,16947,91.91
29236,1,0,2,1,0,4,8,15186,83.84
29237,1,0,0,1,0,0,2,32,3.72
29238,1,4,0,1,0,0,6,11521,68.36
29239,1,4,1,1,0,0,7,13868,78.23
29240,1,3,2,1,0,0,7,13868,78.23
29241,1,0,1,1,0,0,3,1352,17.01
29242,1,1,1,1,0,0,4,4966,36.77
29243,1,2,0,1,0,0,4,4966,36.77
29244,1,0,3,1,3,0,8,15186,83.84
29245,1,1,0,1,0,0,3,1352,17.01
29246,1,0,1,1,0,0,3,1352,17.01
29247,1,0,2,1,0,0,4,4966,36.77
29248,1,2,0,1,0,0,4,4966,36.77
29249,1,0,1,1,0,2,5,8690,54.42
29250,1,2,0,1,0,0,4,4966,36.77
29251,1,2,1,1,0,0,5,8690,54.42
29252,1,0,2,1,0,0,4,4966,36.77
29253,1,4,2,1,0,0,8,15186,83.84
29254,1,2,1,1,0,0,5,8690,54.42
29255,1,1,0,1,0,0,3,1352,17.01
29256,1,1,1,1,0,0,4,4966,36.77
29257,1,1,0,1,0,0,3,1352,17.01
29258,1,1,1,1,0,0,4,4966,36.77
29259,1,0,0,1,0,0,2,32,3.72
29260,1,2,5,1,1,0,10,16522,90.12
29261,1,1,0,1,0,0,3,1352,17.01
29262,3,4,4,5,0,0,16,18081,97.67
29263,1,0,0,1,0,0,2,32,3.72
29264,1,0,2,1,0,0,4,4966,36.77
29265,1,1,0,1,0,0,3,1352,17.01
29266,1,0,0,1,0,0,2,32,3.72
29267,1,2,0,1,0,0,4,4966,36.77
29268,1,3,1,1,0,0,6,11521,68.36
29269,1,0,0,1,0,0,2,32,3.72
29270,1,0,2,1,0,0,4,4966,36.77
29271,1,4,1,1,0,0,7,13868,78.23
29272,1,1,0,1,0,0,3,1352,17.01
29273,1,4,0,1,0,0,6,11521,68.36
29274,1,0,1,1,0,0,3,1352,17.01
29275,1,0,1,1,0,0,3,1352,17.01
29276,1,0,3,1,0,0,5,8690,54.42
29277,1,4,0,1,0,0,6,11521,68.36
29278,1,1,0,1,0,0,3,1352,17.01
29279,1,1,1,1,0,0,4,4966,36.77
29280,1,2,0,1,0,0,4,4966,36.77
29281,1,0,1,1,0,0,3,1352,17.01
29282,1,4,0,1,0,0,6,11521,68.36
29283,1,1,0,1,0,0,3,1352,17.01
29284,1,3,1,1,0,0,6,11521,68.36
29285,1,1,2,1,0,0,5,8690,54.42
29286,1,0,4,1,0,0,6,11521,68.36
29287,1,0,4,1,1,0,7,13868,78.23
29288,1,0,2,1,0,0,4,4966,36.77
29289,1,0,2,2,0,0,5,8690,54.42
29290,1,1,1,0,0,0,3,1352,17.01
29291,1,2,2,1,0,0,6,11521,68.36
29292,1,0,3,1,1,0,6,11521,68.36
29293,1,2,1,1,0,0,5,8690,54.42
29294,1,0,2,1,0,0,4,4966,36.77
29295,1,4,0,1,0,0,6,11521,68.36
29296,1,1,0,1,0,0,3,1352,17.01
29297,1,2,0,1,0,0,4,4966,36.77
29298,1,0,1,1,0,0,3,1352,17.01
29299,1,0,1,1,0,0,3,1352,17.01
29300,1,0,1,0,0,0,2,32,3.72
29301,1,2,2,1,0,0,6,11521,68.36
29302,1,1,1,1,0,0,4,4966,36.77
29303,1,1,0,1,0,0,3,1352,17.01
29304,1,4,0,0,0,0,5,8690,54.42
29305,1,1,1,1,0,0,4,4966,36.77
29306,1,0,0,1,0,0,2,32,3.72
29307,1,2,1,1,0,0,5,8690,54.42
29308,1,1,0,1,0,0,3,1352,17.01
29309,1,1,2,1,0,0,5,8690,54.42
29310,1,2,0,1,2,0,6,11521,68.36
29311,1,3,0,1,0,0,5,8690,54.42
29312,1,0,0,1,0,0,2,32,3.72
29313,1,3,0,1,0,0,5,8690,54.42
29314,1,0,0,1,0,0,2,32,3.72
29315,1,1,0,1,0,0,3,1352,17.01
29316,1,1,1,1,0,0,4,4966,36.77
29317,1,0,1,1,0,0,3,1352,17.01
29318,4,0,5,1,4,4,18,18287,98.68
29319,1,0,1,1,0,0,3,1352,17.01
29320,1,1,1,1,0,6,10,16522,90.12
29321,1,2,0,1,0,0,4,4966,36.77
29322,1,0,1,1,0,0,3,1352,17.01
29323,1,0,1,1,0,4,7,13868,78.23
29324,1,0,1,1,0,0,3,1352,17.01
29325,1,0,2,1,0,0,4,4966,36.77
29326,1,1,0,1,0,0,3,1352,17.01
29327,1,0,1,1,0,0,3,1352,17.01
29328,1,1,1,1,0,0,4,4966,36.77
29329,1,2,0,1,0,0,4,4966,36.77
29330,1,1,0,1,0,0,3,1352,17.01
29331,1,0,1,1,0,0,3,1352,17.01
29332,3,0,5,1,3,0,12,17186,93.28
29333,1,1,0,1,0,0,3,1352,17.01
29334,1,2,1,0,0,0,4,4966,36.77
29335,1,1,0,1,0,0,3,1352,17.01
29336,1,0,2,1,0,0,4,4966,36.77
29337,1,1,0,1,0,0,3,1352,17.01
29338,1,4,0,1,0,0,6,11521,68.36
29339,1,3,0,1,0,0,5,8690,54.42
29340,1,2,2,1,0,6,12,17186,93.28
29341,1,0,2,1,0,0,4,4966,36.77
29342,1,0,2,1,0,0,4,4966,36.77
29343,1,0,0,0,0,0,1,1,0.08
29344,1,3,1,1,0,0,6,11521,68.36
29345,1,4,0,1,0,0,6,11521,68.36
29346,1,1,0,1,0,0,3,1352,17.01
29347,1,2,0,1,0,0,4,4966,36.77
29348,1,4,0,1,0,0,6,11521,68.36
29349,1,1,1,1,0,0,4,4966,36.77
29350,1,4,0,1,0,0,6,11521,68.36
29351,1,3,0,1,0,0,5,8690,54.42
29352,1,0,1,1,0,0,3,1352,17.01
29353,1,3,1,1,0,0,6,11521,68.36
29354,1,4,0,1,0,0,6,11521,68.36
29355,1,4,1,1,0,0,7,13868,78.23
29356,1,2,0,1,0,0,4,4966,36.77
29357,1,0,0,0,0,2,3,1352,17.01
29358,1,0,1,1,0,0,3,1352,17.01
29359,1,2,0,1,0,0,4,4966,36.77
29360,1,3,0,1,0,0,5,8690,54.42
29361,1,4,2,1,0,0,8,15186,83.84
29362,1,0,1,1,0,0,3,1352,17.01
29363,1,1,1,1,0,0,4,4966,36.77
29364,1,0,1,1,0,0,3,1352,17.01
29365,1,1,1,1,0,0,4,4966,36.77
29366,1,1,1,1,0,0,4,4966,36.77
29367,1,0,1,1,0,0,3,1352,17.01
29368,1,0,1,1,0,0,3,1352,17.01
29369,1,1,3,2,1,0,8,15186,83.84
29370,1,1,0,1,0,0,3,1352,17.01
29371,1,2,2,1,0,0,6,11521,68.36
29372,1,0,0,1,0,0,2,32,3.72
29373,1,0,1,1,0,0,3,1352,17.01
29374,1,2,2,1,0,0,6,11521,68.36
29375,1,1,1,1,0,0,4,4966,36.77
29376,1,2,1,1,1,0,6,11521,68.36
29377,1,0,1,1,2,0,5,8690,54.42
29378,1,0,0,1,0,0,2,32,3.72
29379,1,1,1,1,0,0,4,4966,36.77
29380,1,0,1,1,0,0,3,1352,17.01
29381,1,3,0,1,0,0,5,8690,54.42
29382,1,0,0,1,0,0,2,32,3.72
29383,1,0,1,1,0,0,3,1352,17.01
29384,1,0,5,1,0,0,7,13868,78.23
29385,1,2,0,1,0,0,4,4966,36.77
29386,1,1,1,1,0,0,4,4966,36.77
29387,1,1,1,1,0,0,4,4966,36.77
29388,1,0,3,1,0,0,5,8690,54.42
29389,1,0,2,1,0,0,4,4966,36.77
29390,1,2,1,1,0,0,5,8690,54.42
29391,1,4,0,1,0,0,6,11521,68.36
29392,1,3,0,1,0,0,5,8690,54.42
29393,1,4,1,1,0,0,7,13868,78.23
29394,1,2,1,1,0,0,5,8690,54.42
29395,1,0,0,1,0,10,12,17186,93.28
29396,1,0,2,1,0,0,4,4966,36.77
29397,1,1,0,1,0,0,3,1352,17.01
29398,1,0,2,1,0,0,4,4966,36.77
29399,1,0,1,1,0,0,3,1352,17.01
29400,1,0,2,1,0,0,4,4966,36.77
29401,1,0,1,1,1,0,4,4966,36.77
29402,1,1,2,1,0,0,5,8690,54.42
29403,1,0,0,1,0,2,4,4966,36.77
29404,1,1,2,1,1,0,6,11521,68.36
29405,1,2,1,1,0,0,5,8690,54.42
29406,1,1,1,1,0,0,4,4966,36.77
29407,1,2,1,1,0,0,5,8690,54.42
29408,1,0,1,1,0,0,3,1352,17.01
29409,1,1,1,1,0,0,4,4966,36.77
29410,1,0,0,0,0,0,1,1,0.08
29411,1,1,0,1,0,4,7,13868,78.23
29412,1,0,2,1,0,0,4,4966,36.77
29413,1,0,2,1,0,0,4,4966,36.77
29414,1,4,1,1,0,0,7,13868,78.23
29415,1,0,1,1,0,10,13,17456,94.66
29416,3,0,5,1,1,0,10,16522,90.12
29417,1,4,2,2,0,0,9,15950,87.44
29418,1,0,1,1,0,0,3,1352,17.01
29419,1,0,1,1,0,0,3,1352,17.01
29420,1,0,1,1,0,6,9,15950,87.44
29421,1,2,1,1,0,0,5,8690,54.42
29422,1,2,1,1,0,0,5,8690,54.42
29423,1,0,0,1,0,0,2,32,3.72
29424,1,0,1,1,0,0,3,1352,17.01
29425,1,1,0,1,0,0,3,1352,17.01
29426,1,1,1,1,0,0,4,4966,36.77
29427,1,4,0,1,0,0,6,11521,68.36
29428,1,0,2,1,0,0,4,4966,36.77
29429,1,0,2,1,1,0,5,8690,54.42
29430,1,0,2,1,0,0,4,4966,36.77
29431,1,1,0,1,0,0,3,1352,17.01
29432,1,0,1,1,0,6,9,15950,87.44
29433,1,0,0,0,0,0,1,1,0.08
29434,1,2,2,1,0,0,6,11521,68.36
29435,1,0,1,1,0,0,3,1352,17.01
29436,1,1,1,1,0,0,4,4966,36.77
29437,1,2,1,1,0,0,5,8690,54.42
29438,1,0,0,1,0,0,2,32,3.72
29439,1,3,0,1,0,0,5,8690,54.42
29440,1,4,0,1,0,0,6,11521,68.36
29441,1,4,0,1,0,0,6,11521,68.36
29442,1,1,0,1,0,0,3,1352,17.01
29443,1,1,1,1,0,0,4,4966,36.77
29444,1,0,1,1,0,6,9,15950,87.44
29445,1,0,4,2,3,0,10,16522,90.12
29446,1,0,3,1,1,0,6,11521,68.36
29447,1,0,1,0,0,0,2,32,3.72
29448,1,0,2,1,0,0,4,4966,36.77
29449,1,4,2,1,0,0,8,15186,83.84
29450,1,1,0,1,0,0,3,1352,17.01
29451,1,1,1,1,0,6,10,16522,90.12
29452,1,1,0,1,0,0,3,1352,17.01
29453,1,0,0,1,0,0,2,32,3.72
29454,1,1,1,1,0,0,4,4966,36.77
29455,1,3,1,1,0,0,6,11521,68.36
29456,1,1,1,1,0,0,4,4966,36.77
29457,1,2,0,1,0,0,4,4966,36.77
29458,1,2,2,2,0,0,7,13868,78.23
29459,1,1,1,1,0,0,4,4966,36.77
29460,1,1,2,1,1,0,6,11521,68.36
29461,1,0,2,1,0,0,4,4966,36.77
29462,1,1,1,1,0,0,4,4966,36.77
29463,1,3,1,1,0,0,6,11521,68.36
29464,1,1,1,1,0,0,4,4966,36.77
29465,1,0,0,1,0,6,8,15186,83.84
29466,1,0,0,1,0,0,2,32,3.72
29467,1,2,1,1,0,0,5,8690,54.42
29468,1,1,2,1,0,0,5,8690,54.42
29469,1,4,0,1,0,0,6,11521,68.36
29470,1,1,1,1,0,0,4,4966,36.77
29471,1,0,2,1,0,0,4,4966,36.77
29472,1,1,0,1,0,0,3,1352,17.01
29473,1,2,1,1,0,0,5,8690,54.42
29474,1,1,0,1,0,0,3,1352,17.01
29475,1,1,0,1,0,0,3,1352,17.01
29476,1,4,0,1,0,0,6,11521,68.36
29477,1,0,1,1,0,0,3,1352,17.01
29478,1,4,3,1,0,0,9,15950,87.44
29479,1,4,0,1,0,0,6,11521,68.36
29480,1,2,1,1,0,0,5,8690,54.42
29481,1,0,1,1,0,0,3,1352,17.01
29482,1,0,1,1,0,0,3,1352,17.01
29483,1,3,1,1,0,0,6,11521,68.36
29484,1,2,0,1,0,0,4,4966,36.77
29485,1,2,1,1,0,0,5,8690,54.42
29486,1,2,1,1,0,0,5,8690,54.42
29487,1,2,2,1,0,0,6,11521,68.36
29488,1,0,1,1,0,0,3,1352,17.01
29489,1,0,2,1,0,6,10,16522,90.12
29490,1,1,1,1,0,0,4,4966,36.77
29491,1,0,2,1,0,4,8,15186,83.84
29492,1,1,1,1,0,0,4,4966,36.77
29493,1,2,2,1,0,0,6,11521,68.36
29494,1,0,2,1,0,0,4,4966,36.77
29495,1,3,0,1,0,0,5,8690,54.42
29496,1,1,1,0,0,0,3,1352,17.01
29497,1,4,0,1,0,0,6,11521,68.36
29498,1,2,1,1,0,0,5,8690,54.42
29499,1,1,2,1,0,0,5,8690,54.42
29500,1,4,0,1,0,0,6,11521,68.36
29501,1,2,1,1,0,0,5,8690,54.42
29502,1,2,0,1,0,0,4,4966,36.77
29503,1,1,1,1,0,0,4,4966,36.77
29504,1,2,1,1,0,0,5,8690,54.42
29505,1,0,0,1,0,0,2,32,3.72
29506,1,1,0,1,0,0,3,1352,17.01
29507,1,1,0,1,0,0,3,1352,17.01
29508,1,1,1,1,0,0,4,4966,36.77
29509,1,0,2,1,0,0,4,4966,36.77
29510,1,3,3,1,0,0,8,15186,83.84
29511,1,0,1,1,0,0,3,1352,17.01
29512,1,1,1,1,0,0,4,4966,36.77
29513,1,0,1,1,0,0,3,1352,17.01
29514,1,0,3,1,0,0,5,8690,54.42
29515,1,5,1,1,0,0,8,15186,83.84
29516,1,2,1,1,0,0,5,8690,54.42
29517,1,1,3,1,1,0,7,13868,78.23
29518,1,4,0,1,0,0,6,11521,68.36
29519,1,2,1,0,0,0,4,4966,36.77
29520,1,0,1,1,0,6,9,15950,87.44
29521,1,1,2,1,0,0,5,8690,54.42
29522,1,2,1,1,0,0,5,8690,54.42
29523,1,2,1,1,0,0,5,8690,54.42
29524,1,1,1,1,0,0,4,4966,36.77
29525,1,4,0,1,0,0,6,11521,68.36
29526,1,0,1,1,0,0,3,1352,17.01
29527,1,4,4,2,0,0,11,16947,91.91
29528,1,0,2,2,0,0,5,8690,54.42
29529,3,0,5,1,5,0,14,17699,95.82
29530,1,0,2,1,0,0,4,4966,36.77
29531,1,4,0,1,0,0,6,11521,68.36
29532,1,0,4,1,0,0,6,11521,68.36
29533,3,0,5,2,3,0,13,17456,94.66
29534,1,4,0,1,0,0,6,11521,68.36
29535,1,1,0,1,0,0,3,1352,17.01
29536,1,0,0,1,0,0,2,32,3.72
29537,1,2,0,1,0,0,4,4966,36.77
29538,1,0,3,1,2,0,7,13868,78.23
29539,1,4,0,1,0,0,6,11521,68.36
29540,1,0,1,1,0,0,3,1352,17.01
29541,1,2,0,1,0,0,4,4966,36.77
29542,1,1,2,1,0,0,5,8690,54.42
29543,1,0,2,1,0,0,4,4966,36.77
29544,1,2,1,1,0,0,5,8690,54.42
29545,1,1,2,1,0,0,5,8690,54.42
29546,1,3,0,1,0,0,5,8690,54.42
29547,1,4,0,1,0,0,6,11521,68.36
29548,1,1,1,1,0,0,4,4966,36.77
29549,1,3,0,1,0,0,5,8690,54.42
29550,1,0,1,1,0,0,3,1352,17.01
29551,1,0,3,1,1,0,6,11521,68.36
29552,1,0,1,1,0,0,3,1352,17.01
29553,1,3,1,1,0,0,6,11521,68.36
29554,1,3,0,1,0,0,5,8690,54.42
29555,1,0,2,1,0,0,4,4966,36.77
29556,1,4,1,1,0,0,7,13868,78.23
29557,1,4,1,1,0,0,7,13868,78.23
29558,1,0,2,1,0,10,14,17699,95.82
29559,1,4,0,1,0,0,6,11521,68.36
29560,1,0,2,1,0,0,4,4966,36.77
29561,1,2,0,1,0,0,4,4966,36.77
29562,1,1,1,1,0,0,4,4966,36.77
29563,1,0,1,1,0,0,3,1352,17.01
29564,1,1,0,1,0,0,3,1352,17.01
29565,1,0,0,1,0,0,2,32,3.72
29566,1,1,1,1,0,0,4,4966,36.77
29567,1,4,0,1,0,0,6,11521,68.36
29568,1,0,1,1,0,0,3,1352,17.01
29569,1,1,0,1,0,0,3,1352,17.01
29570,1,0,3,2,0,0,6,11521,68.36
29571,1,1,0,1,0,0,3,1352,17.01
29572,3,3,5,5,5,0,21,18462,99.52
29573,1,0,0,1,0,0,2,32,3.72
29574,1,0,1,1,0,0,3,1352,17.01
29575,1,3,0,1,0,0,5,8690,54.42
29576,1,0,0,1,0,0,2,32,3.72
29577,1,2,0,1,0,0,4,4966,36.77
29578,1,2,1,1,0,0,5,8690,54.42
29579,1,2,0,1,0,0,4,4966,36.77
29580,1,2,0,1,0,0,4,4966,36.77
29581,1,1,1,1,0,0,4,4966,36.77
29582,1,1,1,1,0,6,10,16522,90.12
29583,1,2,1,1,0,0,5,8690,54.42
29584,1,0,1,1,0,0,3,1352,17.01
29585,1,0,2,1,0,0,4,4966,36.77
29586,1,0,1,1,0,0,3,1352,17.01
29587,1,0,1,1,0,0,3,1352,17.01
29588,1,4,0,1,0,0,6,11521,68.36
29590,1,2,1,1,0,0,5,8690,54.42
29591,1,1,0,1,0,0,3,1352,17.01
29592,1,2,1,1,0,0,5,8690,54.42
29593,1,3,1,1,0,0,6,11521,68.36
29594,1,0,1,1,0,4,7,13868,78.23
29595,1,0,3,1,3,2,10,16522,90.12
29596,1,0,3,1,0,0,5,8690,54.42
29597,1,0,1,1,0,2,5,8690,54.42
29598,1,0,1,1,0,0,3,1352,17.01
29599,1,1,1,1,0,6,10,16522,90.12
29600,1,0,0,1,0,0,2,32,3.72
29601,1,1,1,1,0,0,4,4966,36.77
29602,1,1,1,1,0,0,4,4966,36.77
29603,1,3,1,1,0,0,6,11521,68.36
29604,1,4,1,1,0,0,7,13868,78.23
29605,1,2,0,1,0,0,4,4966,36.77
29606,1,0,4,1,0,0,6,11521,68.36
29607,1,1,0,1,0,6,9,15950,87.44
29608,1,3,2,1,0,0,7,13868,78.23
29609,1,1,1,1,0,0,4,4966,36.77
29610,1,0,3,1,0,0,5,8690,54.42
29611,1,4,4,1,0,0,10,16522,90.12
29612,1,2,1,0,0,0,4,4966,36.77
29613,1,0,0,1,0,0,2,32,3.72
29614,1,0,4,2,1,0,8,15186,83.84
29615,1,2,0,1,0,0,4,4966,36.77
29616,1,2,1,1,0,0,5,8690,54.42
29617,1,0,0,1,0,0,2,32,3.72
29618,1,0,2,1,0,0,4,4966,36.77
29619,1,2,1,1,0,0,5,8690,54.42
29620,1,0,4,1,0,0,6,11521,68.36
29621,1,1,1,1,0,0,4,4966,36.77
29622,1,0,1,1,0,0,3,1352,17.01
29623,1,1,2,1,0,2,7,13868,78.23
29624,1,0,3,2,3,0,9,15950,87.44
29625,4,0,5,2,5,10,26,18556,99.96
29626,3,0,4,1,3,10,21,18462,99.52
29627,3,0,3,1,3,10,20,18419,99.31
29628,1,0,0,1,0,10,12,17186,93.28
29629,1,3,0,1,0,0,5,8690,54.42
29630,1,1,1,1,0,0,4,4966,36.77
29631,1,0,2,1,0,0,4,4966,36.77
29632,1,1,0,1,0,0,3,1352,17.01
29633,1,3,0,1,0,0,5,8690,54.42
29634,1,3,1,1,0,0,6,11521,68.36
29635,1,0,1,1,0,0,3,1352,17.01
29636,1,1,0,1,0,0,3,1352,17.01
29637,1,1,0,1,0,0,3,1352,17.01
29638,1,4,1,1,0,0,7,13868,78.23
29639,1,3,1,2,0,0,7,13868,78.23
29640,1,0,4,2,0,0,7,13868,78.23
29641,3,0,5,1,2,0,11,16947,91.91
29642,1,0,0,1,0,0,2,32,3.72
29643,1,3,0,1,0,0,5,8690,54.42
29644,1,4,0,1,0,0,6,11521,68.36
29645,1,0,2,1,0,0,4,4966,36.77
29646,1,0,1,1,0,0,3,1352,17.01
29647,1,1,1,1,0,0,4,4966,36.77
29648,1,1,1,1,0,0,4,4966,36.77
29649,1,2,1,1,0,0,5,8690,54.42
29650,1,1,0,1,0,0,3,1352,17.01
29651,1,2,1,1,0,0,5,8690,54.42
29652,1,1,0,1,0,0,3,1352,17.01
29653,1,4,0,1,0,0,6,11521,68.36
29654,1,3,3,1,0,0,8,15186,83.84
29655,1,1,3,1,0,0,6,11521,68.36
29656,3,0,5,1,3,6,18,18287,98.68
29657,1,0,0,1,0,0,2,32,3.72
29658,1,0,1,1,3,0,6,11521,68.36
29659,1,3,1,1,0,0,6,11521,68.36
29660,1,2,1,1,0,0,5,8690,54.42
29661,1,0,0,1,0,0,2,32,3.72
29662,1,0,0,1,0,6,8,15186,83.84
29663,1,0,0,0,0,0,1,1,0.08
29664,1,0,0,1,0,0,2,32,3.72
29665,1,4,1,1,0,0,7,13868,78.23
29666,1,0,0,1,0,0,2,32,3.72
29667,1,0,3,1,0,0,5,8690,54.42
29668,1,2,1,1,1,0,6,11521,68.36
29669,1,2,1,1,0,0,5,8690,54.42
29670,1,4,0,1,0,0,6,11521,68.36
29671,1,1,0,1,0,0,3,1352,17.01
29672,1,3,2,1,0,0,7,13868,78.23
29673,1,0,1,1,0,0,3,1352,17.01
29674,1,4,0,1,0,0,6,11521,68.36
29675,1,2,0,1,0,4,8,15186,83.84
29676,1,3,2,1,0,0,7,13868,78.23
29677,1,0,1,1,0,0,3,1352,17.01
29678,1,1,1,1,0,10,14,17699,95.82
29679,1,0,1,0,1,10,13,17456,94.66
29680,1,0,1,0,1,10,13,17456,94.66
29681,1,1,3,1,0,0,6,11521,68.36
29682,1,1,1,1,0,0,4,4966,36.77
29683,1,1,1,1,0,0,4,4966,36.77
29684,1,0,1,1,0,0,3,1352,17.01
29685,1,1,1,1,0,0,4,4966,36.77
29686,1,4,0,1,0,0,6,11521,68.36
29687,1,0,0,1,0,0,2,32,3.72
29688,1,0,0,1,0,0,2,32,3.72
29689,1,2,1,1,0,0,5,8690,54.42
29690,1,0,1,1,4,0,7,13868,78.23
29691,1,3,1,1,0,0,6,11521,68.36
29692,1,1,0,0,0,0,2,32,3.72
29693,1,3,2,1,0,0,7,13868,78.23
29694,1,1,2,1,1,0,6,11521,68.36
29695,3,2,5,4,0,0,14,17699,95.82
29696,1,4,0,1,0,0,6,11521,68.36
29697,1,2,0,1,0,0,4,4966,36.77
29698,1,1,0,1,0,0,3,1352,17.01
29699,1,0,3,1,1,0,6,11521,68.36
29700,1,0,0,1,0,0,2,32,3.72
29701,1,0,1,1,0,0,3,1352,17.01
29702,1,0,0,1,0,0,2,32,3.72
29703,1,0,1,1,0,6,9,15950,87.44
29704,1,1,3,1,0,0,6,11521,68.36
29705,1,0,1,1,0,6,9,15950,87.44
29706,1,0,2,1,0,0,4,4966,36.77
29707,1,4,0,1,0,0,6,11521,68.36
29708,1,0,2,1,0,0,4,4966,36.77
29709,1,2,1,1,0,4,9,15950,87.44
29710,1,2,1,1,0,0,5,8690,54.42
29711,1,3,1,1,0,0,6,11521,68.36
29712,1,1,1,1,0,0,4,4966,36.77
29713,1,3,1,1,0,0,6,11521,68.36
29714,1,3,1,1,0,0,6,11521,68.36
29715,1,0,1,1,0,0,3,1352,17.01
29716,1,2,0,1,0,0,4,4966,36.77
29717,1,1,0,1,0,0,3,1352,17.01
29718,1,0,1,1,0,0,3,1352,17.01
29719,1,0,3,2,3,0,9,15950,87.44
29720,1,0,2,1,0,0,4,4966,36.77
29721,1,1,1,1,1,0,5,8690,54.42
29722,1,1,3,2,0,0,7,13868,78.23
29723,1,3,1,1,0,0,6,11521,68.36
29724,1,3,0,1,0,0,5,8690,54.42
29725,1,2,0,1,0,0,4,4966,36.77
29726,1,1,1,1,0,0,4,4966,36.77
29727,1,0,1,1,0,0,3,1352,17.01
29728,1,0,0,1,0,0,2,32,3.72
29729,1,0,1,1,0,6,9,15950,87.44
29730,1,0,1,1,1,0,4,4966,36.77
29731,1,0,2,1,0,0,4,4966,36.77
29732,1,0,0,1,0,0,2,32,3.72
29733,3,2,4,2,4,0,15,17888,96.85
29734,1,0,1,1,0,0,3,1352,17.01
29735,3,0,4,5,2,0,14,17699,95.82
29736,1,1,1,1,0,0,4,4966,36.77
29737,1,0,1,1,0,0,3,1352,17.01
29738,1,5,0,1,0,0,7,13868,78.23
29739,1,0,1,1,0,0,3,1352,17.01
29740,1,0,1,1,0,0,3,1352,17.01
29741,1,1,2,1,0,0,5,8690,54.42
29742,1,1,0,1,0,0,3,1352,17.01
29743,1,0,3,1,1,8,14,17699,95.82
29744,1,1,1,1,0,0,4,4966,36.77
29745,1,1,1,1,0,0,4,4966,36.77
29746,1,3,1,1,0,0,6,11521,68.36
29747,3,1,5,3,2,0,14,17699,95.82
29748,3,5,4,5,0,0,17,18193,98.23
29749,3,0,5,2,4,0,14,17699,95.82
29750,3,0,4,1,1,0,9,15950,87.44
29751,3,0,5,1,2,0,11,16947,91.91
29752,1,0,3,2,0,6,12,17186,93.28
29753,1,3,2,1,0,0,7,13868,78.23
29754,1,0,1,1,0,0,3,1352,17.01
29755,1,0,1,1,0,0,3,1352,17.01
29756,1,2,0,1,0,0,4,4966,36.77
29757,1,0,0,1,0,0,2,32,3.72
29758,1,0,1,1,0,0,3,1352,17.01
29759,1,0,1,1,0,0,3,1352,17.01
29760,1,1,0,1,0,0,3,1352,17.01
29761,1,0,4,1,1,0,7,13868,78.23
29762,1,1,1,1,0,0,4,4966,36.77
29763,1,2,1,1,0,0,5,8690,54.42
29764,1,1,2,1,0,0,5,8690,54.42
29765,1,3,3,1,0,0,8,15186,83.84
29766,1,2,1,1,0,0,5,8690,54.42
29767,1,0,1,1,0,0,3,1352,17.01
29768,1,1,2,1,0,0,5,8690,54.42
29769,1,2,1,1,0,4,9,15950,87.44
29770,1,2,0,1,0,0,4,4966,36.77
29771,1,0,2,1,0,0,4,4966,36.77
29772,1,1,2,1,0,0,5,8690,54.42
29773,1,0,1,1,0,0,3,1352,17.01
29774,1,0,0,1,0,0,2,32,3.72
29775,1,0,2,1,0,0,4,4966,36.77
29776,1,1,1,1,0,0,4,4966,36.77
29777,1,1,1,1,0,0,4,4966,36.77
29778,1,0,0,1,0,0,2,32,3.72
29780,1,0,0,1,0,0,2,32,3.72
29781,1,1,1,1,0,6,10,16522,90.12
29782,1,1,0,0,0,0,2,32,3.72
29783,1,2,1,1,0,0,5,8690,54.42
29784,1,3,2,1,0,0,7,13868,78.23
29785,1,4,2,1,0,0,8,15186,83.84
29786,1,0,1,1,0,0,3,1352,17.01
29787,1,0,2,1,0,0,4,4966,36.77
29788,1,4,0,1,0,0,6,11521,68.36
29789,1,1,2,1,0,0,5,8690,54.42
29790,1,0,0,1,0,0,2,32,3.72
29791,1,4,0,1,0,0,6,11521,68.36
29792,1,2,1,1,0,0,5,8690,54.42
29793,1,3,0,1,0,0,5,8690,54.42
29794,1,0,1,1,0,0,3,1352,17.01
29795,1,0,2,1,1,0,5,8690,54.42
29796,1,2,0,1,0,0,4,4966,36.77
29797,3,0,4,1,1,0,9,15950,87.44
29798,1,0,5,1,0,0,7,13868,78.23
29799,1,0,3,1,0,0,5,8690,54.42
29800,1,1,2,1,0,0,5,8690,54.42
29801,1,1,2,1,1,0,6,11521,68.36
29802,1,1,1,1,0,0,4,4966,36.77
29803,1,2,0,1,0,0,4,4966,36.77
29804,1,2,0,1,0,0,4,4966,36.77
29805,1,3,1,1,0,0,6,11521,68.36
29806,1,4,1,1,0,0,7,13868,78.23
29807,1,1,0,1,0,0,3,1352,17.01
29808,1,2,0,1,0,0,4,4966,36.77
29809,1,1,2,1,0,0,5,8690,54.42
29810,1,1,1,1,0,6,10,16522,90.12
29811,1,0,1,1,0,0,3,1352,17.01
29812,1,0,1,1,0,0,3,1352,17.01
29813,1,0,2,1,0,0,4,4966,36.77
29814,1,1,2,1,0,0,5,8690,54.42
29815,1,0,5,1,0,0,7,13868,78.23
29816,1,0,3,1,1,0,6,11521,68.36
29817,1,1,1,1,0,0,4,4966,36.77
29818,1,0,1,1,0,0,3,1352,17.01
29819,1,1,1,1,0,0,4,4966,36.77
29820,1,2,1,1,0,0,5,8690,54.42
29821,1,1,2,1,0,0,5,8690,54.42
29822,1,1,2,1,0,0,5,8690,54.42
29823,1,0,1,1,0,0,3,1352,17.01
29824,1,0,1,1,0,0,3,1352,17.01
29825,1,2,2,1,0,0,6,11521,68.36
29826,1,1,0,1,0,0,3,1352,17.01
29827,1,0,1,1,0,0,3,1352,17.01
29828,1,1,1,1,0,0,4,4966,36.77
29829,1,4,0,1,0,0,6,11521,68.36
29830,1,0,2,1,1,0,5,8690,54.42
29831,1,0,1,1,0,0,3,1352,17.01
29832,1,1,1,1,0,0,4,4966,36.77
29833,1,0,1,1,0,0,3,1352,17.01
29834,1,1,1,1,0,0,4,4966,36.77
29835,1,0,1,1,0,0,3,1352,17.01
29836,1,0,1,1,0,0,3,1352,17.01
29837,4,0,5,1,5,0,15,17888,96.85
29838,1,0,3,1,0,0,5,8690,54.42
29839,1,0,1,1,0,0,3,1352,17.01
29840,1,1,0,1,0,0,3,1352,17.01
29841,1,0,3,2,3,0,9,15950,87.44
29842,1,4,1,1,0,0,7,13868,78.23
29843,1,0,1,1,0,2,5,8690,54.42
29844,1,2,1,1,0,0,5,8690,54.42
29845,1,0,4,2,0,0,7,13868,78.23
29846,1,1,0,1,0,0,3,1352,17.01
29847,1,1,1,1,0,0,4,4966,36.77
29848,1,0,1,1,0,0,3,1352,17.01
29849,1,0,2,1,0,0,4,4966,36.77
29850,1,0,3,2,1,0,7,13868,78.23
29851,1,1,1,1,0,0,4,4966,36.77
29852,1,4,0,1,0,0,6,11521,68.36
29853,1,0,1,1,0,0,3,1352,17.01
29854,1,3,0,1,0,0,5,8690,54.42
29855,1,0,1,1,0,0,3,1352,17.01
29856,1,4,0,1,0,0,6,11521,68.36
29857,1,0,1,1,0,0,3,1352,17.01
29858,1,0,3,1,1,0,6,11521,68.36
29859,1,2,1,1,0,0,5,8690,54.42
29860,1,2,1,1,0,0,5,8690,54.42
29861,1,0,1,1,0,0,3,1352,17.01
29862,1,0,1,1,0,0,3,1352,17.01
29863,1,4,0,1,0,0,6,11521,68.36
29864,1,1,1,1,0,0,4,4966,36.77
29865,1,0,0,1,0,0,2,32,3.72
29866,1,2,3,1,0,0,7,13868,78.23
29867,1,1,0,1,0,0,3,1352,17.01
29868,1,0,1,1,0,0,3,1352,17.01
29869,3,1,4,2,4,0,14,17699,95.82
29870,1,2,0,1,0,0,4,4966,36.77
29871,1,0,2,1,0,0,4,4966,36.77
29872,1,0,4,2,2,0,9,15950,87.44
29873,1,1,0,1,0,0,3,1352,17.01
29874,1,5,0,1,0,0,7,13868,78.23
29875,1,4,0,1,0,0,6,11521,68.36
29876,1,1,2,1,0,0,5,8690,54.42
29877,1,1,0,1,0,0,3,1352,17.01
29878,1,1,2,1,0,0,5,8690,54.42
29879,1,2,2,1,0,0,6,11521,68.36
29880,1,0,1,1,0,0,3,1352,17.01
29881,1,4,0,1,0,0,6,11521,68.36
29882,1,1,1,1,0,0,4,4966,36.77
29883,1,4,1,1,0,0,7,13868,78.23
29884,1,0,3,1,0,0,5,8690,54.42
29886,1,0,2,1,1,8,13,17456,94.66
29887,1,0,0,1,0,0,2,32,3.72
29888,1,2,0,0,0,0,3,1352,17.01
29889,1,1,1,1,0,0,4,4966,36.77
29890,1,2,1,1,0,0,5,8690,54.42
29891,1,3,0,1,0,0,5,8690,54.42
29892,1,4,0,1,0,0,6,11521,68.36
29893,1,2,1,1,0,0,5,8690,54.42
29894,1,3,1,1,0,0,6,11521,68.36
29895,1,0,2,2,1,0,6,11521,68.36
29896,1,4,1,1,0,0,7,13868,78.23
29897,1,4,0,1,0,0,6,11521,68.36
29898,1,0,1,1,0,0,3,1352,17.01
29899,1,4,2,1,0,0,8,15186,83.84
29900,1,2,0,2,0,0,5,8690,54.42
29901,1,1,0,1,0,0,3,1352,17.01
29902,1,0,1,1,0,0,3,1352,17.01
29903,3,3,5,2,3,0,16,18081,97.67
29904,1,3,0,1,0,0,5,8690,54.42
29905,1,0,3,1,0,0,5,8690,54.42
29906,1,2,1,1,0,0,5,8690,54.42
29907,1,3,0,1,0,0,5,8690,54.42
29908,1,0,0,1,0,0,2,32,3.72
29909,1,1,0,1,0,0,3,1352,17.01
29910,1,0,2,1,0,0,4,4966,36.77
29911,1,4,1,1,0,0,7,13868,78.23
29912,1,0,0,1,0,0,2,32,3.72
29913,1,0,0,1,0,0,2,32,3.72
29914,3,1,2,1,1,0,8,15186,83.84
29915,1,0,1,1,0,0,3,1352,17.01
29916,1,0,3,1,3,10,18,18287,98.68
29917,1,3,0,1,0,0,5,8690,54.42
29918,1,0,5,2,1,0,9,15950,87.44
29919,1,0,1,1,0,0,3,1352,17.01
29920,1,0,1,1,0,0,3,1352,17.01
29921,1,2,2,1,0,0,6,11521,68.36
29922,1,1,1,1,0,0,4,4966,36.77
29923,1,1,1,1,0,0,4,4966,36.77
29924,1,2,1,1,0,0,5,8690,54.42
29925,1,3,0,1,0,0,5,8690,54.42
29926,1,0,1,1,0,0,3,1352,17.01
29927,1,0,2,1,0,0,4,4966,36.77
29928,1,1,1,1,0,6,10,16522,90.12
29929,1,2,2,1,0,0,6,11521,68.36
29930,1,4,0,1,0,0,6,11521,68.36
29931,1,4,1,1,0,0,7,13868,78.23
29932,1,0,2,1,0,6,10,16522,90.12
29933,1,1,1,1,0,0,4,4966,36.77
29934,1,0,0,1,0,0,2,32,3.72
29935,1,0,1,1,0,0,3,1352,17.01
29936,1,2,2,1,0,0,6,11521,68.36
29937,1,3,0,1,0,0,5,8690,54.42
29938,1,5,1,1,0,0,8,15186,83.84
29939,1,0,0,1,0,0,2,32,3.72
29940,1,1,1,1,0,0,4,4966,36.77
29941,1,0,0,1,0,0,2,32,3.72
29942,1,3,2,2,0,0,8,15186,83.84
29943,1,2,1,1,0,0,5,8690,54.42
29944,1,0,3,1,0,0,5,8690,54.42
29945,1,4,0,1,0,0,6,11521,68.36
29946,1,0,0,1,0,0,2,32,3.72
29947,1,0,1,1,0,0,3,1352,17.01
29948,1,0,0,1,0,0,2,32,3.72
29949,1,2,0,1,0,0,4,4966,36.77
29950,1,1,2,1,0,0,5,8690,54.42
29951,1,0,1,1,0,0,3,1352,17.01
29952,1,3,0,0,0,0,4,4966,36.77
29953,1,0,2,1,0,0,4,4966,36.77
29954,1,0,3,1,1,0,6,11521,68.36
29955,1,0,0,1,0,0,2,32,3.72
29956,1,0,1,1,0,0,3,1352,17.01
29957,1,3,1,1,0,0,6,11521,68.36
29958,1,0,1,1,0,0,3,1352,17.01
29959,1,1,0,1,0,0,3,1352,17.01
29960,1,1,2,1,0,0,5,8690,54.42
29961,1,3,0,1,0,0,5,8690,54.42
29962,1,3,3,2,0,0,9,15950,87.44
29963,1,1,0,1,0,0,3,1352,17.01
29964,1,0,3,1,0,0,5,8690,54.42
29965,1,1,1,1,0,0,4,4966,36.77
29966,1,3,1,1,0,0,6,11521,68.36
29967,1,4,0,1,0,0,6,11521,68.36
29968,1,0,2,1,0,0,4,4966,36.77
29969,1,1,1,1,0,0,4,4966,36.77
29970,1,0,0,0,0,0,1,1,0.08
29971,1,3,0,1,0,0,5,8690,54.42
29972,1,1,1,1,0,0,4,4966,36.77
29973,1,0,1,1,0,0,3,1352,17.01
29974,1,3,1,1,0,0,6,11521,68.36
29975,1,0,4,1,3,0,9,15950,87.44
29976,1,1,0,1,0,6,9,15950,87.44
29977,1,1,0,1,0,0,3,1352,17.01
29978,1,0,2,1,0,4,8,15186,83.84
29979,1,0,2,1,0,0,4,4966,36.77
29980,1,0,1,1,0,4,7,13868,78.23
29981,1,0,1,1,0,0,3,1352,17.01
29982,1,0,0,1,0,0,2,32,3.72
29983,1,1,1,1,0,0,4,4966,36.77
29984,1,2,0,1,0,0,4,4966,36.77
29985,1,1,1,1,0,0,4,4966,36.77
29986,1,2,2,1,0,0,6,11521,68.36
29987,1,0,1,1,0,0,3,1352,17.01
29988,1,1,0,1,0,0,3,1352,17.01
29989,1,2,0,1,0,0,4,4966,36.77
29990,1,2,1,1,0,0,5,8690,54.42
29991,1,0,4,1,1,0,7,13868,78.23
29992,1,0,4,1,3,0,9,15950,87.44
29993,1,0,0,1,0,0,2,32,3.72
29994,1,0,1,1,0,0,3,1352,17.01
29995,1,0,1,1,0,0,3,1352,17.01
29996,1,5,2,2,0,0,10,16522,90.12
29997,1,1,1,1,0,0,4,4966,36.77
29998,1,1,0,1,0,0,3,1352,17.01
29999,1,2,1,1,0,0,5,8690,54.42
30000,1,0,0,1,0,0,2,32,3.72
30001,1,0,2,1,0,6,10,16522,90.12
30002,1,0,0,1,0,0,2,32,3.72
30003,1,0,3,1,0,0,5,8690,54.42
30004,1,3,2,1,0,0,7,13868,78.23
30005,1,1,0,1,0,0,3,1352,17.01
30006,1,4,1,1,0,0,7,13868,78.23
30007,1,0,4,1,1,0,7,13868,78.23
30008,1,0,1,1,0,0,3,1352,17.01
30009,1,4,0,1,0,0,6,11521,68.36
30010,1,4,0,1,0,0,6,11521,68.36
30011,1,4,0,1,0,0,6,11521,68.36
30012,1,0,0,1,0,0,2,32,3.72
30013,1,1,0,1,0,0,3,1352,17.01
30014,1,0,0,1,0,0,2,32,3.72
30015,1,0,0,1,0,4,6,11521,68.36
30016,1,0,1,1,0,0,3,1352,17.01
30017,1,1,1,1,0,0,4,4966,36.77
30018,1,2,1,1,0,0,5,8690,54.42
30019,1,1,2,1,0,0,5,8690,54.42
30020,1,1,2,1,0,0,5,8690,54.42
30021,1,4,1,1,0,0,7,13868,78.23
30022,1,0,0,0,0,0,1,1,0.08
30023,1,0,2,1,1,6,11,16947,91.91
30024,1,1,1,1,0,0,4,4966,36.77
30025,1,0,2,1,0,0,4,4966,36.77
30026,1,0,0,1,0,0,2,32,3.72
30027,1,2,0,1,0,0,4,4966,36.77
30028,1,2,1,1,0,4,9,15950,87.44
30029,1,1,1,1,0,0,4,4966,36.77
30030,1,1,0,1,0,0,3,1352,17.01
30031,1,0,2,1,0,0,4,4966,36.77
30032,1,0,0,1,0,0,2,32,3.72
30033,1,2,0,1,0,0,4,4966,36.77
30034,1,0,2,1,0,0,4,4966,36.77
30036,1,1,1,1,0,0,4,4966,36.77
30038,1,1,1,1,0,6,10,16522,90.12
30040,1,0,1,1,0,0,3,1352,17.01
30041,1,2,0,1,0,0,4,4966,36.77
30042,1,0,2,1,0,0,4,4966,36.77
30043,1,2,0,1,0,0,4,4966,36.77
30044,1,4,0,1,0,0,6,11521,68.36
30045,1,0,0,1,0,0,2,32,3.72
30046,1,0,0,1,0,0,2,32,3.72
30047,1,0,0,1,0,0,2,32,3.72
30048,1,0,0,1,0,0,2,32,3.72
30049,1,0,2,1,2,6,12,17186,93.28
30050,1,0,1,1,0,6,9,15950,87.44
30051,1,0,2,1,0,2,6,11521,68.36
30052,1,2,0,1,0,0,4,4966,36.77
30053,1,0,2,1,0,0,4,4966,36.77
30054,1,1,0,1,0,0,3,1352,17.01
30055,1,0,0,1,0,4,6,11521,68.36
30056,1,2,3,1,0,0,7,13868,78.23
30057,1,0,3,1,0,0,5,8690,54.42
30058,1,0,0,1,0,0,2,32,3.72
30059,1,0,3,1,0,0,5,8690,54.42
30060,1,0,1,1,0,6,9,15950,87.44
30061,1,1,1,1,0,0,4,4966,36.77
30062,1,2,0,1,0,0,4,4966,36.77
30063,1,2,2,1,0,0,6,11521,68.36
30064,1,3,2,1,0,0,7,13868,78.23
30065,1,0,1,1,0,0,3,1352,17.01
30066,1,3,1,1,0,0,6,11521,68.36
30067,1,0,1,1,0,0,3,1352,17.01
30068,1,2,1,1,0,0,5,8690,54.42
30069,1,2,0,1,0,0,4,4966,36.77
30070,1,0,3,1,2,4,11,16947,91.91
30071,1,4,0,1,0,0,6,11521,68.36
30072,1,3,0,1,0,0,5,8690,54.42
30073,1,3,0,1,0,0,5,8690,54.42
30074,1,1,1,1,0,6,10,16522,90.12
30075,1,5,2,2,0,0,10,16522,90.12
30076,1,3,0,1,0,0,5,8690,54.42
30077,1,0,1,1,0,0,3,1352,17.01
30078,1,1,0,1,0,0,3,1352,17.01
30079,1,1,0,1,0,0,3,1352,17.01
30080,1,2,2,2,0,0,7,13868,78.23
30081,1,1,0,1,0,0,3,1352,17.01
30082,1,0,2,1,0,0,4,4966,36.77
30083,1,1,1,1,0,0,4,4966,36.77
30084,1,1,0,1,1,0,4,4966,36.77
30085,1,4,0,1,0,0,6,11521,68.36
30086,1,0,0,1,0,0,2,32,3.72
30087,1,0,2,1,0,0,4,4966,36.77
30088,1,0,1,1,0,0,3,1352,17.01
30089,1,1,0,1,0,0,3,1352,17.01
30090,1,0,4,2,2,6,15,17888,96.85
30091,1,4,0,0,0,0,5,8690,54.42
30092,1,0,1,1,0,0,3,1352,17.01
30093,1,1,0,1,0,0,3,1352,17.01
30094,1,4,0,1,0,0,6,11521,68.36
30095,1,5,3,2,0,0,11,16947,91.91
30096,1,4,2,2,0,0,9,15950,87.44
30097,1,0,2,1,0,0,4,4966,36.77
30098,1,2,0,1,0,0,4,4966,36.77
30099,1,1,0,1,0,0,3,1352,17.01
30100,1,0,0,1,0,0,2,32,3.72
30101,1,4,0,1,0,0,6,11521,68.36
30102,1,0,0,1,0,0,2,32,3.72
30103,1,0,2,1,1,0,5,8690,54.42
30104,1,4,2,1,0,0,8,15186,83.84
30105,1,0,3,1,2,0,7,13868,78.23
30106,1,2,2,1,0,0,6,11521,68.36
30107,1,0,5,1,0,0,7,13868,78.23
30108,1,0,0,1,0,0,2,32,3.72
30109,1,2,0,1,0,0,4,4966,36.77
30110,1,0,1,1,0,0,3,1352,17.01
30111,1,1,0,1,0,0,3,1352,17.01
30112,3,0,5,2,4,0,14,17699,95.82
30113,1,4,1,1,0,0,7,13868,78.23
30114,1,0,2,1,0,0,4,4966,36.77
30115,1,2,0,1,0,0,4,4966,36.77
30116,1,1,0,1,0,0,3,1352,17.01
30117,1,0,2,1,0,4,8,15186,83.84
30118,1,0,2,1,0,0,4,4966,36.77
30119,1,0,1,1,0,0,3,1352,17.01
30120,1,2,0,1,0,0,4,4966,36.77
30121,1,2,1,1,0,0,5,8690,54.42
30122,1,0,1,1,0,0,3,1352,17.01
30123,1,2,1,1,0,0,5,8690,54.42
30124,1,2,1,1,0,0,5,8690,54.42
30125,1,1,1,1,0,0,4,4966,36.77
30126,1,0,1,1,0,0,3,1352,17.01
30127,1,0,3,1,0,0,5,8690,54.42
30128,1,0,1,1,0,6,9,15950,87.44
30129,1,1,2,1,0,6,11,16947,91.91
30130,1,1,0,1,0,0,3,1352,17.01
30131,1,5,0,1,0,0,7,13868,78.23
30132,1,1,3,1,3,0,9,15950,87.44
30133,1,0,2,1,1,0,5,8690,54.42
30134,1,0,1,1,0,0,3,1352,17.01
30135,1,2,0,1,0,0,4,4966,36.77
30136,1,0,0,1,0,6,8,15186,83.84
30137,1,1,1,1,0,0,4,4966,36.77
30138,1,0,0,1,0,0,2,32,3.72
30139,1,0,0,1,0,0,2,32,3.72
30141,1,0,0,1,0,0,2,32,3.72
30142,1,3,1,1,0,0,6,11521,68.36
30143,1,1,0,1,0,0,3,1352,17.01
30144,1,0,1,1,0,0,3,1352,17.01
30145,1,2,1,1,0,0,5,8690,54.42
30146,1,3,0,1,0,0,5,8690,54.42
30147,1,4,0,1,1,0,7,13868,78.23
30148,1,0,1,1,0,0,3,1352,17.01
30150,1,1,1,1,0,0,4,4966,36.77
30151,1,0,2,1,1,6,11,16947,91.91
30152,1,0,3,1,1,0,6,11521,68.36
30153,1,1,1,1,0,0,4,4966,36.77
30154,1,0,1,1,0,0,3,1352,17.01
30155,1,0,0,1,0,0,2,32,3.72
30156,1,0,1,1,0,0,3,1352,17.01
30157,1,2,0,1,0,0,4,4966,36.77
30158,1,3,0,1,0,0,5,8690,54.42
30159,1,1,1,1,0,2,6,11521,68.36
30160,1,4,0,1,0,0,6,11521,68.36
30161,1,0,1,1,0,0,3,1352,17.01
30162,1,2,2,1,0,0,6,11521,68.36
30163,1,5,0,1,0,0,7,13868,78.23
30164,1,0,1,1,0,0,3,1352,17.01
30165,1,0,2,1,0,0,4,4966,36.77
30166,1,0,2,1,0,0,4,4966,36.77
30167,1,0,1,1,0,0,3,1352,17.01
30168,1,1,0,1,0,0,3,1352,17.01
30169,1,1,1,1,0,0,4,4966,36.77
30170,1,2,2,1,0,0,6,11521,68.36
30171,1,0,1,1,0,0,3,1352,17.01
30172,1,0,0,1,0,0,2,32,3.72
30173,1,0,1,1,0,0,3,1352,17.01
30174,1,1,0,1,0,0,3,1352,17.01
30175,1,0,4,1,1,0,7,13868,78.23
30176,1,2,0,1,0,0,4,4966,36.77
30177,1,2,0,1,0,0,4,4966,36.77
30178,1,0,1,1,0,0,3,1352,17.01
30179,1,0,1,1,0,0,3,1352,17.01
30180,1,0,1,1,0,0,3,1352,17.01
30181,1,0,0,1,0,0,2,32,3.72
30182,1,5,0,1,0,0,7,13868,78.23
30183,1,0,2,1,0,0,4,4966,36.77
30184,1,1,1,1,0,0,4,4966,36.77
30185,1,2,0,0,0,0,3,1352,17.01
30186,1,0,3,1,1,0,6,11521,68.36
30187,1,0,1,1,0,0,3,1352,17.01
30188,1,3,1,1,0,0,6,11521,68.36
30189,1,0,2,1,0,0,4,4966,36.77
30190,1,0,1,1,0,0,3,1352,17.01
30191,1,2,1,1,0,0,5,8690,54.42
30192,1,2,0,1,0,0,4,4966,36.77
30193,1,4,0,1,0,0,6,11521,68.36
30194,1,0,1,1,0,4,7,13868,78.23
30195,1,4,0,1,0,0,6,11521,68.36
30196,1,1,1,1,0,0,4,4966,36.77
30197,1,0,1,1,0,0,3,1352,17.01
30198,1,1,0,1,0,0,3,1352,17.01
30199,1,0,0,1,0,2,4,4966,36.77
30200,1,1,1,1,0,0,4,4966,36.77
30201,1,1,1,1,0,0,4,4966,36.77
30202,1,1,0,1,0,0,3,1352,17.01
30203,1,1,0,1,0,0,3,1352,17.01
30204,1,1,0,1,0,0,3,1352,17.01
30205,1,0,2,1,2,6,12,17186,93.28
30206,1,0,0,1,0,4,6,11521,68.36
30207,1,4,2,1,0,0,8,15186,83.84
30208,1,1,1,1,0,0,4,4966,36.77
30209,1,1,1,1,0,0,4,4966,36.77
30210,1,0,1,1,0,0,3,1352,17.01
30211,1,0,3,1,0,0,5,8690,54.42
30212,1,0,2,1,0,0,4,4966,36.77
30213,1,0,2,1,0,0,4,4966,36.77
30214,1,0,0,1,0,0,2,32,3.72
30215,1,0,0,1,0,0,2,32,3.72
30216,1,0,0,1,0,0,2,32,3.72
30217,1,4,0,1,0,0,6,11521,68.36
30218,1,0,1,1,0,0,3,1352,17.01
30219,1,4,0,1,0,0,6,11521,68.36
30220,1,1,0,1,0,0,3,1352,17.01
30221,1,4,0,1,0,0,6,11521,68.36
30222,1,1,1,1,0,0,4,4966,36.77
30223,1,0,1,1,0,0,3,1352,17.01
30224,1,1,0,1,0,0,3,1352,17.01
30225,1,2,1,1,0,0,5,8690,54.42
30226,1,1,1,1,0,0,4,4966,36.77
30227,1,0,3,1,1,0,6,11521,68.36
30228,1,2,0,1,0,0,4,4966,36.77
30229,1,0,1,1,0,6,9,15950,87.44
30230,1,2,0,1,0,0,4,4966,36.77
30231,1,0,0,1,0,0,2,32,3.72
30232,1,0,0,1,0,0,2,32,3.72
30233,1,2,1,1,0,0,5,8690,54.42
30234,1,2,1,1,0,0,5,8690,54.42
30235,1,0,0,1,0,0,2,32,3.72
30236,1,0,1,1,1,0,4,4966,36.77
30237,1,4,0,1,0,0,6,11521,68.36
30238,1,4,0,1,0,0,6,11521,68.36
30240,1,0,2,1,0,0,4,4966,36.77
30241,1,4,1,1,0,0,7,13868,78.23
30242,1,0,1,1,0,0,3,1352,17.01
30243,1,0,1,1,0,0,3,1352,17.01
30244,1,0,1,1,0,0,3,1352,17.01
30245,1,0,2,1,0,0,4,4966,36.77
30246,1,1,0,1,0,0,3,1352,17.01
30247,1,0,2,1,0,6,10,16522,90.12
30248,1,2,0,1,0,0,4,4966,36.77
30249,1,2,1,1,0,0,5,8690,54.42
30250,1,1,1,1,0,0,4,4966,36.77
30251,1,0,4,1,1,0,7,13868,78.23
30252,1,0,1,1,0,4,7,13868,78.23
30253,1,0,2,1,0,0,4,4966,36.77
30254,1,0,3,1,0,0,5,8690,54.42
30255,1,0,5,1,1,0,8,15186,83.84
30256,1,0,0,1,0,0,2,32,3.72
30257,1,2,1,1,0,0,5,8690,54.42
30258,1,2,2,1,0,0,6,11521,68.36
30259,1,0,1,1,0,0,3,1352,17.01
30260,1,2,0,1,0,0,4,4966,36.77
30261,1,4,0,1,0,0,6,11521,68.36
30262,1,0,1,1,0,0,3,1352,17.01
30263,1,0,1,1,0,0,3,1352,17.01
30264,1,0,1,1,0,0,3,1352,17.01
30265,1,0,1,1,0,0,3,1352,17.01
30266,1,0,2,1,0,0,4,4966,36.77
30267,1,2,0,1,0,0,4,4966,36.77
30268,1,2,2,1,0,0,6,11521,68.36
30269,1,0,2,1,0,6,10,16522,90.12
30270,1,1,0,1,0,0,3,1352,17.01
30271,1,0,2,1,1,0,5,8690,54.42
30272,1,0,2,1,0,0,4,4966,36.77
30273,1,0,1,1,0,0,3,1352,17.01
30274,3,3,5,3,3,0,17,18193,98.23
30275,1,4,1,1,0,0,7,13868,78.23
30276,1,5,0,1,0,0,7,13868,78.23
30277,1,3,0,1,0,0,5,8690,54.42
30278,1,0,1,1,0,0,3,1352,17.01
30279,1,4,0,1,0,0,6,11521,68.36
30280,1,1,1,1,0,0,4,4966,36.77
30281,1,0,1,1,0,0,3,1352,17.01
30282,1,4,1,1,0,0,7,13868,78.23
30283,1,0,3,1,0,0,5,8690,54.42
30284,1,0,2,1,0,0,4,4966,36.77
30285,1,1,3,2,0,0,7,13868,78.23
30286,1,3,1,1,0,0,6,11521,68.36
30287,1,0,2,1,0,6,10,16522,90.12
30288,1,4,0,1,0,0,6,11521,68.36
30289,1,4,0,1,0,0,6,11521,68.36
30290,1,1,1,1,0,0,4,4966,36.77
30291,3,0,5,1,3,4,16,18081,97.67
30292,1,1,1,1,0,10,14,17699,95.82
30293,1,1,1,1,0,0,4,4966,36.77
30294,1,0,0,1,1,0,3,1352,17.01
30296,1,1,0,1,0,0,3,1352,17.01
30297,1,0,3,1,0,0,5,8690,54.42
30298,1,0,1,1,0,4,7,13868,78.23
30299,1,0,2,1,0,0,4,4966,36.77
30300,1,2,0,1,0,0,4,4966,36.77
30301,1,1,0,1,0,0,3,1352,17.01
30302,1,1,1,1,0,0,4,4966,36.77
30303,1,0,1,1,0,4,7,13868,78.23
30304,1,0,2,1,0,0,4,4966,36.77
30305,1,2,1,1,0,0,5,8690,54.42
30306,1,1,0,1,0,0,3,1352,17.01
30307,1,0,2,1,0,0,4,4966,36.77
30308,1,2,0,1,0,0,4,4966,36.77
30309,1,0,1,1,0,0,3,1352,17.01
30310,1,1,0,1,0,0,3,1352,17.01
30311,1,1,0,1,0,0,3,1352,17.01
30312,1,2,0,1,0,0,4,4966,36.77
30313,1,4,0,1,0,0,6,11521,68.36
30314,1,0,4,1,3,0,9,15950,87.44
30315,1,2,2,1,0,0,6,11521,68.36
30316,1,0,2,1,0,0,4,4966,36.77
30317,1,0,4,2,0,0,7,13868,78.23
30318,1,0,2,1,0,0,4,4966,36.77
30319,1,3,2,1,0,0,7,13868,78.23
30320,1,1,1,1,0,0,4,4966,36.77
30321,1,0,2,1,0,0,4,4966,36.77
30322,1,0,2,1,0,0,4,4966,36.77
30323,1,0,1,1,0,0,3,1352,17.01
30324,1,1,0,1,0,2,5,8690,54.42
30325,1,1,1,1,0,0,4,4966,36.77
30326,1,1,0,0,0,0,2,32,3.72
30327,1,0,1,1,0,0,3,1352,17.01
30328,1,0,1,1,0,2,5,8690,54.42
30329,1,1,0,1,0,2,5,8690,54.42
30330,1,1,2,1,0,0,5,8690,54.42
30331,1,0,1,1,0,0,3,1352,17.01
30332,1,0,1,1,0,0,3,1352,17.01
30333,1,0,3,2,0,0,6,11521,68.36
30334,1,4,0,1,0,0,6,11521,68.36
30335,1,2,1,1,0,0,5,8690,54.42
30336,1,1,1,1,0,0,4,4966,36.77
30337,1,1,0,1,0,0,3,1352,17.01
30338,1,4,0,1,0,0,6,11521,68.36
30339,1,1,0,1,0,0,3,1352,17.01
30340,1,1,0,1,0,0,3,1352,17.01
30341,1,0,2,1,0,0,4,4966,36.77
30343,1,2,2,1,0,0,6,11521,68.36
30344,1,3,0,1,0,0,5,8690,54.42
30345,1,4,0,1,0,0,6,11521,68.36
30346,1,2,0,1,1,0,5,8690,54.42
30347,1,0,2,1,3,0,7,13868,78.23
30348,1,0,1,1,0,0,3,1352,17.01
30349,1,3,0,1,0,0,5,8690,54.42
30350,1,3,0,1,0,0,5,8690,54.42
30351,1,3,0,1,0,0,5,8690,54.42
30352,1,2,0,1,0,0,4,4966,36.77
30353,1,3,1,1,0,0,6,11521,68.36
30354,1,0,4,1,1,10,17,18193,98.23
30355,1,1,1,1,0,0,4,4966,36.77
30356,1,0,1,1,0,0,3,1352,17.01
30357,1,4,0,0,0,0,5,8690,54.42
30358,1,3,1,0,0,0,5,8690,54.42
30359,1,5,2,2,0,0,10,16522,90.12
30360,1,0,2,1,0,0,4,4966,36.77
30361,1,0,0,1,0,0,2,32,3.72
30362,1,0,0,1,0,0,2,32,3.72
30364,1,1,1,1,0,0,4,4966,36.77
30365,1,0,1,1,0,0,3,1352,17.01
30366,1,4,0,1,0,0,6,11521,68.36
30367,1,3,0,1,0,0,5,8690,54.42
30368,1,4,1,1,0,0,7,13868,78.23
30369,1,4,0,1,0,0,6,11521,68.36
30370,1,4,0,1,0,0,6,11521,68.36
30371,1,1,0,1,0,0,3,1352,17.01
30372,1,2,0,1,0,0,4,4966,36.77
30373,1,1,2,1,0,0,5,8690,54.42
30374,1,0,0,1,0,0,2,32,3.72
30375,1,4,0,1,0,0,6,11521,68.36
30376,1,1,1,1,0,0,4,4966,36.77
30377,1,2,0,1,0,0,4,4966,36.77
30378,1,0,1,1,0,0,3,1352,17.01
30379,1,0,3,1,0,6,11,16947,91.91
30380,1,4,1,1,0,0,7,13868,78.23
30381,3,3,4,3,2,0,15,17888,96.85
30382,1,3,0,1,0,0,5,8690,54.42
30383,1,0,1,1,0,0,3,1352,17.01
30384,1,0,2,1,1,0,5,8690,54.42
30385,1,1,0,1,0,8,11,16947,91.91
30386,1,0,0,1,0,0,2,32,3.72
30387,1,2,0,1,0,0,4,4966,36.77
30388,1,0,2,1,0,0,4,4966,36.77
30389,1,4,0,1,0,0,6,11521,68.36
30390,1,2,2,1,0,0,6,11521,68.36
30391,1,1,2,1,0,0,5,8690,54.42
30392,1,0,0,0,0,0,1,1,0.08
30393,1,2,0,1,0,0,4,4966,36.77
30394,1,0,2,1,0,0,4,4966,36.77
30395,1,2,0,1,0,0,4,4966,36.77
30396,1,0,4,1,1,6,13,17456,94.66
30397,3,0,3,1,3,6,16,18081,97.67
30398,1,0,1,1,0,0,3,1352,17.01
30399,1,0,1,1,0,0,3,1352,17.01
30400,1,2,0,1,0,0,4,4966,36.77
30401,1,3,1,1,0,0,6,11521,68.36
30402,1,0,2,1,0,6,10,16522,90.12
30403,1,1,1,1,0,0,4,4966,36.77
30404,1,1,0,1,0,0,3,1352,17.01
30405,1,0,3,1,1,8,14,17699,95.82
30406,1,0,0,1,0,0,2,32,3.72
30407,1,0,0,1,0,0,2,32,3.72
30408,1,0,1,1,0,0,3,1352,17.01
30409,1,0,1,1,0,0,3,1352,17.01
30410,1,2,2,1,0,0,6,11521,68.36
30411,1,0,1,1,0,4,7,13868,78.23
30412,1,0,1,1,0,0,3,1352,17.01
30413,1,2,1,1,0,0,5,8690,54.42
30414,1,1,0,1,0,0,3,1352,17.01
30415,1,0,2,1,1,0,5,8690,54.42
30416,1,1,1,1,0,0,4,4966,36.77
30417,1,0,2,1,1,0,5,8690,54.42
30418,1,3,1,1,0,0,6,11521,68.36
30419,1,2,2,1,0,0,6,11521,68.36
30420,1,2,1,1,0,0,5,8690,54.42
30421,1,0,1,1,0,0,3,1352,17.01
30422,1,0,2,1,0,0,4,4966,36.77
30423,1,1,0,1,0,0,3,1352,17.01
30424,1,0,2,1,1,0,5,8690,54.42
30425,1,0,3,1,0,0,5,8690,54.42
30426,1,1,0,1,0,0,3,1352,17.01
30427,1,1,1,1,0,0,4,4966,36.77
30428,1,1,1,1,0,0,4,4966,36.77
30429,1,0,3,1,1,0,6,11521,68.36
30430,1,0,0,1,0,0,2,32,3.72
30431,1,0,4,1,2,0,8,15186,83.84
30432,1,4,0,1,0,0,6,11521,68.36
30433,1,0,1,1,2,0,5,8690,54.42
30434,1,1,0,1,0,0,3,1352,17.01
30435,1,0,1,1,0,0,3,1352,17.01
30436,1,1,0,1,0,0,3,1352,17.01
30437,1,0,0,1,0,0,2,32,3.72
30438,1,0,1,1,0,0,3,1352,17.01
30439,1,2,1,1,0,0,5,8690,54.42
30440,1,1,2,1,0,0,5,8690,54.42
30441,1,2,0,1,0,0,4,4966,36.77
30442,1,3,0,1,0,0,5,8690,54.42
30443,1,0,1,1,0,0,3,1352,17.01
30444,1,5,2,1,0,0,9,15950,87.44
30445,1,2,1,1,0,0,5,8690,54.42
30446,1,1,1,1,0,6,10,16522,90.12
30447,3,1,4,2,5,0,15,17888,96.85
30448,1,2,1,1,0,0,5,8690,54.42
30449,1,1,1,1,0,0,4,4966,36.77
30450,1,0,0,1,0,0,2,32,3.72
30451,1,1,0,1,0,0,3,1352,17.01
30452,1,0,0,1,0,0,2,32,3.72
30453,1,2,1,1,0,0,5,8690,54.42
30454,1,1,1,1,0,0,4,4966,36.77
30455,1,2,0,1,0,0,4,4966,36.77
30457,1,1,2,1,0,0,5,8690,54.42
30458,1,1,0,1,0,0,3,1352,17.01
30459,1,1,1,1,0,0,4,4966,36.77
30460,1,0,3,1,2,6,13,17456,94.66
30461,1,1,1,1,0,0,4,4966,36.77
30462,1,1,1,1,0,0,4,4966,36.77
30463,1,0,1,1,0,0,3,1352,17.01
30464,1,2,0,1,0,0,4,4966,36.77
30465,1,0,2,1,0,0,4,4966,36.77
30466,1,0,1,1,0,0,3,1352,17.01
30467,1,0,1,1,0,4,7,13868,78.23
30468,1,4,1,1,0,0,7,13868,78.23
30469,1,5,2,2,0,0,10,16522,90.12
30470,1,0,1,1,0,0,3,1352,17.01
30471,1,1,0,1,0,0,3,1352,17.01
30472,1,0,1,1,0,0,3,1352,17.01
30473,1,1,2,1,0,0,5,8690,54.42
30474,1,0,1,1,0,0,3,1352,17.01
30475,1,0,2,1,1,0,5,8690,54.42
30476,1,0,0,1,0,0,2,32,3.72
30477,1,0,1,1,0,0,3,1352,17.01
30478,1,0,0,1,0,0,2,32,3.72
30479,1,2,1,1,0,0,5,8690,54.42
30480,1,0,2,1,1,0,5,8690,54.42
30481,1,4,0,1,0,0,6,11521,68.36
30482,1,1,1,1,0,0,4,4966,36.77
30483,1,2,0,0,0,0,3,1352,17.01
30484,1,5,2,2,0,0,10,16522,90.12
30485,1,0,2,1,0,4,8,15186,83.84
30486,1,3,0,1,0,0,5,8690,54.42
30487,1,2,1,1,0,0,5,8690,54.42
30488,1,0,2,1,1,8,13,17456,94.66
30489,1,3,1,1,0,0,6,11521,68.36
30490,1,1,1,1,0,6,10,16522,90.12
30491,1,0,1,1,0,0,3,1352,17.01
30492,1,0,0,1,0,0,2,32,3.72
30493,1,4,0,1,0,0,6,11521,68.36
30494,1,2,1,1,0,0,5,8690,54.42
30495,1,2,2,1,0,0,6,11521,68.36
30496,1,0,2,1,0,0,4,4966,36.77
30497,1,1,2,1,0,0,5,8690,54.42
30498,1,3,0,1,0,0,5,8690,54.42
30499,1,0,3,1,0,0,5,8690,54.42
30500,1,4,0,1,0,0,6,11521,68.36
30501,1,5,1,1,0,0,8,15186,83.84
30502,1,1,1,1,0,0,4,4966,36.77
30503,1,4,0,1,0,0,6,11521,68.36
30504,1,0,0,1,0,0,2,32,3.72
30505,1,0,1,1,0,0,3,1352,17.01
30506,1,0,4,1,2,0,8,15186,83.84
30507,1,1,0,1,0,0,3,1352,17.01
30508,1,4,0,1,0,0,6,11521,68.36
30509,1,1,1,1,0,0,4,4966,36.77
30510,1,0,3,1,1,0,6,11521,68.36
30511,1,1,1,2,0,0,5,8690,54.42
30512,1,1,1,1,0,0,4,4966,36.77
30513,1,2,1,1,0,6,11,16947,91.91
30514,1,0,0,1,0,0,2,32,3.72
30515,1,0,1,1,0,0,3,1352,17.01
30516,1,3,1,1,0,4,10,16522,90.12
30517,1,3,0,1,0,0,5,8690,54.42
30518,1,2,2,1,0,0,6,11521,68.36
30519,1,0,1,1,0,0,3,1352,17.01
30520,1,0,1,1,0,0,3,1352,17.01
30521,1,0,0,1,0,0,2,32,3.72
30522,1,0,1,1,0,0,3,1352,17.01
30523,1,0,0,1,2,0,4,4966,36.77
30524,1,4,0,1,0,0,6,11521,68.36
30525,1,0,1,1,0,0,3,1352,17.01
30526,1,0,1,1,0,0,3,1352,17.01
30527,1,0,2,1,0,0,4,4966,36.77
30528,1,4,1,1,0,0,7,13868,78.23
30529,1,4,1,1,0,0,7,13868,78.23
30530,1,3,3,1,0,0,8,15186,83.84
30531,1,0,2,1,0,0,4,4966,36.77
30532,1,0,0,1,0,0,2,32,3.72
30533,1,1,1,1,0,0,4,4966,36.77
30534,1,0,1,1,0,0,3,1352,17.01
30535,1,4,0,1,0,0,6,11521,68.36
30536,1,0,1,1,0,0,3,1352,17.01
30537,1,1,0,1,0,0,3,1352,17.01
30538,1,0,1,1,0,0,3,1352,17.01
30539,1,0,1,1,0,0,3,1352,17.01
30540,1,2,1,1,0,0,5,8690,54.42
30541,1,2,1,1,0,0,5,8690,54.42
30542,1,3,0,1,0,0,5,8690,54.42
30543,1,0,1,1,0,0,3,1352,17.01
30544,1,1,2,1,0,0,5,8690,54.42
30545,3,0,3,1,1,0,8,15186,83.84
30546,1,0,2,1,2,0,6,11521,68.36
30547,1,4,0,1,0,0,6,11521,68.36
30548,1,1,1,1,0,0,4,4966,36.77
30549,1,2,0,1,0,0,4,4966,36.77
30550,1,4,0,1,0,0,6,11521,68.36
30551,1,1,2,1,0,0,5,8690,54.42
30552,1,0,3,2,3,0,9,15950,87.44
30553,1,4,0,1,0,0,6,11521,68.36
30554,1,0,2,1,0,0,4,4966,36.77
30555,1,0,3,1,0,0,5,8690,54.42
30556,1,0,3,1,0,0,5,8690,54.42
30557,1,1,1,1,0,0,4,4966,36.77
30558,1,0,0,1,0,0,2,32,3.72
30559,1,0,0,1,0,0,2,32,3.72
30560,1,2,0,0,0,0,3,1352,17.01
30561,1,4,0,1,0,0,6,11521,68.36
30562,1,0,2,1,0,0,4,4966,36.77
30563,1,1,1,1,0,0,4,4966,36.77
30564,1,0,1,1,0,0,3,1352,17.01
30565,1,0,1,1,0,0,3,1352,17.01
30566,1,2,1,1,0,0,5,8690,54.42
30567,1,5,0,1,0,0,7,13868,78.23
30568,1,0,1,1,0,0,3,1352,17.01
30569,1,4,0,2,0,0,7,13868,78.23
30570,1,0,0,1,0,0,2,32,3.72
30571,1,0,3,1,0,0,5,8690,54.42
30572,1,1,1,1,0,0,4,4966,36.77
30573,1,0,1,1,0,6,9,15950,87.44
30574,1,2,0,1,0,0,4,4966,36.77
30575,1,4,0,1,0,0,6,11521,68.36
30576,1,0,1,1,0,0,3,1352,17.01
30577,1,0,2,1,0,0,4,4966,36.77
30578,1,0,2,1,0,0,4,4966,36.77
30579,1,1,1,1,0,0,4,4966,36.77
30580,1,1,2,1,0,0,5,8690,54.42
30581,1,2,0,1,0,0,4,4966,36.77
30582,1,0,1,1,0,0,3,1352,17.01
30583,1,0,0,1,0,0,2,32,3.72
30584,1,4,0,1,0,0,6,11521,68.36
30585,1,4,1,1,0,0,7,13868,78.23
30586,1,0,3,1,1,0,6,11521,68.36
30587,1,0,1,1,0,0,3,1352,17.01
30588,1,0,0,1,0,0,2,32,3.72
30589,1,0,1,1,0,0,3,1352,17.01
30590,1,1,0,1,0,0,3,1352,17.01
30591,1,1,1,1,0,0,4,4966,36.77
30592,1,1,2,1,0,0,5,8690,54.42
30593,1,2,1,1,0,0,5,8690,54.42
30594,1,0,1,1,1,10,14,17699,95.82
30595,1,0,1,1,0,0,3,1352,17.01
30596,1,2,2,1,0,0,6,11521,68.36
30597,1,0,2,1,0,0,4,4966,36.77
30598,1,0,1,1,0,0,3,1352,17.01
30599,1,0,1,1,0,0,3,1352,17.01
30600,1,0,2,1,0,0,4,4966,36.77
30601,1,1,0,0,0,0,2,32,3.72
30602,1,4,0,1,0,0,6,11521,68.36
30603,1,1,0,1,0,0,3,1352,17.01
30604,1,5,0,1,0,0,7,13868,78.23
30605,1,2,0,1,0,0,4,4966,36.77
30606,1,1,1,1,0,0,4,4966,36.77
30607,1,2,1,1,0,0,5,8690,54.42
30608,1,0,1,1,0,0,3,1352,17.01
30609,1,2,1,1,0,0,5,8690,54.42
30610,1,5,2,1,0,0,9,15950,87.44
30611,1,0,3,1,2,0,7,13868,78.23
30612,1,0,1,1,0,0,3,1352,17.01
30613,1,4,0,1,0,0,6,11521,68.36
30614,1,1,0,1,0,0,3,1352,17.01
30615,1,1,1,1,0,4,8,15186,83.84
30616,1,3,0,1,0,0,5,8690,54.42
30617,1,4,0,1,0,0,6,11521,68.36
30618,1,1,1,1,0,0,4,4966,36.77
30619,1,0,0,1,0,6,8,15186,83.84
30620,1,1,1,1,0,0,4,4966,36.77
30621,1,2,1,1,0,0,5,8690,54.42
30622,1,2,3,1,0,0,7,13868,78.23
30623,1,2,1,1,0,0,5,8690,54.42
30624,1,2,0,1,0,0,4,4966,36.77
30625,1,0,1,1,0,0,3,1352,17.01
30626,1,0,0,1,0,0,2,32,3.72
30627,1,1,1,1,0,0,4,4966,36.77
30628,1,0,0,1,0,0,2,32,3.72
30629,1,0,3,1,0,0,5,8690,54.42
30630,1,1,0,1,0,0,3,1352,17.01
30631,1,0,1,1,0,4,7,13868,78.23
30632,1,0,0,1,0,0,2,32,3.72
30633,1,0,2,1,0,0,4,4966,36.77
30634,1,0,2,1,0,0,4,4966,36.77
30635,1,2,2,1,0,0,6,11521,68.36
30636,1,3,1,1,0,0,6,11521,68.36
30637,1,3,1,1,0,0,6,11521,68.36
30638,1,1,1,1,0,0,4,4966,36.77
30639,1,2,0,1,0,0,4,4966,36.77
30640,1,2,0,1,0,0,4,4966,36.77
30641,1,1,2,1,0,0,5,8690,54.42
30642,1,3,1,1,0,0,6,11521,68.36
30643,1,4,2,2,0,0,9,15950,87.44
30644,1,1,3,2,0,0,7,13868,78.23
30645,1,2,1,1,0,0,5,8690,54.42
30646,1,4,0,1,0,0,6,11521,68.36
30647,1,1,0,1,3,0,6,11521,68.36
30648,1,4,2,1,0,0,8,15186,83.84
30649,1,0,0,1,0,0,2,32,3.72
30650,1,4,4,2,0,0,11,16947,91.91
30651,1,0,2,1,0,0,4,4966,36.77
30652,1,1,1,1,0,0,4,4966,36.77
30653,1,1,1,1,0,2,6,11521,68.36
30654,1,2,2,1,0,6,12,17186,93.28
30655,1,1,1,1,0,0,4,4966,36.77
30656,1,2,1,1,0,0,5,8690,54.42
30657,1,1,1,1,0,0,4,4966,36.77
30658,1,1,1,1,0,0,4,4966,36.77
30659,1,0,1,1,0,0,3,1352,17.01
30660,1,0,3,1,0,0,5,8690,54.42
30661,1,1,2,1,0,0,5,8690,54.42
30662,1,0,1,1,0,0,3,1352,17.01
30663,3,0,4,1,1,8,17,18193,98.23
30664,1,4,0,1,0,0,6,11521,68.36
30665,1,0,0,1,0,0,2,32,3.72
30666,1,4,0,1,0,0,6,11521,68.36
30667,1,3,1,1,0,0,6,11521,68.36
30668,1,2,2,1,0,0,6,11521,68.36
30669,1,0,0,1,0,0,2,32,3.72
30670,1,0,1,1,0,0,3,1352,17.01
30671,1,3,0,1,0,0,5,8690,54.42
30672,1,1,0,1,0,0,3,1352,17.01
30673,1,0,2,1,2,4,10,16522,90.12
30674,1,1,1,1,0,0,4,4966,36.77
30675,1,0,1,1,0,2,5,8690,54.42
30676,1,2,1,1,0,0,5,8690,54.42
30677,1,1,3,1,0,0,6,11521,68.36
30678,1,0,1,1,1,0,4,4966,36.77
30679,1,5,2,2,0,0,10,16522,90.12
30680,1,0,0,1,0,0,2,32,3.72
30681,1,2,0,1,0,0,4,4966,36.77
30682,1,1,0,1,0,0,3,1352,17.01
30683,1,0,0,1,0,0,2,32,3.72
30684,1,1,2,1,0,0,5,8690,54.42
30685,1,0,1,1,0,0,3,1352,17.01
30686,1,0,0,1,0,0,2,32,3.72
30687,1,0,1,1,1,0,4,4966,36.77
30688,1,3,1,1,0,0,6,11521,68.36
30689,1,0,2,1,0,6,10,16522,90.12
30690,1,0,1,1,0,0,3,1352,17.01
30691,1,3,1,1,0,0,6,11521,68.36
30692,3,0,4,1,1,6,15,17888,96.85
30693,1,2,1,1,0,0,5,8690,54.42
30694,1,1,1,1,0,0,4,4966,36.77
30695,1,0,3,1,0,0,5,8690,54.42
30696,1,1,1,1,0,0,4,4966,36.77
30697,1,1,0,1,0,0,3,1352,17.01
30698,1,2,0,1,0,0,4,4966,36.77
30699,1,0,5,2,1,0,9,15950,87.44
30700,1,0,1,1,0,6,9,15950,87.44
30701,1,3,0,1,0,0,5,8690,54.42
30702,1,1,0,1,0,2,5,8690,54.42
30703,1,3,2,1,0,0,7,13868,78.23
30704,1,3,0,1,0,0,5,8690,54.42
30705,1,1,1,1,0,0,4,4966,36.77
30706,1,1,2,1,0,0,5,8690,54.42
30707,1,2,1,1,0,0,5,8690,54.42
30708,1,4,0,1,0,0,6,11521,68.36
30709,1,1,0,1,0,0,3,1352,17.01
30710,1,0,2,1,0,0,4,4966,36.77
30711,1,1,1,1,0,0,4,4966,36.77
30712,1,2,1,1,0,0,5,8690,54.42
30713,1,0,2,1,0,4,8,15186,83.84
30714,1,0,1,1,0,0,3,1352,17.01
30715,1,1,1,1,0,0,4,4966,36.77
30716,1,2,0,1,0,0,4,4966,36.77
30717,1,0,0,1,0,0,2,32,3.72
30718,1,1,0,1,0,0,3,1352,17.01
30719,1,0,1,1,0,0,3,1352,17.01
30720,1,1,1,1,0,4,8,15186,83.84
30721,1,2,0,1,0,0,4,4966,36.77
30722,1,2,0,1,0,0,4,4966,36.77
30723,1,1,1,1,0,2,6,11521,68.36
30724,1,2,1,1,0,0,5,8690,54.42
30725,1,0,1,1,0,0,3,1352,17.01
30726,1,4,2,1,0,0,8,15186,83.84
30727,1,0,4,1,1,0,7,13868,78.23
30728,1,3,0,1,0,0,5,8690,54.42
30729,1,3,3,1,0,0,8,15186,83.84
30730,1,0,0,1,0,0,2,32,3.72
30731,1,1,0,1,0,0,3,1352,17.01
30732,1,4,0,2,0,0,7,13868,78.23
30733,1,3,0,1,0,0,5,8690,54.42
30734,1,0,1,1,0,0,3,1352,17.01
30735,1,5,1,1,0,0,8,15186,83.84
30736,1,0,1,1,0,0,3,1352,17.01
30737,1,2,2,1,0,0,6,11521,68.36
30738,1,1,1,1,0,0,4,4966,36.77
30739,1,3,1,1,0,0,6,11521,68.36
30740,1,0,4,1,1,0,7,13868,78.23
30741,1,0,1,1,0,0,3,1352,17.01
30742,1,0,2,1,0,0,4,4966,36.77
30743,1,1,1,1,0,0,4,4966,36.77
30744,1,1,1,1,0,0,4,4966,36.77
30745,1,1,1,1,0,0,4,4966,36.77
30746,1,0,1,1,0,0,3,1352,17.01
30747,1,1,1,1,0,0,4,4966,36.77
30748,1,4,3,2,0,0,10,16522,90.12
30749,1,4,0,1,0,0,6,11521,68.36
30750,1,3,0,1,0,0,5,8690,54.42
30751,1,0,0,1,0,0,2,32,3.72
30752,1,2,1,1,0,0,5,8690,54.42
30753,1,0,1,1,0,0,3,1352,17.01
30754,1,0,0,1,0,0,2,32,3.72
30755,1,1,1,1,0,0,4,4966,36.77
30756,1,1,2,1,0,0,5,8690,54.42
30757,1,1,2,1,0,0,5,8690,54.42
30758,1,1,0,1,0,0,3,1352,17.01
30759,1,0,1,1,0,6,9,15950,87.44
30760,1,1,0,1,0,0,3,1352,17.01
30761,1,2,3,1,1,0,8,15186,83.84
30762,1,3,0,1,0,0,5,8690,54.42
30763,1,0,2,1,2,0,6,11521,68.36
30764,1,1,1,1,0,0,4,4966,36.77
30765,1,0,2,1,0,0,4,4966,36.77
30766,1,0,0,1,0,0,2,32,3.72
30767,1,4,0,1,0,0,6,11521,68.36
30768,1,1,0,1,0,0,3,1352,17.01
30769,1,0,1,1,0,0,3,1352,17.01
30770,1,1,1,1,0,0,4,4966,36.77
30771,1,0,1,1,0,0,3,1352,17.01
30772,1,3,1,1,0,0,6,11521,68.36
30773,1,1,1,1,0,0,4,4966,36.77
30774,1,0,1,1,0,0,3,1352,17.01
30775,1,5,3,1,0,0,10,16522,90.12
30776,1,0,1,1,0,0,3,1352,17.01
30777,1,0,1,1,0,6,9,15950,87.44
30778,1,0,2,1,0,0,4,4966,36.77
30779,1,5,0,1,0,0,7,13868,78.23
30780,1,1,2,1,0,0,5,8690,54.42
30781,1,0,2,1,0,0,4,4966,36.77
30782,1,0,1,1,0,0,3,1352,17.01
30783,1,3,0,1,0,0,5,8690,54.42
30784,1,2,1,1,0,0,5,8690,54.42
30785,1,1,3,1,0,0,6,11521,68.36
30786,1,1,2,1,1,0,6,11521,68.36
30787,1,0,3,1,1,6,12,17186,93.28
30788,1,4,0,1,0,0,6,11521,68.36
30789,1,0,1,1,0,0,3,1352,17.01
30790,1,3,1,1,0,4,10,16522,90.12
30791,1,2,0,1,0,0,4,4966,36.77
30792,1,3,1,1,0,0,6,11521,68.36
30793,1,2,0,1,0,0,4,4966,36.77
30794,1,1,1,1,1,0,5,8690,54.42
30795,1,1,1,1,0,4,8,15186,83.84
30796,1,4,1,1,0,0,7,13868,78.23
30797,1,0,1,1,0,0,3,1352,17.01
30798,1,1,2,1,0,0,5,8690,54.42
30799,1,0,2,1,0,0,4,4966,36.77
30800,3,0,5,1,3,6,18,18287,98.68
30801,1,1,1,1,0,6,10,16522,90.12
30802,1,3,0,1,0,0,5,8690,54.42
30803,1,1,0,1,0,0,3,1352,17.01
30804,1,1,0,0,0,0,2,32,3.72
30805,1,2,2,1,0,0,6,11521,68.36
30806,1,4,0,1,0,0,6,11521,68.36
30807,1,1,0,1,0,0,3,1352,17.01
30808,1,3,0,1,0,0,5,8690,54.42
30809,1,0,0,1,0,0,2,32,3.72
30810,1,3,0,1,0,0,5,8690,54.42
30811,1,2,0,1,0,0,4,4966,36.77
30812,1,0,1,1,0,0,3,1352,17.01
30813,1,2,0,1,0,0,4,4966,36.77
30814,1,1,1,1,0,0,4,4966,36.77
30815,1,2,0,1,0,0,4,4966,36.77
30816,1,2,1,1,0,0,5,8690,54.42
30817,1,1,0,1,0,0,3,1352,17.01
30818,1,2,0,1,0,0,4,4966,36.77
30819,1,0,0,1,0,0,2,32,3.72
30820,1,0,1,1,0,0,3,1352,17.01
30821,1,0,3,1,0,0,5,8690,54.42
30822,1,0,2,1,0,0,4,4966,36.77
30823,1,2,0,1,0,0,4,4966,36.77
30824,1,0,3,1,1,4,10,16522,90.12
30825,1,3,1,1,0,0,6,11521,68.36
30826,1,1,2,1,0,0,5,8690,54.42
30827,1,2,2,1,0,0,6,11521,68.36
30828,1,0,1,1,0,0,3,1352,17.01
30829,1,0,1,1,0,0,3,1352,17.01
30830,1,0,1,1,0,0,3,1352,17.01
30831,1,2,1,1,0,0,5,8690,54.42
30832,1,0,2,1,0,0,4,4966,36.77
30833,1,2,1,1,0,0,5,8690,54.42
30834,1,0,1,1,0,0,3,1352,17.01
30835,1,0,1,1,0,0,3,1352,17.01
30836,1,0,1,1,0,0,3,1352,17.01
30837,1,0,2,1,0,0,4,4966,36.77
30838,1,1,2,1,0,0,5,8690,54.42
30839,1,0,1,1,0,0,3,1352,17.01
30840,1,0,4,2,3,0,10,16522,90.12
30841,1,0,1,1,0,0,3,1352,17.01
30842,1,0,1,1,0,0,3,1352,17.01
30843,1,1,1,1,0,0,4,4966,36.77
30844,1,0,2,1,0,0,4,4966,36.77
30845,1,0,4,1,0,0,6,11521,68.36
30846,1,1,1,1,0,0,4,4966,36.77
30847,1,0,1,1,0,0,3,1352,17.01
30848,1,0,2,1,1,8,13,17456,94.66
30849,1,4,0,1,0,0,6,11521,68.36
30850,1,2,1,1,1,0,6,11521,68.36
30851,1,0,2,1,0,0,4,4966,36.77
30852,1,1,1,1,1,0,5,8690,54.42
30853,1,1,1,1,0,0,4,4966,36.77
30854,1,0,2,1,0,0,4,4966,36.77
30855,1,1,2,1,0,0,5,8690,54.42
30856,1,1,0,1,0,0,3,1352,17.01
30857,1,1,0,1,0,0,3,1352,17.01
30858,1,4,0,1,0,0,6,11521,68.36
30859,1,4,1,1,0,0,7,13868,78.23
30860,1,1,1,1,0,0,4,4966,36.77
30861,1,0,0,1,0,0,2,32,3.72
30862,1,1,1,1,0,0,4,4966,36.77
30863,1,0,1,1,0,0,3,1352,17.01
30864,1,0,1,1,0,0,3,1352,17.01
30865,1,0,2,1,0,0,4,4966,36.77
30866,1,0,1,1,0,0,3,1352,17.01
30867,1,4,0,1,0,0,6,11521,68.36
30868,1,0,1,1,0,4,7,13868,78.23
30869,1,2,0,1,0,0,4,4966,36.77
30870,1,4,0,1,0,0,6,11521,68.36
30871,1,4,0,1,0,0,6,11521,68.36
30872,1,1,1,1,0,0,4,4966,36.77
30873,1,1,3,2,0,0,7,13868,78.23
30874,1,2,0,1,0,0,4,4966,36.77
30875,1,0,3,1,1,0,6,11521,68.36
30876,1,2,1,1,0,0,5,8690,54.42
30877,1,1,1,1,0,0,4,4966,36.77
30878,1,0,2,1,0,0,4,4966,36.77
30879,1,0,2,1,0,0,4,4966,36.77
30880,1,1,1,1,0,0,4,4966,36.77
30881,1,1,1,1,0,0,4,4966,36.77
30882,1,0,1,1,0,0,3,1352,17.01
30883,1,1,1,1,0,0,4,4966,36.77
30884,1,4,2,1,0,0,8,15186,83.84
30885,1,4,1,1,0,0,7,13868,78.23
30886,1,0,1,1,0,0,3,1352,17.01
30887,1,1,1,1,0,0,4,4966,36.77
30888,1,1,2,1,0,0,5,8690,54.42
30889,1,0,2,1,0,0,4,4966,36.77
30890,1,0,0,1,0,0,2,32,3.72
30891,1,0,4,2,0,0,7,13868,78.23
30892,1,0,2,1,0,0,4,4966,36.77
30893,1,4,1,1,0,0,7,13868,78.23
30894,1,3,0,1,0,0,5,8690,54.42
30895,1,0,1,1,0,0,3,1352,17.01
30896,1,2,0,1,0,0,4,4966,36.77
30897,1,1,2,1,0,0,5,8690,54.42
30898,1,3,0,1,0,0,5,8690,54.42
30899,1,2,1,1,0,0,5,8690,54.42
30900,1,2,1,1,0,0,5,8690,54.42
30901,1,3,0,1,0,0,5,8690,54.42
30902,1,1,1,1,0,0,4,4966,36.77
30903,1,2,0,1,0,0,4,4966,36.77
30904,1,3,0,1,0,0,5,8690,54.42
30905,1,2,1,1,0,0,5,8690,54.42
30906,1,0,2,1,0,0,4,4966,36.77
30907,1,1,1,1,0,6,10,16522,90.12
30908,1,4,0,1,0,0,6,11521,68.36
30909,1,4,2,1,0,0,8,15186,83.84
30910,1,0,3,1,0,0,5,8690,54.42
30911,1,3,0,1,0,0,5,8690,54.42
30912,1,3,0,1,0,0,5,8690,54.42
30913,1,3,1,1,0,0,6,11521,68.36
30914,1,1,0,1,0,0,3,1352,17.01
30915,1,1,1,1,0,0,4,4966,36.77
30916,1,0,2,1,0,0,4,4966,36.77
30917,1,0,3,1,1,4,10,16522,90.12
30918,1,1,1,1,0,0,4,4966,36.77
30919,1,0,0,1,0,0,2,32,3.72
30920,1,0,2,1,0,0,4,4966,36.77
30921,1,0,1,1,0,0,3,1352,17.01
30922,1,2,2,1,0,0,6,11521,68.36
30923,1,0,2,1,0,0,4,4966,36.77
30924,1,1,0,1,0,4,7,13868,78.23
30925,1,1,0,1,0,0,3,1352,17.01
30926,1,0,1,1,0,0,3,1352,17.01
30927,1,0,2,1,0,0,4,4966,36.77
30928,1,4,1,1,0,0,7,13868,78.23
30929,1,0,2,1,1,0,5,8690,54.42
30930,3,0,5,2,3,0,13,17456,94.66
30931,1,1,0,1,0,0,3,1352,17.01
30932,1,2,1,1,0,0,5,8690,54.42
30933,1,0,0,1,0,0,2,32,3.72
30934,1,1,0,1,0,0,3,1352,17.01
30935,1,0,3,1,0,0,5,8690,54.42
30936,1,1,2,1,0,0,5,8690,54.42
30937,1,5,1,1,0,0,8,15186,83.84
30938,1,0,2,1,0,4,8,15186,83.84
30939,1,2,0,1,0,0,4,4966,36.77
30940,1,0,3,1,0,0,5,8690,54.42
30941,1,1,2,1,0,10,15,17888,96.85
30942,1,0,2,1,0,0,4,4966,36.77
30943,1,0,0,1,0,0,2,32,3.72
30944,1,0,2,1,0,0,4,4966,36.77
30945,1,1,1,1,0,8,12,17186,93.28
30946,1,0,1,1,0,6,9,15950,87.44
30947,1,4,0,1,0,0,6,11521,68.36
30948,1,3,1,1,0,0,6,11521,68.36
30949,1,2,2,1,0,0,6,11521,68.36
30950,1,1,1,1,0,0,4,4966,36.77
30951,1,3,0,1,0,0,5,8690,54.42
30952,1,4,0,1,0,0,6,11521,68.36
30953,1,1,0,1,0,0,3,1352,17.01
30954,1,4,3,1,0,0,9,15950,87.44
30955,1,4,1,1,0,0,7,13868,78.23
30956,1,1,2,1,0,0,5,8690,54.42
30957,1,3,1,1,0,0,6,11521,68.36
30958,1,2,0,1,0,0,4,4966,36.77
30959,1,2,0,1,0,0,4,4966,36.77
30960,1,2,0,1,0,0,4,4966,36.77
30961,1,1,2,1,0,0,5,8690,54.42
30962,1,0,1,1,0,6,9,15950,87.44
30963,1,1,2,1,0,0,5,8690,54.42
30964,1,0,1,1,0,0,3,1352,17.01
30965,1,2,0,1,0,0,4,4966,36.77
30966,1,0,0,1,0,0,2,32,3.72
30967,1,1,0,1,0,0,3,1352,17.01
30968,1,0,2,1,0,6,10,16522,90.12
30969,1,0,1,1,0,0,3,1352,17.01
30970,1,0,2,1,0,0,4,4966,36.77
30971,1,4,0,1,0,0,6,11521,68.36
30972,1,3,0,1,0,0,5,8690,54.42
30973,1,0,0,1,0,0,2,32,3.72
30974,1,3,0,1,0,0,5,8690,54.42
30975,1,0,1,1,0,0,3,1352,17.01
30976,1,0,2,1,0,4,8,15186,83.84
30977,1,3,0,1,0,0,5,8690,54.42
30978,1,3,0,1,0,0,5,8690,54.42
30979,1,0,4,2,3,0,10,16522,90.12
30980,1,2,0,1,0,0,4,4966,36.77
30981,1,2,0,1,0,0,4,4966,36.77
30982,1,2,1,1,0,0,5,8690,54.42
30983,1,0,3,1,0,0,5,8690,54.42
30984,1,1,0,1,0,0,3,1352,17.01
30985,1,0,0,1,0,0,2,32,3.72
30986,1,0,1,1,0,0,3,1352,17.01
30987,1,0,1,1,0,0,3,1352,17.01
30988,1,2,0,1,0,0,4,4966,36.77
30989,1,0,1,1,0,0,3,1352,17.01
30990,1,2,0,1,0,0,4,4966,36.77
30991,1,0,1,1,0,0,3,1352,17.01
30992,1,0,1,1,0,0,3,1352,17.01
30993,1,1,0,1,0,0,3,1352,17.01
30994,1,1,1,1,0,0,4,4966,36.77
30995,1,0,1,1,0,0,3,1352,17.01
30996,1,0,0,1,0,0,2,32,3.72
30997,1,0,1,1,0,0,3,1352,17.01
30998,1,1,1,1,0,0,4,4966,36.77
30999,1,0,0,1,0,0,2,32,3.72
31000,1,4,0,1,0,0,6,11521,68.36
31001,1,5,2,1,0,0,9,15950,87.44
31002,1,4,0,1,0,0,6,11521,68.36
31003,1,0,0,1,0,0,2,32,3.72
31004,1,0,0,1,1,0,3,1352,17.01
31005,1,1,0,1,0,4,7,13868,78.23
31006,1,0,0,1,0,4,6,11521,68.36
31007,1,2,0,1,0,0,4,4966,36.77
31008,1,0,1,1,0,0,3,1352,17.01
31009,1,5,2,1,0,0,9,15950,87.44
31010,1,0,2,0,0,0,3,1352,17.01
31011,1,0,1,1,0,0,3,1352,17.01
31012,1,0,1,1,0,0,3,1352,17.01
31013,1,5,2,1,0,0,9,15950,87.44
31014,1,5,2,1,0,0,9,15950,87.44
31015,1,0,0,1,0,0,2,32,3.72
31016,1,5,0,1,0,0,7,13868,78.23
31017,1,0,2,1,0,0,4,4966,36.77
31018,1,2,1,1,0,0,5,8690,54.42
31019,1,3,0,1,0,0,5,8690,54.42
31020,1,4,1,1,0,0,7,13868,78.23
31021,1,4,0,1,0,0,6,11521,68.36
31022,1,4,2,1,0,0,8,15186,83.84
31023,1,2,2,1,0,0,6,11521,68.36
31024,1,1,0,1,0,0,3,1352,17.01
31026,1,0,0,1,0,0,2,32,3.72
31027,1,4,0,1,0,0,6,11521,68.36
31028,1,1,0,1,0,0,3,1352,17.01
31029,1,0,1,1,2,2,7,13868,78.23
31031,1,3,0,1,0,0,5,8690,54.42
31032,1,1,1,1,0,0,4,4966,36.77
31033,1,0,0,1,0,0,2,32,3.72
31034,1,2,1,1,0,0,5,8690,54.42
31035,1,2,1,1,0,0,5,8690,54.42
31036,1,0,1,1,0,0,3,1352,17.01
31037,1,0,3,1,2,0,7,13868,78.23
31038,1,0,1,1,0,0,3,1352,17.01
31039,1,1,0,1,0,0,3,1352,17.01
31040,1,3,1,1,0,0,6,11521,68.36
31041,1,1,1,1,0,0,4,4966,36.77
31042,1,0,1,1,0,0,3,1352,17.01
31043,1,4,0,1,0,0,6,11521,68.36
31044,1,4,0,1,0,0,6,11521,68.36
31045,1,3,1,1,0,0,6,11521,68.36
31046,1,3,1,1,0,0,6,11521,68.36
31047,1,1,1,1,0,0,4,4966,36.77
31048,1,4,2,1,0,0,8,15186,83.84
31049,1,1,2,1,0,0,5,8690,54.42
31051,1,1,1,1,0,0,4,4966,36.77
31052,1,0,2,1,0,0,4,4966,36.77
31053,1,2,2,1,0,0,6,11521,68.36
31054,1,1,0,0,0,0,2,32,3.72
31055,1,3,4,1,0,0,9,15950,87.44
31056,1,1,4,2,0,0,8,15186,83.84
31057,1,0,4,2,0,0,7,13868,78.23
31058,1,0,2,1,0,0,4,4966,36.77
31059,1,0,4,1,0,6,12,17186,93.28
31060,1,1,2,1,0,0,5,8690,54.42
31061,1,4,0,1,0,0,6,11521,68.36
31062,1,1,2,1,0,0,5,8690,54.42
31063,1,2,3,1,1,0,8,15186,83.84
31064,1,1,0,1,0,0,3,1352,17.01
31065,1,1,0,1,0,0,3,1352,17.01
31066,1,5,1,1,0,0,8,15186,83.84
31067,1,0,1,1,0,2,5,8690,54.42
31068,1,4,1,1,0,0,7,13868,78.23
31069,1,0,0,1,0,0,2,32,3.72
31070,1,4,1,1,0,0,7,13868,78.23
31071,1,0,0,1,0,0,2,32,3.72
31072,1,4,3,1,0,0,9,15950,87.44
31073,1,0,3,1,0,6,11,16947,91.91
31074,1,0,1,1,0,0,3,1352,17.01
31075,1,0,0,1,0,0,2,32,3.72
31076,1,2,0,1,0,0,4,4966,36.77
31077,1,0,1,1,1,0,4,4966,36.77
31078,1,2,2,1,0,0,6,11521,68.36
31079,1,4,2,1,0,0,8,15186,83.84
31080,1,2,0,0,0,0,3,1352,17.01
31081,1,0,1,1,0,0,3,1352,17.01
31082,1,2,1,1,0,0,5,8690,54.42
31083,1,3,0,1,0,0,5,8690,54.42
31084,1,0,0,1,0,0,2,32,3.72
31085,1,0,0,1,0,0,2,32,3.72
31086,1,1,2,1,0,0,5,8690,54.42
31087,1,1,0,1,0,0,3,1352,17.01
31088,1,1,1,1,0,0,4,4966,36.77
31089,1,0,1,1,0,0,3,1352,17.01
31090,1,1,1,1,0,0,4,4966,36.77
31091,1,0,1,1,0,0,3,1352,17.01
31092,1,1,1,1,0,0,4,4966,36.77
31093,1,2,1,1,0,0,5,8690,54.42
31094,1,0,2,1,0,0,4,4966,36.77
31095,1,2,1,1,0,0,5,8690,54.42
31096,1,2,1,1,0,0,5,8690,54.42
31097,1,2,0,1,0,0,4,4966,36.77
31098,1,2,1,1,0,0,5,8690,54.42
31099,1,2,1,1,0,0,5,8690,54.42
31101,1,1,2,1,0,0,5,8690,54.42
31102,1,4,0,1,0,0,6,11521,68.36
31103,1,0,5,1,3,0,10,16522,90.12
31104,1,0,5,2,1,0,9,15950,87.44
31105,1,4,0,1,0,0,6,11521,68.36
31106,1,1,2,1,0,0,5,8690,54.42
31107,1,2,0,1,0,0,4,4966,36.77
31108,1,3,1,1,0,0,6,11521,68.36
31109,1,0,1,1,0,0,3,1352,17.01
31110,1,0,3,1,1,0,6,11521,68.36
31111,1,0,1,1,0,0,3,1352,17.01
31112,1,0,2,1,0,0,4,4966,36.77
31113,1,1,0,1,0,10,13,17456,94.66
31114,1,0,2,1,0,0,4,4966,36.77
31115,1,1,0,0,0,0,2,32,3.72
31116,1,0,1,1,0,6,9,15950,87.44
31117,1,2,1,1,0,0,5,8690,54.42
31118,1,4,0,1,0,0,6,11521,68.36
31119,1,2,0,1,0,0,4,4966,36.77
31120,1,4,0,1,0,0,6,11521,68.36
31121,1,1,0,1,0,0,3,1352,17.01
31122,1,0,0,1,0,0,2,32,3.72
31123,1,1,1,1,0,0,4,4966,36.77
31124,1,0,0,1,0,0,2,32,3.72
31125,1,1,1,1,0,0,4,4966,36.77
31126,1,0,0,1,0,0,2,32,3.72
31127,1,1,0,1,0,0,3,1352,17.01
31128,1,0,5,1,1,0,8,15186,83.84
31129,1,0,2,1,1,6,11,16947,91.91
31130,1,0,3,1,0,0,5,8690,54.42
31131,1,0,1,1,0,0,3,1352,17.01
31132,1,1,1,1,0,0,4,4966,36.77
31133,1,1,0,1,0,0,3,1352,17.01
31134,1,2,0,1,0,0,4,4966,36.77
31135,1,0,1,1,0,0,3,1352,17.01
31136,1,4,0,1,0,0,6,11521,68.36
31137,1,1,0,1,0,0,3,1352,17.01
31138,1,0,1,1,0,0,3,1352,17.01
31139,1,4,1,1,0,0,7,13868,78.23
31140,1,0,1,1,0,0,3,1352,17.01
31141,1,2,3,1,0,0,7,13868,78.23
31142,1,0,1,1,0,0,3,1352,17.01
31143,1,1,0,1,0,0,3,1352,17.01
31144,1,5,1,1,0,0,8,15186,83.84
31145,1,1,1,1,0,0,4,4966,36.77
31146,1,1,1,1,0,0,4,4966,36.77
31147,1,1,0,1,0,0,3,1352,17.01
31148,1,3,1,1,0,0,6,11521,68.36
31149,1,1,0,1,0,8,11,16947,91.91
31150,1,3,0,1,0,0,5,8690,54.42
31151,1,4,1,1,0,0,7,13868,78.23
31152,1,1,1,1,0,0,4,4966,36.77
31153,1,2,0,1,0,0,4,4966,36.77
31154,1,1,5,2,0,0,9,15950,87.44
31155,1,4,1,2,0,0,8,15186,83.84
31156,1,0,0,1,0,0,2,32,3.72
31157,1,0,1,1,0,2,5,8690,54.42
31158,1,0,1,1,0,0,3,1352,17.01
31159,1,0,1,1,0,0,3,1352,17.01
31160,1,1,1,1,0,0,4,4966,36.77
31161,1,1,1,1,0,0,4,4966,36.77
31162,1,0,0,1,0,0,2,32,3.72
31163,1,1,1,1,0,0,4,4966,36.77
31164,1,0,0,1,0,0,2,32,3.72
31165,1,1,1,1,0,0,4,4966,36.77
31166,1,1,1,1,0,0,4,4966,36.77
31167,1,0,1,1,0,0,3,1352,17.01
31168,1,0,1,1,0,0,3,1352,17.01
31169,1,3,0,1,0,0,5,8690,54.42
31170,1,2,0,1,0,0,4,4966,36.77
31171,1,3,2,1,0,0,7,13868,78.23
31172,1,2,2,1,0,0,6,11521,68.36
31173,1,0,1,1,0,2,5,8690,54.42
31174,1,0,2,1,0,0,4,4966,36.77
31175,1,0,0,1,0,6,8,15186,83.84
31176,1,1,2,2,1,0,7,13868,78.23
31177,1,3,0,1,0,0,5,8690,54.42
31178,1,1,0,1,0,0,3,1352,17.01
31179,1,1,1,1,0,0,4,4966,36.77
31180,1,0,3,1,0,0,5,8690,54.42
31181,1,4,1,1,0,0,7,13868,78.23
31182,1,3,2,1,0,0,7,13868,78.23
31183,1,0,1,1,0,0,3,1352,17.01
31184,1,0,2,1,0,0,4,4966,36.77
31185,1,0,2,1,1,4,9,15950,87.44
31186,1,4,2,1,0,0,8,15186,83.84
31187,1,3,1,1,0,0,6,11521,68.36
31188,1,0,1,1,0,0,3,1352,17.01
31189,1,0,0,1,0,0,2,32,3.72
31190,1,0,2,1,0,4,8,15186,83.84
31191,1,0,1,1,0,6,9,15950,87.44
31192,1,0,0,1,0,0,2,32,3.72
31193,1,0,0,1,0,0,2,32,3.72
31194,1,0,0,1,0,0,2,32,3.72
31195,1,3,0,1,0,0,5,8690,54.42
31196,1,0,2,1,0,0,4,4966,36.77
31197,1,1,2,2,0,0,6,11521,68.36
31198,1,3,1,1,0,0,6,11521,68.36
31199,1,0,2,1,2,0,6,11521,68.36
31200,1,0,1,1,0,0,3,1352,17.01
31201,1,0,1,1,0,0,3,1352,17.01
31202,1,1,0,1,0,0,3,1352,17.01
31203,1,0,0,1,0,0,2,32,3.72
31204,1,2,1,1,0,0,5,8690,54.42
31205,1,0,1,1,0,0,3,1352,17.01
31206,1,0,1,1,0,0,3,1352,17.01
31207,1,1,2,1,0,0,5,8690,54.42
31208,1,0,0,1,0,0,2,32,3.72
31209,1,1,0,1,0,0,3,1352,17.01
31210,1,0,3,1,0,0,5,8690,54.42
31211,1,0,3,1,0,0,5,8690,54.42
31212,1,1,1,1,0,0,4,4966,36.77
31213,1,4,1,1,0,0,7,13868,78.23
31214,1,3,1,1,0,0,6,11521,68.36
31215,1,1,0,1,0,0,3,1352,17.01
31216,1,0,0,1,0,2,4,4966,36.77
31217,1,0,2,1,1,0,5,8690,54.42
31218,1,0,1,1,0,4,7,13868,78.23
31219,1,2,0,1,0,0,4,4966,36.77
31220,1,0,0,1,0,0,2,32,3.72
31221,1,0,1,1,0,0,3,1352,17.01
31222,1,0,3,1,1,0,6,11521,68.36
31223,1,0,1,1,0,0,3,1352,17.01
31224,1,0,0,1,0,0,2,32,3.72
31225,1,4,0,1,0,0,6,11521,68.36
31226,1,2,1,1,0,0,5,8690,54.42
31227,1,0,3,1,0,0,5,8690,54.42
31228,1,0,1,1,0,0,3,1352,17.01
31229,1,0,1,1,0,0,3,1352,17.01
31230,1,2,0,1,0,0,4,4966,36.77
31231,1,0,1,1,0,0,3,1352,17.01
31232,1,1,1,1,0,0,4,4966,36.77
31233,1,2,1,1,0,0,5,8690,54.42
31234,1,4,3,2,0,0,10,16522,90.12
31235,1,0,0,1,0,0,2,32,3.72
31236,1,1,0,1,0,0,3,1352,17.01
31237,1,4,0,1,0,0,6,11521,68.36
31238,1,1,0,1,0,0,3,1352,17.01
31239,1,2,0,1,0,0,4,4966,36.77
31240,1,1,1,1,0,0,4,4966,36.77
31241,1,0,1,1,0,0,3,1352,17.01
31242,1,0,1,1,0,0,3,1352,17.01
31243,1,2,0,1,0,0,4,4966,36.77
31244,1,3,1,1,0,0,6,11521,68.36
31245,1,0,1,1,0,0,3,1352,17.01
31246,1,2,1,1,0,0,5,8690,54.42
31247,1,0,1,1,0,0,3,1352,17.01
31248,1,0,1,1,0,0,3,1352,17.01
31249,1,1,2,1,0,0,5,8690,54.42
31250,1,2,1,1,0,0,5,8690,54.42
31251,1,4,0,1,0,0,6,11521,68.36
31252,1,1,1,1,0,0,4,4966,36.77
31253,1,0,2,1,0,0,4,4966,36.77
31254,1,0,2,1,2,0,6,11521,68.36
31255,1,1,1,1,0,0,4,4966,36.77
31256,1,0,2,1,0,0,4,4966,36.77
31257,1,0,2,1,0,6,10,16522,90.12
31258,1,3,4,1,0,0,9,15950,87.44
31259,1,0,3,1,1,6,12,17186,93.28
31260,1,2,1,1,0,0,5,8690,54.42
31261,1,2,1,1,0,0,5,8690,54.42
31262,1,0,1,1,0,0,3,1352,17.01
31263,1,0,1,1,0,0,3,1352,17.01
31264,1,5,0,1,0,0,7,13868,78.23
31265,3,0,5,2,2,0,12,17186,93.28
31266,1,0,1,1,0,0,3,1352,17.01
31267,1,3,0,1,0,0,5,8690,54.42
31268,1,0,0,1,0,0,2,32,3.72
31269,1,0,3,1,1,4,10,16522,90.12
31270,1,0,1,1,0,0,3,1352,17.01
31271,1,0,0,1,0,0,2,32,3.72
31272,1,2,1,1,2,0,7,13868,78.23
31273,1,0,1,1,0,0,3,1352,17.01
31274,1,1,0,1,0,0,3,1352,17.01
31275,1,1,1,1,0,0,4,4966,36.77
31276,1,1,1,1,0,0,4,4966,36.77
31277,1,3,0,1,0,0,5,8690,54.42
31278,1,2,1,1,0,0,5,8690,54.42
31279,1,1,2,1,0,0,5,8690,54.42
31280,1,0,2,1,0,0,4,4966,36.77
31281,1,0,0,1,0,0,2,32,3.72
31282,1,3,1,1,0,0,6,11521,68.36
31283,1,0,1,1,0,0,3,1352,17.01
31284,1,2,1,1,0,0,5,8690,54.42
31285,1,1,0,1,0,0,3,1352,17.01
31286,1,0,4,2,1,0,8,15186,83.84
31287,1,5,2,2,0,0,10,16522,90.12
31288,1,4,2,1,0,0,8,15186,83.84
31289,1,0,1,1,0,0,3,1352,17.01
31290,1,1,0,1,0,0,3,1352,17.01
31291,1,0,2,1,0,0,4,4966,36.77
31292,1,2,3,2,0,0,8,15186,83.84
31293,1,0,0,1,0,0,2,32,3.72
31294,1,2,0,1,0,0,4,4966,36.77
31295,1,1,0,1,0,0,3,1352,17.01
31296,1,1,1,1,0,0,4,4966,36.77
31297,1,1,1,1,0,0,4,4966,36.77
31298,1,1,0,1,0,0,3,1352,17.01
31299,1,0,2,1,0,0,4,4966,36.77
31300,1,1,2,1,0,0,5,8690,54.42
31301,1,0,0,1,0,6,8,15186,83.84
31302,1,2,1,1,0,0,5,8690,54.42
31303,1,3,0,1,0,0,5,8690,54.42
31304,1,3,1,1,0,0,6,11521,68.36
31305,1,1,1,1,0,0,4,4966,36.77
31306,1,1,1,1,0,0,4,4966,36.77
31307,3,0,3,1,1,0,8,15186,83.84
31308,1,3,0,1,0,0,5,8690,54.42
31309,1,4,0,1,0,0,6,11521,68.36
31310,1,3,0,1,0,0,5,8690,54.42
31311,1,0,2,1,0,0,4,4966,36.77
31312,1,2,1,1,0,0,5,8690,54.42
31313,1,0,1,1,0,0,3,1352,17.01
31314,1,0,1,1,0,0,3,1352,17.01
31315,1,5,2,1,0,0,9,15950,87.44
31316,1,1,0,1,0,0,3,1352,17.01
31317,1,0,2,1,0,0,4,4966,36.77
31318,1,1,1,1,0,0,4,4966,36.77
31319,1,1,0,1,0,0,3,1352,17.01
31320,1,3,0,1,0,0,5,8690,54.42
31321,1,1,3,1,0,0,6,11521,68.36
31322,1,1,2,1,0,0,5,8690,54.42
31323,1,0,1,1,0,0,3,1352,17.01
31324,1,0,0,1,0,0,2,32,3.72
31325,1,0,1,1,0,0,3,1352,17.01
31326,1,1,0,1,0,0,3,1352,17.01
31327,1,0,1,1,0,0,3,1352,17.01
31328,1,2,0,1,0,0,4,4966,36.77
31329,1,1,3,1,0,0,6,11521,68.36
31330,1,4,0,1,0,0,6,11521,68.36
31331,1,0,2,1,0,6,10,16522,90.12
31332,1,4,0,1,0,0,6,11521,68.36
31333,1,1,2,1,0,0,5,8690,54.42
31334,1,1,1,1,0,0,4,4966,36.77
31335,1,3,1,1,0,0,6,11521,68.36
31336,1,2,0,1,0,0,4,4966,36.77
31337,1,1,0,1,0,0,3,1352,17.01
31338,1,2,2,1,0,0,6,11521,68.36
31339,1,0,0,1,0,0,2,32,3.72
31340,1,1,0,1,0,0,3,1352,17.01
31341,1,4,2,1,0,0,8,15186,83.84
31342,1,2,1,1,0,0,5,8690,54.42
31343,1,0,3,1,0,0,5,8690,54.42
31344,1,3,2,1,0,0,7,13868,78.23
31345,1,0,2,1,0,0,4,4966,36.77
31346,1,1,3,1,0,6,12,17186,93.28
31347,1,0,2,1,1,0,5,8690,54.42
31348,1,0,3,2,0,0,6,11521,68.36
31349,1,2,0,1,0,0,4,4966,36.77
31350,1,0,1,1,0,0,3,1352,17.01
31351,1,2,0,1,0,0,4,4966,36.77
31352,1,2,2,1,0,0,6,11521,68.36
31353,1,1,1,1,2,4,10,16522,90.12
31354,1,0,1,1,0,0,3,1352,17.01
31355,1,4,0,1,0,0,6,11521,68.36
31356,1,0,1,1,0,0,3,1352,17.01
31357,1,2,1,1,0,0,5,8690,54.42
31358,1,2,1,1,0,0,5,8690,54.42
31359,1,4,0,1,0,0,6,11521,68.36
31360,1,3,0,1,0,0,5,8690,54.42
31361,1,1,0,1,0,0,3,1352,17.01
31362,1,3,1,1,0,0,6,11521,68.36
31363,1,4,1,1,0,0,7,13868,78.23
31364,1,0,1,1,0,0,3,1352,17.01
31365,1,0,0,1,0,8,10,16522,90.12
31366,1,3,1,1,0,0,6,11521,68.36
31367,1,0,1,1,0,0,3,1352,17.01
31368,1,3,1,1,0,0,6,11521,68.36
31369,1,1,1,1,0,0,4,4966,36.77
31370,1,1,1,1,0,0,4,4966,36.77
31371,1,0,2,1,0,0,4,4966,36.77
31372,1,1,1,1,0,0,4,4966,36.77
31373,1,1,0,1,0,0,3,1352,17.01
31374,1,2,1,1,0,0,5,8690,54.42
31375,1,0,1,1,0,0,3,1352,17.01
31376,1,0,1,1,0,0,3,1352,17.01
31377,1,2,0,1,0,0,4,4966,36.77
31378,1,0,1,1,0,0,3,1352,17.01
31379,1,0,2,1,0,0,4,4966,36.77
31380,1,2,2,1,0,0,6,11521,68.36
31381,1,0,2,1,0,0,4,4966,36.77
31382,1,0,1,1,0,0,3,1352,17.01
31383,1,0,1,1,0,0,3,1352,17.01
31384,1,2,1,1,0,0,5,8690,54.42
31385,1,4,1,1,0,0,7,13868,78.23
31386,1,1,1,1,0,0,4,4966,36.77
31387,1,0,2,1,0,0,4,4966,36.77
31388,1,3,0,1,0,0,5,8690,54.42
31389,1,2,0,1,0,0,4,4966,36.77
31390,1,0,0,1,0,0,2,32,3.72
31391,1,0,1,1,0,6,9,15950,87.44
31392,1,2,3,2,0,0,8,15186,83.84
31393,1,2,1,1,0,0,5,8690,54.42
31394,1,0,1,1,0,0,3,1352,17.01
31395,1,4,1,1,0,0,7,13868,78.23
31396,1,4,5,1,0,0,11,16947,91.91
31397,1,0,2,1,0,0,4,4966,36.77
31398,1,0,1,1,0,0,3,1352,17.01
31399,1,3,1,1,0,0,6,11521,68.36
31400,1,0,1,1,0,0,3,1352,17.01
31401,1,4,0,1,0,0,6,11521,68.36
31402,1,0,1,1,0,0,3,1352,17.01
31403,1,0,0,1,0,0,2,32,3.72
31404,1,3,0,1,0,0,5,8690,54.42
31405,1,2,1,1,0,0,5,8690,54.42
31406,1,0,0,1,0,0,2,32,3.72
31407,1,0,1,1,2,0,5,8690,54.42
31408,1,1,1,1,0,0,4,4966,36.77
31409,1,0,1,1,0,0,3,1352,17.01
31410,1,4,0,1,0,0,6,11521,68.36
31411,1,0,2,1,0,0,4,4966,36.77
31412,1,1,0,1,0,0,3,1352,17.01
31413,1,0,1,1,0,4,7,13868,78.23
31414,1,5,0,1,0,0,7,13868,78.23
31415,1,2,1,1,0,0,5,8690,54.42
31416,1,1,2,1,0,0,5,8690,54.42
31417,1,2,1,1,0,0,5,8690,54.42
31418,1,1,1,1,0,0,4,4966,36.77
31419,1,1,1,1,0,6,10,16522,90.12
31420,1,1,0,1,0,0,3,1352,17.01
31421,1,2,0,1,0,0,4,4966,36.77
31422,1,1,0,1,0,0,3,1352,17.01
31423,1,4,0,1,0,0,6,11521,68.36
31424,1,0,1,1,0,0,3,1352,17.01
31425,1,0,3,1,0,0,5,8690,54.42
31426,1,0,1,1,0,0,3,1352,17.01
31427,1,0,1,1,0,4,7,13868,78.23
31428,1,0,2,1,0,0,4,4966,36.77
31429,1,0,1,1,0,0,3,1352,17.01
31430,1,0,1,1,0,0,3,1352,17.01
31431,1,0,1,1,0,0,3,1352,17.01
31432,1,0,2,1,0,0,4,4966,36.77
31433,1,0,1,1,0,0,3,1352,17.01
31434,1,1,0,1,0,0,3,1352,17.01
31435,1,1,0,1,0,0,3,1352,17.01
31436,1,1,2,1,0,0,5,8690,54.42
31437,1,0,1,1,0,0,3,1352,17.01
31438,1,1,2,1,0,0,5,8690,54.42
31439,1,0,2,1,1,0,5,8690,54.42
31440,1,0,0,1,0,0,2,32,3.72
31441,1,0,0,1,0,0,2,32,3.72
31442,1,1,1,1,0,0,4,4966,36.77
31443,1,0,3,2,1,2,9,15950,87.44
31444,1,4,0,1,0,0,6,11521,68.36
31445,1,2,2,1,0,0,6,11521,68.36
31446,1,4,0,1,0,0,6,11521,68.36
31447,1,1,0,1,0,0,3,1352,17.01
31448,1,4,0,1,0,0,6,11521,68.36
31449,1,0,1,1,1,0,4,4966,36.77
31450,1,1,0,1,0,2,5,8690,54.42
31451,1,4,1,1,0,0,7,13868,78.23
31452,1,1,3,1,0,0,6,11521,68.36
31453,1,0,2,1,0,0,4,4966,36.77
31454,1,0,3,1,0,4,9,15950,87.44
31455,1,1,1,1,0,0,4,4966,36.77
31456,1,1,1,1,0,4,8,15186,83.84
31457,1,1,0,1,0,0,3,1352,17.01
31458,1,0,0,1,0,0,2,32,3.72
31459,1,1,1,1,0,0,4,4966,36.77
31460,1,2,1,1,0,0,5,8690,54.42
31461,1,3,0,1,0,0,5,8690,54.42
31462,1,4,0,1,0,0,6,11521,68.36
31463,1,0,1,1,0,0,3,1352,17.01
31464,1,1,0,1,0,0,3,1352,17.01
31465,1,3,2,1,0,0,7,13868,78.23
31466,1,1,0,1,0,0,3,1352,17.01
31467,1,2,0,1,0,0,4,4966,36.77
31468,1,0,1,1,0,6,9,15950,87.44
31469,1,0,1,1,0,0,3,1352,17.01
31470,1,3,1,1,0,0,6,11521,68.36
31471,1,1,2,1,0,0,5,8690,54.42
31472,1,1,1,1,0,0,4,4966,36.77
31473,1,2,1,1,0,0,5,8690,54.42
31474,1,0,2,1,0,0,4,4966,36.77
31475,1,0,2,1,0,4,8,15186,83.84
31477,1,3,1,1,0,0,6,11521,68.36
31478,1,0,1,1,0,6,9,15950,87.44
31479,1,2,1,1,0,0,5,8690,54.42
31480,1,0,1,1,0,0,3,1352,17.01
31481,1,0,1,1,0,0,3,1352,17.01
31482,1,1,0,1,0,0,3,1352,17.01
31483,1,0,1,1,0,0,3,1352,17.01
31484,1,0,0,1,0,2,4,4966,36.77
31485,1,2,0,1,0,0,4,4966,36.77
31486,1,2,3,1,0,0,7,13868,78.23
31487,1,1,2,1,0,0,5,8690,54.42
31488,1,0,1,1,1,0,4,4966,36.77
31489,1,0,2,1,0,0,4,4966,36.77
31490,1,0,1,1,0,0,3,1352,17.01
31491,1,3,0,1,0,0,5,8690,54.42
31492,1,4,0,1,0,0,6,11521,68.36
31493,1,1,2,1,0,0,5,8690,54.42
31494,1,1,1,1,0,0,4,4966,36.77
31495,1,0,1,1,0,0,3,1352,17.01
31496,1,1,0,1,0,0,3,1352,17.01
31497,1,2,1,1,0,0,5,8690,54.42
31498,1,2,1,1,0,0,5,8690,54.42
31499,1,2,1,1,0,0,5,8690,54.42
31500,1,1,2,1,0,0,5,8690,54.42
31501,1,5,0,1,0,0,7,13868,78.23
31502,1,1,1,1,0,0,4,4966,36.77
31503,1,5,5,1,0,0,12,17186,93.28
31504,1,0,1,1,0,0,3,1352,17.01
31505,1,0,1,1,0,0,3,1352,17.01
31506,1,1,2,1,1,0,6,11521,68.36
31507,1,2,2,1,1,0,7,13868,78.23
31508,1,0,3,1,3,0,8,15186,83.84
31509,1,0,2,2,1,0,6,11521,68.36
31510,1,1,1,1,0,0,4,4966,36.77
31511,1,0,0,1,0,0,2,32,3.72
31512,1,0,1,1,0,0,3,1352,17.01
31513,1,1,2,1,0,0,5,8690,54.42
31514,1,0,0,1,0,0,2,32,3.72
31515,1,2,0,1,0,0,4,4966,36.77
31516,1,2,0,1,0,0,4,4966,36.77
31517,1,2,1,1,0,0,5,8690,54.42
31518,1,0,2,1,0,0,4,4966,36.77
31519,1,4,1,1,0,0,7,13868,78.23
31520,1,0,1,1,0,10,13,17456,94.66
31521,1,0,3,2,0,0,6,11521,68.36
31522,1,0,1,1,0,0,3,1352,17.01
31523,1,0,1,1,0,0,3,1352,17.01
31524,1,5,0,1,0,0,7,13868,78.23
31525,1,5,1,1,0,0,8,15186,83.84
31526,1,3,0,1,0,0,5,8690,54.42
31527,1,2,0,1,0,0,4,4966,36.77
31528,1,2,0,1,0,0,4,4966,36.77
31529,1,0,2,1,0,0,4,4966,36.77
31530,1,3,0,1,0,0,5,8690,54.42
31531,1,3,0,1,0,0,5,8690,54.42
31532,1,0,1,1,0,0,3,1352,17.01
31533,1,2,0,1,0,0,4,4966,36.77
31534,1,1,0,1,0,0,3,1352,17.01
31535,1,4,1,1,0,0,7,13868,78.23
31536,1,4,0,1,0,0,6,11521,68.36
31537,1,4,1,1,0,0,7,13868,78.23
31538,1,4,1,1,0,0,7,13868,78.23
31539,1,4,1,1,0,0,7,13868,78.23
31540,1,1,0,1,0,0,3,1352,17.01
31541,1,3,1,1,0,0,6,11521,68.36
31542,1,4,1,1,0,0,7,13868,78.23
31543,1,4,1,1,0,0,7,13868,78.23
31544,1,4,1,1,0,0,7,13868,78.23
31545,1,4,0,1,0,0,6,11521,68.36
31546,3,0,5,1,1,0,10,16522,90.12
31547,1,0,2,1,0,0,4,4966,36.77
31548,1,4,0,1,0,0,6,11521,68.36
31549,1,4,1,1,0,0,7,13868,78.23
31550,1,4,0,1,0,0,6,11521,68.36
31551,1,4,0,1,0,0,6,11521,68.36
31552,1,4,1,1,0,0,7,13868,78.23
31553,1,4,0,1,0,0,6,11521,68.36
31554,1,4,0,1,0,0,6,11521,68.36
31555,1,4,1,1,0,0,7,13868,78.23
31556,1,4,0,1,0,0,6,11521,68.36
31557,1,4,0,1,0,0,6,11521,68.36
31558,1,2,0,1,0,0,4,4966,36.77
31559,4,0,5,1,5,0,15,17888,96.85
31560,1,2,0,1,0,0,4,4966,36.77
31561,1,2,0,1,0,0,4,4966,36.77
31562,1,1,0,1,0,0,3,1352,17.01
31563,1,3,1,1,0,0,6,11521,68.36
31564,1,4,0,1,0,0,6,11521,68.36
31565,1,0,3,2,3,0,9,15950,87.44
31566,3,0,4,2,3,0,12,17186,93.28
31567,3,0,5,2,5,0,15,17888,96.85
31568,1,5,1,1,0,0,8,15186,83.84
31569,1,5,1,1,0,0,8,15186,83.84
31570,1,5,1,1,0,0,8,15186,83.84
31571,1,5,4,2,0,0,12,17186,93.28
31572,1,5,1,1,0,0,8,15186,83.84
31573,1,5,1,1,0,0,8,15186,83.84
31574,1,4,0,1,0,0,6,11521,68.36
31575,1,4,0,1,0,0,6,11521,68.36
31576,1,2,0,1,0,0,4,4966,36.77
31577,1,1,0,1,0,0,3,1352,17.01
31578,1,4,0,1,0,0,6,11521,68.36
31579,1,4,0,1,0,0,6,11521,68.36
31580,1,4,0,1,0,0,6,11521,68.36
31581,1,0,1,1,0,0,3,1352,17.01
31582,1,0,1,1,0,0,3,1352,17.01
31583,1,1,0,1,0,0,3,1352,17.01
31584,1,0,1,1,0,0,3,1352,17.01
31585,1,2,0,1,0,0,4,4966,36.77
31586,1,4,0,1,0,0,6,11521,68.36
31587,1,4,0,1,0,0,6,11521,68.36
31588,1,0,1,1,0,0,3,1352,17.01
31589,1,1,0,1,0,0,3,1352,17.01
31590,1,0,1,1,0,0,3,1352,17.01
31591,1,4,0,1,0,0,6,11521,68.36
31592,1,2,1,1,0,0,5,8690,54.42
31593,1,0,1,1,0,0,3,1352,17.01
31594,1,3,1,1,0,0,6,11521,68.36
31595,1,4,0,1,0,0,6,11521,68.36
31596,1,3,2,1,0,0,7,13868,78.23
31597,4,1,4,2,4,0,15,17888,96.85
31598,1,2,2,2,0,0,7,13868,78.23
31599,1,2,1,1,1,0,6,11521,68.36
31600,1,1,1,1,0,0,4,4966,36.77
31601,1,1,1,1,0,0,4,4966,36.77
31602,1,1,1,1,0,0,4,4966,36.77
31603,1,0,1,1,0,0,3,1352,17.01
31604,1,4,1,1,0,0,7,13868,78.23
31605,1,4,1,1,0,0,7,13868,78.23
31606,1,1,1,1,0,0,4,4966,36.77
31607,1,2,1,1,0,0,5,8690,54.42
31608,1,1,2,1,0,0,5,8690,54.42
31609,1,0,2,1,0,0,4,4966,36.77
31610,1,3,1,1,0,0,6,11521,68.36
31611,1,4,0,1,0,0,6,11521,68.36
31613,1,0,1,1,0,0,3,1352,17.01
31614,1,0,0,1,0,0,2,32,3.72
31615,1,0,1,1,0,0,3,1352,17.01
31616,1,1,1,1,0,0,4,4966,36.77
31617,1,1,0,1,0,0,3,1352,17.01
31618,1,2,0,1,0,0,4,4966,36.77
31619,1,1,1,1,0,0,4,4966,36.77
31620,1,2,1,1,0,0,5,8690,54.42
31621,1,2,0,1,0,0,4,4966,36.77
31622,1,3,0,1,0,0,5,8690,54.42
31623,1,2,1,1,0,0,5,8690,54.42
31624,1,2,3,2,0,0,8,15186,83.84
31625,1,3,1,1,0,0,6,11521,68.36
31626,1,2,1,1,0,0,5,8690,54.42
31627,1,4,3,1,0,0,9,15950,87.44
31628,1,0,5,1,3,0,10,16522,90.12
31629,1,2,1,1,0,0,5,8690,54.42
31630,1,1,0,1,0,0,3,1352,17.01
31631,1,4,0,1,0,0,6,11521,68.36
31632,1,4,0,1,0,0,6,11521,68.36
31633,1,4,0,1,0,0,6,11521,68.36
31634,1,4,0,1,0,0,6,11521,68.36
31635,1,4,0,1,0,0,6,11521,68.36
31636,1,4,0,1,0,0,6,11521,68.36
31637,1,4,1,1,0,0,7,13868,78.23
31638,1,4,0,1,0,0,6,11521,68.36
31640,1,0,1,1,0,0,3,1352,17.01
31641,1,0,2,1,0,0,4,4966,36.77
31642,1,3,1,1,0,0,6,11521,68.36
31644,1,3,0,1,0,0,5,8690,54.42
31645,1,0,1,1,0,0,3,1352,17.01
31646,1,0,0,1,0,0,2,32,3.72
31647,1,0,3,1,0,0,5,8690,54.42
31648,1,4,1,1,0,0,7,13868,78.23
31649,1,2,2,1,0,0,6,11521,68.36
31650,1,0,2,1,0,0,4,4966,36.77
31651,1,1,1,1,0,0,4,4966,36.77
31653,3,1,5,2,3,2,16,18081,97.67
31654,1,0,0,1,0,0,2,32,3.72
31655,1,1,2,1,0,0,5,8690,54.42
31656,1,1,2,1,0,0,5,8690,54.42
31658,1,0,0,1,0,0,2,32,3.72
31659,1,0,1,1,0,0,3,1352,17.01
31660,1,1,1,1,0,0,4,4966,36.77
31661,1,0,1,1,0,0,3,1352,17.01
31662,1,0,3,1,3,0,8,15186,83.84
31663,1,0,1,1,0,0,3,1352,17.01
31665,1,0,2,1,1,0,5,8690,54.42
31666,1,0,1,1,1,10,14,17699,95.82
31667,1,4,0,1,0,0,6,11521,68.36
31668,1,0,1,1,0,0,3,1352,17.01
31669,1,4,0,1,0,0,6,11521,68.36
31670,1,5,0,1,0,0,7,13868,78.23
31671,1,3,0,1,0,0,5,8690,54.42
31672,1,3,1,1,1,0,7,13868,78.23
31673,1,2,0,1,0,0,4,4966,36.77
31674,1,3,0,1,0,0,5,8690,54.42
31675,1,1,1,2,0,0,5,8690,54.42
31676,1,4,1,2,0,0,8,15186,83.84
31677,1,1,2,1,0,0,5,8690,54.42
31678,1,0,0,1,0,0,2,32,3.72
31679,1,0,0,1,0,0,2,32,3.72
31680,4,0,5,3,5,0,17,18193,98.23
31681,1,1,0,1,0,0,3,1352,17.01
31682,1,1,0,1,0,0,3,1352,17.01
31683,1,4,1,1,0,0,7,13868,78.23
31684,1,0,1,1,0,0,3,1352,17.01
31687,1,4,2,1,0,0,8,15186,83.84
31688,1,4,1,1,0,0,7,13868,78.23
31689,1,1,1,1,0,0,4,4966,36.77
31690,1,3,0,1,0,0,5,8690,54.42
31691,1,2,2,1,0,0,6,11521,68.36
31692,1,1,0,1,0,0,3,1352,17.01
31693,1,1,0,1,0,0,3,1352,17.01
31694,1,1,0,1,0,0,3,1352,17.01
31695,1,4,0,1,0,0,6,11521,68.36
31696,1,3,1,1,0,0,6,11521,68.36
31700,1,1,2,1,0,0,5,8690,54.42
31701,1,1,3,1,1,0,7,13868,78.23
31702,1,0,2,1,2,0,6,11521,68.36
31703,1,0,2,1,0,0,4,4966,36.77
31704,1,0,1,1,0,0,3,1352,17.01
31705,3,0,5,2,2,10,22,18498,99.73
31706,1,0,1,1,1,0,4,4966,36.77
31707,1,4,0,1,0,0,6,11521,68.36
31708,1,4,0,1,0,0,6,11521,68.36
31709,1,4,2,2,0,0,9,15950,87.44
31710,1,2,0,1,0,0,4,4966,36.77
31711,3,1,4,3,2,0,13,17456,94.66
31712,4,0,5,2,5,10,26,18556,99.96
31713,4,0,5,2,5,6,22,18498,99.73
31714,1,0,2,1,1,10,15,17888,96.85
31715,1,0,3,1,1,10,16,18081,97.67
80000,1,0,4,2,0,0,7,13868,78.23
80001,1,0,4,2,1,2,10,16522,90.12
80003,3,0,5,3,2,0,13,17456,94.66
80005,3,0,5,2,3,2,15,17888,96.85
80006,1,0,3,1,1,8,14,17699,95.82
80007,1,0,4,2,0,0,7,13868,78.23
80008,1,0,2,2,0,0,5,8690,54.42
80009,3,0,5,1,3,4,16,18081,97.67
80010,4,0,5,2,5,6,22,18498,99.73
80011,1,0,3,1,1,4,10,16522,90.12
80013,3,0,4,1,3,8,19,18362,99.04
80014,1,0,3,1,2,10,17,18193,98.23
80015,3,0,4,1,2,10,20,18419,99.31
80016,3,0,5,2,3,0,13,17456,94.66
80017,1,0,3,2,0,0,6,11521,68.36
80019,3,0,4,1,3,0,11,16947,91.91
80020,3,0,4,2,2,0,11,16947,91.91
80021,1,0,5,1,3,0,10,16522,90.12
80022,3,0,3,2,3,2,13,17456,94.66
80023,1,0,4,1,1,0,7,13868,78.23
80024,1,0,2,1,1,2,7,13868,78.23
80025,1,0,2,1,1,0,5,8690,54.42
80027,1,0,4,1,0,0,6,11521,68.36
80028,3,0,5,2,2,0,12,17186,93.28
80029,3,0,5,2,3,0,13,17456,94.66
80030,1,0,3,1,1,4,10,16522,90.12
80032,3,0,5,2,1,0,11,16947,91.91
80033,3,0,5,2,3,0,13,17456,94.66
80034,3,0,5,2,3,0,13,17456,94.66
80035,1,1,5,1,0,0,8,15186,83.84
80036,3,0,5,1,2,0,11,16947,91.91
80037,1,0,2,1,0,0,4,4966,36.77
80038,1,1,1,1,0,0,4,4966,36.77
80039,1,1,1,1,0,0,4,4966,36.77
80040,1,0,2,1,0,0,4,4966,36.77
80041,1,2,1,1,0,0,5,8690,54.42
80042,1,2,2,1,0,0,6,11521,68.36
80043,1,0,2,1,0,0,4,4966,36.77
80044,1,0,0,1,0,0,2,32,3.72
80045,1,0,2,1,0,0,4,4966,36.77
80046,1,2,0,0,0,0,3,1352,17.01
80047,1,1,0,0,0,0,2,32,3.72
80049,1,0,0,0,0,0,1,1,0.08
80051,1,0,1,1,0,0,3,1352,17.01
80052,1,1,2,1,0,0,5,8690,54.42
80053,1,0,1,1,0,0,3,1352,17.01
80054,1,0,2,1,0,0,4,4966,36.77
80055,1,0,3,1,1,6,12,17186,93.28
80056,1,0,0,1,0,0,2,32,3.72
80060,1,1,1,1,0,0,4,4966,36.77
80061,1,0,2,1,0,0,4,4966,36.77
80062,1,5,2,1,0,0,9,15950,87.44
80063,1,2,0,1,0,0,4,4966,36.77
80064,1,2,2,1,0,0,6,11521,68.36
80065,1,0,2,1,0,0,4,4966,36.77
80066,1,1,2,1,0,0,5,8690,54.42
80067,1,0,2,1,0,0,4,4966,36.77
80068,1,0,1,1,0,0,3,1352,17.01
80069,1,0,1,1,0,0,3,1352,17.01
80070,1,1,1,1,0,0,4,4966,36.77
80073,1,0,2,1,0,0,4,4966,36.77
80074,1,0,1,1,0,0,3,1352,17.01
80075,1,0,1,1,0,0,3,1352,17.01
80076,1,0,1,1,0,0,3,1352,17.01
80078,1,0,2,1,0,0,4,4966,36.77
80079,1,0,0,1,0,0,2,32,3.72
80080,1,1,2,1,0,0,5,8690,54.42
80083,1,3,3,1,0,0,8,15186,83.84
80084,1,2,2,1,0,0,6,11521,68.36
80085,1,1,1,1,0,0,4,4966,36.77
80086,1,0,1,1,0,4,7,13868,78.23
80087,1,0,1,1,0,0,3,1352,17.01
80088,1,3,2,1,0,0,7,13868,78.23
80089,1,2,1,1,0,0,5,8690,54.42
80090,1,3,1,1,0,0,6,11521,68.36
80091,1,0,1,1,0,0,3,1352,17.01
80092,1,1,1,1,0,0,4,4966,36.77
80094,1,2,2,1,0,0,6,11521,68.36
80095,1,1,1,1,0,0,4,4966,36.77
80096,1,1,1,1,0,0,4,4966,36.77
80097,1,0,2,1,0,0,4,4966,36.77
80098,1,0,2,1,0,0,4,4966,36.77
80099,1,0,2,1,0,0,4,4966,36.77
80100,1,0,2,1,0,0,4,4966,36.77
80101,1,0,1,1,0,0,3,1352,17.01
80102,1,1,0,1,0,0,3,1352,17.01
80103,1,3,1,1,0,0,6,11521,68.36
80104,1,0,2,1,0,0,4,4966,36.77
80105,1,1,2,1,0,10,15,17888,96.85
80106,1,0,2,1,0,0,4,4966,36.77
80107,1,0,2,1,0,0,4,4966,36.77
80108,1,4,2,1,0,0,8,15186,83.84
80109,1,3,0,1,0,0,5,8690,54.42
80110,1,4,1,1,0,0,7,13868,78.23
80111,1,3,1,1,0,0,6,11521,68.36
80112,1,2,1,1,0,0,5,8690,54.42
80113,1,0,0,1,0,0,2,32,3.72
80114,1,0,1,1,0,0,3,1352,17.01
80115,1,0,2,0,0,0,3,1352,17.01
80116,1,1,2,1,0,0,5,8690,54.42
80117,1,0,2,1,0,0,4,4966,36.77
80118,1,1,2,1,0,0,5,8690,54.42
80119,1,1,0,1,0,0,3,1352,17.01
80120,1,0,1,1,0,0,3,1352,17.01
80121,1,0,1,1,0,4,7,13868,78.23
80122,1,1,1,1,0,0,4,4966,36.77
80123,1,0,2,1,0,0,4,4966,36.77
80124,1,0,1,1,0,0,3,1352,17.01
80125,1,0,2,1,0,0,4,4966,36.77
80126,1,0,2,1,0,0,4,4966,36.77
80127,1,0,1,1,0,0,3,1352,17.01
80128,1,0,1,1,0,6,9,15950,87.44
80129,1,1,2,1,0,0,5,8690,54.42
80130,1,2,1,1,0,0,5,8690,54.42
80131,1,1,1,1,0,0,4,4966,36.77
80132,1,3,1,1,0,0,6,11521,68.36
80133,1,3,1,1,0,0,6,11521,68.36
80134,1,1,1,1,0,0,4,4966,36.77
80135,1,3,1,1,0,0,6,11521,68.36
80136,1,0,2,1,0,0,4,4966,36.77
80137,1,1,1,1,0,0,4,4966,36.77
80138,1,0,1,1,0,0,3,1352,17.01
80139,1,0,2,1,0,0,4,4966,36.77
80140,1,0,2,1,0,4,8,15186,83.84
80141,1,1,0,1,0,0,3,1352,17.01
80142,1,1,2,1,1,0,6,11521,68.36
80143,1,4,1,1,0,0,7,13868,78.23
80144,1,2,4,1,0,0,8,15186,83.84
80145,1,2,1,1,0,0,5,8690,54.42
80146,1,4,1,1,0,0,7,13868,78.23
80147,1,0,1,1,0,0,3,1352,17.01
80148,1,0,2,1,0,0,4,4966,36.77
80149,1,1,2,1,0,0,5,8690,54.42
80150,1,0,1,1,0,0,3,1352,17.01
80151,1,4,1,1,0,0,7,13868,78.23
80152,1,2,1,1,0,0,5,8690,54.42
80153,1,1,1,1,0,0,4,4966,36.77
80154,1,0,2,1,0,0,4,4966,36.77
80155,1,0,2,1,0,2,6,11521,68.36
80156,1,4,1,1,0,0,7,13868,78.23
80158,1,0,1,1,0,0,3,1352,17.01
80159,1,0,1,1,0,0,3,1352,17.01
80160,1,0,1,1,0,0,3,1352,17.01
80161,1,2,1,1,0,0,5,8690,54.42
80162,1,0,1,1,0,0,3,1352,17.01
80163,1,3,1,1,0,0,6,11521,68.36
80164,1,0,2,1,0,0,4,4966,36.77
80165,1,4,2,1,1,0,9,15950,87.44
80166,1,4,2,1,0,0,8,15186,83.84
80167,1,0,2,1,0,0,4,4966,36.77
80168,1,0,2,1,0,0,4,4966,36.77
80169,1,1,2,1,0,4,9,15950,87.44
80171,1,0,1,1,0,0,3,1352,17.01
80172,1,4,2,1,0,0,8,15186,83.84
80173,1,0,2,1,0,0,4,4966,36.77
80174,1,0,1,1,0,0,3,1352,17.01
80175,1,0,2,1,0,0,4,4966,36.77
80176,1,1,0,1,0,0,3,1352,17.01
80177,1,0,2,1,0,4,8,15186,83.84
80179,1,2,3,1,0,0,7,13868,78.23
80180,1,0,3,1,0,0,5,8690,54.42
80181,1,2,2,1,1,0,7,13868,78.23
80182,1,4,1,1,0,0,7,13868,78.23
80183,1,1,0,1,0,0,3,1352,17.01
80185,1,0,2,1,0,0,4,4966,36.77
80186,1,0,1,1,0,0,3,1352,17.01
80187,1,1,1,1,0,0,4,4966,36.77
80188,1,0,2,1,0,0,4,4966,36.77
80189,1,2,2,1,0,0,6,11521,68.36
80190,1,1,2,1,0,0,5,8690,54.42
80191,1,0,2,1,0,0,4,4966,36.77
80192,1,0,1,1,0,0,3,1352,17.01
80193,1,0,1,1,0,0,3,1352,17.01
80194,1,1,1,1,0,0,4,4966,36.77
80195,1,0,2,1,0,0,4,4966,36.77
80196,1,1,1,1,0,0,4,4966,36.77
80197,1,0,1,1,0,0,3,1352,17.01
80198,1,0,2,1,0,6,10,16522,90.12
80199,1,0,2,1,0,6,10,16522,90.12
80200,1,1,3,1,0,0,6,11521,68.36
80201,1,1,2,1,0,0,5,8690,54.42
80203,1,0,1,1,0,0,3,1352,17.01
80205,1,1,2,1,0,0,5,8690,54.42
80206,1,0,1,1,0,0,3,1352,17.01
80207,1,0,1,1,0,0,3,1352,17.01
80208,1,2,2,1,0,0,6,11521,68.36
80209,1,0,2,1,0,0,4,4966,36.77
80211,1,0,1,1,0,0,3,1352,17.01
80212,1,0,2,1,0,0,4,4966,36.77
80213,1,0,2,1,0,0,4,4966,36.77
80214,1,0,1,1,0,0,3,1352,17.01
80215,1,2,2,1,0,0,6,11521,68.36
80216,1,2,0,1,0,0,4,4966,36.77
80217,1,0,2,1,0,0,4,4966,36.77
80218,1,3,2,1,0,0,7,13868,78.23
80219,1,1,0,1,0,0,3,1352,17.01
80220,1,0,2,1,0,0,4,4966,36.77
80221,1,1,1,1,0,0,4,4966,36.77
80222,1,0,3,0,0,0,4,4966,36.77
80223,1,0,3,0,0,0,4,4966,36.77
80224,1,0,1,0,0,0,2,32,3.72
80226,1,0,0,1,0,0,2,32,3.72
80227,1,0,1,1,0,0,3,1352,17.01
80228,1,0,0,1,0,0,2,32,3.72
80229,1,0,1,1,0,0,3,1352,17.01
80230,1,0,0,1,0,0,2,32,3.72
80233,1,0,1,1,0,0,3,1352,17.01
80234,1,0,1,1,0,0,3,1352,17.01
80235,1,0,1,1,0,0,3,1352,17.01
80236,1,2,2,1,0,0,6,11521,68.36
80237,1,0,0,0,0,0,1,1,0.08
80238,1,0,0,0,0,0,1,1,0.08
80239,1,3,2,1,0,0,7,13868,78.23
80240,1,0,2,1,0,0,4,4966,36.77
80241,1,0,2,1,0,0,4,4966,36.77
80242,1,1,2,1,0,0,5,8690,54.42
80243,1,1,1,1,0,0,4,4966,36.77
80244,1,0,1,1,0,0,3,1352,17.01
80245,1,0,2,1,0,0,4,4966,36.77
80246,1,0,1,1,0,0,3,1352,17.01
80247,1,1,1,1,0,0,4,4966,36.77
80248,1,0,1,1,0,0,3,1352,17.01
80249,1,4,0,1,0,0,6,11521,68.36
80250,1,4,0,1,0,0,6,11521,68.36
80251,1,4,1,1,0,0,7,13868,78.23
80252,1,4,1,1,0,0,7,13868,78.23
80253,1,4,1,1,0,0,7,13868,78.23
80254,1,4,0,1,0,0,6,11521,68.36
80255,1,4,2,1,0,0,8,15186,83.84
80256,1,4,2,1,0,0,8,15186,83.84
80257,1,2,1,1,0,0,5,8690,54.42
80258,1,1,1,1,0,0,4,4966,36.77
80259,1,1,1,1,0,0,4,4966,36.77
80260,1,2,3,1,0,0,7,13868,78.23
80261,1,0,2,1,0,0,4,4966,36.77
80262,1,0,2,1,0,0,4,4966,36.77
80263,1,1,2,1,0,0,5,8690,54.42
80264,1,1,1,1,0,0,4,4966,36.77
80265,1,0,2,1,0,0,4,4966,36.77
80266,1,3,3,1,0,0,8,15186,83.84
80267,1,0,2,1,0,0,4,4966,36.77
80268,1,0,1,1,0,0,3,1352,17.01
80269,1,0,0,1,0,0,2,32,3.72
80270,1,0,0,1,0,0,2,32,3.72
80271,1,3,1,1,0,0,6,11521,68.36
80272,1,1,1,1,0,0,4,4966,36.77
80273,1,0,2,1,0,0,4,4966,36.77
80274,1,0,1,1,0,0,3,1352,17.01
80276,1,0,0,1,0,0,2,32,3.72
80277,1,0,0,1,0,0,2,32,3.72
80278,1,0,0,1,0,0,2,32,3.72
80279,1,0,0,1,0,0,2,32,3.72
80280,1,1,1,1,0,0,4,4966,36.77
80281,1,1,1,1,0,0,4,4966,36.77
80282,1,4,1,1,0,0,7,13868,78.23
80283,1,0,0,1,0,0,2,32,3.72
80284,1,1,2,1,0,0,5,8690,54.42
80286,1,0,1,1,0,0,3,1352,17.01
80287,1,0,2,1,0,0,4,4966,36.77
80288,1,0,1,1,0,0,3,1352,17.01
80289,1,0,3,1,0,0,5,8690,54.42
80290,1,0,2,1,0,0,4,4966,36.77
80292,1,2,0,1,0,0,4,4966,36.77
80293,1,2,1,1,0,0,5,8690,54.42
80294,1,0,1,1,1,0,4,4966,36.77
80295,1,1,1,1,0,0,4,4966,36.77
80296,1,1,2,1,0,0,5,8690,54.42
80297,1,0,1,1,0,0,3,1352,17.01
80298,1,2,1,1,0,0,5,8690,54.42
80299,1,4,1,1,0,0,7,13868,78.23
80300,1,2,1,1,0,0,5,8690,54.42
80301,1,0,2,1,0,0,4,4966,36.77
80302,1,3,3,1,0,0,8,15186,83.84
80304,1,0,2,1,0,0,4,4966,36.77
80305,1,0,1,1,0,0,3,1352,17.01
80306,1,0,3,1,0,0,5,8690,54.42
80307,1,3,2,1,0,0,7,13868,78.23
80309,1,0,1,1,0,0,3,1352,17.01
80310,1,0,1,1,0,0,3,1352,17.01
80311,1,0,1,1,0,0,3,1352,17.01
80313,1,1,4,1,0,0,7,13868,78.23
80314,1,1,4,1,0,0,7,13868,78.23
80315,1,2,4,1,0,0,8,15186,83.84
80316,1,0,1,1,0,0,3,1352,17.01
80317,1,0,0,1,0,0,2,32,3.72
80318,1,0,1,1,0,0,3,1352,17.01
80319,1,0,0,1,0,0,2,32,3.72
80320,1,0,0,1,0,0,2,32,3.72
80321,1,0,0,1,0,0,2,32,3.72
80323,1,0,1,1,0,0,3,1352,17.01
80324,1,0,1,1,0,0,3,1352,17.01
80325,1,0,0,1,0,0,2,32,3.72
80326,1,0,3,1,0,0,5,8690,54.42
80329,1,0,3,1,0,0,5,8690,54.42
80331,1,0,1,1,0,0,3,1352,17.01
80332,1,2,3,1,0,0,7,13868,78.23
80334,1,0,0,1,0,0,2,32,3.72
80336,1,0,0,1,0,0,2,32,3.72
80337,1,0,1,1,0,0,3,1352,17.01
80338,1,0,1,1,0,0,3,1352,17.01
80339,1,4,1,1,0,0,7,13868,78.23
80340,1,1,3,1,0,0,6,11521,68.36
80341,1,1,3,1,0,0,6,11521,68.36
80342,1,3,3,1,0,0,8,15186,83.84
80343,1,4,0,1,0,0,6,11521,68.36
80344,1,0,1,1,0,0,3,1352,17.01
80345,1,0,0,1,0,0,2,32,3.72
80347,1,1,2,1,0,0,5,8690,54.42
80348,1,0,2,1,0,0,4,4966,36.77
80349,1,0,1,1,0,0,3,1352,17.01
80350,3,1,5,2,4,0,15,17888,96.85
80351,1,0,0,1,0,0,2,32,3.72
80353,1,0,0,1,0,0,2,32,3.72
80354,1,1,1,1,0,0,4,4966,36.77
80356,1,0,1,1,0,0,3,1352,17.01
80357,1,0,1,1,0,0,3,1352,17.01
80358,1,0,0,1,0,0,2,32,3.72
80359,1,0,2,1,0,0,4,4966,36.77
80360,1,0,2,1,0,0,4,4966,36.77
80361,1,0,1,1,0,0,3,1352,17.01
80365,1,1,2,1,0,0,5,8690,54.42
80366,1,0,2,1,0,4,8,15186,83.84
6669,1,0,1,1,0,0,3,1352,17.01
6726,1,4,0,1,0,0,6,11521,68.36
6725,1,4,0,1,1,0,7,13868,78.23
24441,1,3,1,1,0,0,6,11521,68.36
6805,1,1,0,1,0,0,3,1352,17.01
6729,1,0,1,1,0,0,3,1352,17.01
6770,1,3,0,1,0,0,5,8690,54.42
6734,1,0,0,1,0,0,2,32,3.72
6733,1,2,0,1,0,0,4,4966,36.77
6754,1,3,0,1,0,0,5,8690,54.42
6802,1,2,0,1,0,0,4,4966,36.77
6803,1,3,0,1,0,0,5,8690,54.42
6794,1,1,0,1,0,0,3,1352,17.01
6796,1,4,2,1,0,0,8,15186,83.84
31697,1,3,0,1,0,0,5,8690,54.42
31699,1,2,0,1,0,0,4,4966,36.77
27814,1,1,2,1,0,0,5,8690,54.42
31698,1,2,0,1,0,0,4,4966,36.77
31686,1,3,2,2,0,0,8,15186,83.84
31685,1,2,0,1,0,0,4,4966,36.77
28115,1,1,3,2,0,0,7,13868,78.23
31664,1,0,2,1,0,0,4,4966,36.77
30363,1,3,1,1,0,0,6,11521,68.36
21804,1,0,1,1,0,6,9,15950,87.44
31612,1,0,3,1,1,0,6,11521,68.36
80082,1,0,2,1,0,0,4,4966,36.77
80308,1,0,1,1,0,0,3,1352,17.01
80048,1,0,0,0,0,0,1,1,0.08
